blueWins,blueFirstBlood,blueEliteMonsters,blueDragons,blueTotalGold,blueTotalExperience,blueGoldDiff,blueCSPerMin,redFirstBlood,redEliteMonsters,redDragons,redTotalGold,redTotalExperience,redGoldDiff,redCSPerMin
FALSE,TRUE,0,FALSE,17210,17039,643,19.5,FALSE,0,FALSE,16567,17047,-643,19.7
FALSE,FALSE,0,FALSE,14712,16265,-2908,17.4,TRUE,2,TRUE,17620,17438,2908,24
FALSE,FALSE,1,TRUE,16113,16221,-1172,18.6,TRUE,0,FALSE,17285,17254,1172,20.3
FALSE,FALSE,1,FALSE,15157,17954,-1321,20.1,TRUE,0,FALSE,16478,17961,1321,23.5
FALSE,FALSE,0,FALSE,16400,18543,-1004,21,TRUE,1,TRUE,17404,18313,1004,22.5
TRUE,FALSE,1,TRUE,15899,18161,698,22.5,TRUE,0,FALSE,15201,18060,-698,22.1
TRUE,TRUE,1,TRUE,16874,16967,2411,22.5,FALSE,0,FALSE,14463,15404,-2411,16.4
FALSE,FALSE,0,FALSE,15305,16138,-2615,20.9,TRUE,1,TRUE,17920,16938,2615,15.7
FALSE,FALSE,0,FALSE,16401,18527,-1979,18.9,TRUE,2,TRUE,18380,19298,1979,24
TRUE,TRUE,1,TRUE,15057,16805,-1548,22,FALSE,0,FALSE,16605,18379,1548,24.7
FALSE,TRUE,0,FALSE,15474,16611,331,23.1,FALSE,1,TRUE,15143,18196,-331,21.6
FALSE,TRUE,1,FALSE,16695,18507,-1505,15.7,FALSE,0,FALSE,18200,19142,1505,18.8
TRUE,TRUE,1,TRUE,17865,19102,3274,23.8,FALSE,0,FALSE,14591,17443,-3274,24
FALSE,FALSE,1,FALSE,14979,17213,-3414,21,TRUE,0,FALSE,18393,18354,3414,22.9
TRUE,TRUE,0,FALSE,15722,17896,-470,22.4,FALSE,0,FALSE,16192,18083,470,24.2
FALSE,FALSE,0,FALSE,15015,16974,-1996,20.9,TRUE,0,FALSE,17011,18778,1996,23.7
TRUE,TRUE,0,FALSE,19733,20862,5228,26.3,FALSE,1,TRUE,14505,17484,-5228,21
FALSE,FALSE,1,FALSE,14852,16888,-1975,20.3,TRUE,0,FALSE,16827,18233,1975,21.8
TRUE,TRUE,0,FALSE,16282,17378,882,21.3,FALSE,2,TRUE,15400,16866,-882,22.8
FALSE,FALSE,0,FALSE,14994,17924,-3155,18.8,TRUE,0,FALSE,18149,20697,3155,21.9
TRUE,TRUE,1,TRUE,18606,19254,2526,21.4,FALSE,0,FALSE,16080,17629,-2526,22.5
FALSE,FALSE,0,FALSE,15878,16945,-2835,20.3,TRUE,1,TRUE,18713,19766,2835,20.9
FALSE,FALSE,0,FALSE,15773,17562,-1254,23.8,TRUE,1,TRUE,17027,18129,1254,23.1
FALSE,FALSE,2,TRUE,15906,19219,406,23.8,TRUE,0,FALSE,15500,17936,-406,22
TRUE,FALSE,0,FALSE,16515,17223,-1020,20.8,TRUE,0,FALSE,17535,16730,1020,19.7
FALSE,FALSE,0,FALSE,15415,16047,-2472,20.4,TRUE,1,TRUE,17887,17114,2472,22.1
TRUE,FALSE,1,TRUE,17178,17854,1260,20.9,TRUE,0,FALSE,15918,17909,-1260,23.3
FALSE,TRUE,0,FALSE,17226,18982,1857,22.8,FALSE,1,TRUE,15369,16967,-1857,20.2
FALSE,TRUE,1,TRUE,17474,17436,1320,21.7,FALSE,0,FALSE,16154,17849,-1320,22.3
FALSE,FALSE,1,TRUE,14905,17974,-3282,23.3,TRUE,0,FALSE,18187,19621,3282,22.5
TRUE,TRUE,1,TRUE,18132,18076,2883,22.8,FALSE,0,FALSE,15249,15965,-2883,22.7
TRUE,TRUE,2,TRUE,16053,17406,1703,21.8,FALSE,0,FALSE,14350,15710,-1703,20.6
FALSE,FALSE,0,FALSE,16438,16989,608,20.3,TRUE,1,TRUE,15830,17074,-608,20.6
FALSE,TRUE,0,FALSE,15634,16355,71,20.1,FALSE,1,TRUE,15563,16714,-71,22.2
TRUE,FALSE,0,FALSE,16085,19076,275,20.4,TRUE,1,TRUE,15810,18204,-275,22.3
FALSE,FALSE,0,FALSE,14981,17082,-809,23.5,TRUE,2,TRUE,15790,16444,809,21.8
FALSE,FALSE,1,TRUE,15421,19276,-2771,21.7,TRUE,0,FALSE,18192,20401,2771,23.4
FALSE,TRUE,1,FALSE,15665,17716,-1730,20.3,FALSE,1,TRUE,17395,18952,1730,21.4
FALSE,FALSE,1,FALSE,17528,19609,-904,23.4,TRUE,1,TRUE,18432,18232,904,22.7
FALSE,FALSE,1,FALSE,15032,16832,-1683,21.3,TRUE,1,TRUE,16715,18195,1683,23.6
FALSE,FALSE,0,FALSE,15483,17362,-3025,22.2,TRUE,1,TRUE,18508,19195,3025,21.3
TRUE,FALSE,0,FALSE,19226,20118,3004,23.1,TRUE,0,FALSE,16222,17818,-3004,18.5
TRUE,FALSE,1,TRUE,16945,17806,1574,20.4,TRUE,0,FALSE,15371,17045,-1574,19.4
TRUE,TRUE,0,FALSE,15000,16493,-1036,23.3,FALSE,0,FALSE,16036,17916,1036,22.1
FALSE,TRUE,1,FALSE,15888,19090,16,25.2,FALSE,1,TRUE,15872,18657,-16,24.3
FALSE,FALSE,0,FALSE,12925,15498,-6386,18.7,TRUE,1,FALSE,19311,19708,6386,24.7
TRUE,TRUE,0,FALSE,19250,19703,5096,25.1,FALSE,0,FALSE,14154,16393,-5096,19.6
TRUE,TRUE,1,TRUE,18355,18790,2756,21.8,FALSE,0,FALSE,15599,17107,-2756,20
TRUE,FALSE,1,FALSE,13978,16429,-977,18,TRUE,0,FALSE,14955,17454,977,21.8
FALSE,FALSE,0,FALSE,15851,17366,-808,20.6,TRUE,0,FALSE,16659,19021,808,24.1
FALSE,FALSE,0,FALSE,16474,17408,-1559,20.9,TRUE,1,TRUE,18033,17815,1559,20.6
TRUE,FALSE,0,FALSE,16590,18284,544,21.3,TRUE,0,FALSE,16046,18209,-544,18.2
TRUE,TRUE,2,TRUE,15737,18634,1381,21.7,FALSE,0,FALSE,14356,17617,-1381,21.2
TRUE,TRUE,0,FALSE,16990,19634,2031,24.8,FALSE,1,TRUE,14959,18185,-2031,21
FALSE,FALSE,1,TRUE,15297,19210,131,24.6,TRUE,0,FALSE,15166,18840,-131,22.7
FALSE,FALSE,1,FALSE,15651,17696,-2699,22.4,TRUE,1,TRUE,18350,20445,2699,20.1
FALSE,TRUE,1,TRUE,15587,16746,-1672,18.1,FALSE,0,FALSE,17259,19444,1672,21.8
TRUE,TRUE,1,TRUE,17777,18131,1201,21.3,FALSE,0,FALSE,16576,17815,-1201,23.4
TRUE,TRUE,2,TRUE,16426,18407,-108,22.2,FALSE,0,FALSE,16534,18348,108,24.7
FALSE,FALSE,0,FALSE,20278,19575,4633,23.6,TRUE,1,TRUE,15645,17306,-4633,18.2
FALSE,FALSE,0,FALSE,13791,16437,-2262,19.1,TRUE,1,TRUE,16053,17828,2262,21.8
FALSE,FALSE,0,FALSE,16505,17667,-49,20.8,TRUE,1,TRUE,16554,17167,49,20.7
TRUE,TRUE,1,TRUE,17277,19610,1687,22.9,FALSE,1,FALSE,15590,18521,-1687,23.2
TRUE,TRUE,2,TRUE,18269,19659,3933,22.9,FALSE,0,FALSE,14336,16737,-3933,23.3
FALSE,FALSE,1,TRUE,14166,15959,-4061,20.3,TRUE,0,FALSE,18227,20356,4061,22.4
FALSE,FALSE,0,FALSE,15456,16280,-4920,18.8,TRUE,1,FALSE,20376,19560,4920,24
FALSE,FALSE,0,FALSE,15180,17773,-1705,21,TRUE,0,FALSE,16885,19612,1705,22.7
FALSE,TRUE,1,TRUE,16179,16814,105,21.2,FALSE,1,FALSE,16074,18361,-105,20
TRUE,FALSE,0,FALSE,16026,18490,-554,23.3,TRUE,1,TRUE,16580,17969,554,23.4
FALSE,TRUE,0,FALSE,14850,17145,-1037,19.8,FALSE,1,TRUE,15887,18722,1037,24.1
FALSE,TRUE,1,FALSE,17347,18573,-1144,20.2,FALSE,1,TRUE,18491,18093,1144,19.9
TRUE,TRUE,0,FALSE,15887,17591,1173,20,FALSE,1,TRUE,14714,16638,-1173,18.6
FALSE,TRUE,0,FALSE,17399,19449,3194,23.2,FALSE,1,TRUE,14205,16915,-3194,20.8
FALSE,TRUE,1,TRUE,13828,16629,-2622,20.4,FALSE,0,FALSE,16450,17765,2622,19.2
TRUE,TRUE,1,TRUE,16645,19110,1151,24.2,FALSE,1,FALSE,15494,18640,-1151,20.5
TRUE,TRUE,2,TRUE,16248,17200,1463,20,FALSE,0,FALSE,14785,15710,-1463,16.9
FALSE,FALSE,0,FALSE,15310,18337,-1038,22.1,TRUE,2,TRUE,16348,19644,1038,22.6
TRUE,TRUE,1,FALSE,16784,17242,1424,21.2,FALSE,0,FALSE,15360,16182,-1424,18
TRUE,FALSE,1,TRUE,19032,18951,527,23.2,TRUE,0,FALSE,18505,18230,-527,21.6
FALSE,FALSE,0,FALSE,17518,18342,1807,24.2,TRUE,2,TRUE,15711,17410,-1807,19.8
FALSE,TRUE,1,FALSE,18976,20326,2856,25.6,FALSE,1,TRUE,16120,19064,-2856,21
FALSE,FALSE,1,TRUE,16143,16617,-964,20.4,TRUE,1,FALSE,17107,19071,964,24.1
FALSE,FALSE,1,FALSE,15868,17111,-178,19.9,TRUE,1,TRUE,16046,16587,178,17.8
TRUE,FALSE,1,TRUE,17977,18162,705,23.5,TRUE,0,FALSE,17272,17970,-705,20.7
TRUE,FALSE,1,TRUE,18138,18159,908,20.8,TRUE,0,FALSE,17230,17853,-908,21
TRUE,FALSE,2,TRUE,18025,19864,3558,26.1,TRUE,0,FALSE,14467,16621,-3558,22
FALSE,FALSE,0,FALSE,14625,17769,-1299,24.1,TRUE,1,TRUE,15924,17818,1299,21.8
TRUE,FALSE,1,TRUE,15752,17113,-1763,20.1,TRUE,0,FALSE,17515,18977,1763,24.8
TRUE,FALSE,0,FALSE,18480,19565,2547,23.2,TRUE,0,FALSE,15933,17376,-2547,24.7
FALSE,FALSE,1,TRUE,14995,16206,-3685,21,TRUE,1,FALSE,18680,19325,3685,20
FALSE,TRUE,0,FALSE,15655,15827,-3689,19.4,FALSE,1,TRUE,19344,20509,3689,21.6
FALSE,TRUE,0,FALSE,15562,18590,-764,23.6,FALSE,2,TRUE,16326,17787,764,23.3
TRUE,TRUE,0,FALSE,17139,19137,3037,22.3,FALSE,1,TRUE,14102,16443,-3037,21.3
TRUE,TRUE,0,FALSE,19229,18820,3545,25.7,FALSE,1,TRUE,15684,16658,-3545,14.5
FALSE,FALSE,1,TRUE,16972,19060,-1031,20.9,TRUE,0,FALSE,18003,19454,1031,25.5
FALSE,FALSE,0,FALSE,16249,18383,-1796,21.3,TRUE,1,TRUE,18045,19132,1796,21.4
TRUE,TRUE,0,FALSE,16415,17645,1626,24.7,FALSE,1,TRUE,14789,16898,-1626,20.3
TRUE,FALSE,1,FALSE,18012,19837,832,25,TRUE,1,TRUE,17180,18507,-832,18.6
TRUE,FALSE,2,TRUE,19294,20668,2750,24.2,TRUE,0,FALSE,16544,18021,-2750,20.3
FALSE,FALSE,1,FALSE,15383,17243,-1524,22.7,TRUE,0,FALSE,16907,18070,1524,18.6
FALSE,TRUE,1,TRUE,15777,17401,-1370,22.4,FALSE,0,FALSE,17147,18276,1370,21
FALSE,FALSE,0,FALSE,14805,17323,-1506,20.9,TRUE,1,TRUE,16311,17735,1506,23.1
FALSE,FALSE,0,FALSE,15244,16787,-1101,19.9,TRUE,2,TRUE,16345,17505,1101,21.2
FALSE,FALSE,1,FALSE,17574,19195,2774,25.2,TRUE,1,TRUE,14800,16988,-2774,22.5
FALSE,FALSE,0,FALSE,16655,17831,-1806,22.2,TRUE,2,TRUE,18461,18419,1806,21.5
FALSE,FALSE,1,TRUE,16855,18370,1265,24.8,TRUE,1,FALSE,15590,17122,-1265,20.7
TRUE,FALSE,0,FALSE,15786,16995,-4443,20,TRUE,1,TRUE,20229,21135,4443,22.7
FALSE,FALSE,0,FALSE,15143,19080,-927,23.3,TRUE,1,TRUE,16070,18113,927,21.6
TRUE,TRUE,0,FALSE,17309,18904,1425,22.1,FALSE,2,TRUE,15884,18176,-1425,20.8
TRUE,FALSE,1,TRUE,16416,19684,1177,21.1,TRUE,0,FALSE,15239,18523,-1177,20.4
TRUE,TRUE,1,TRUE,15222,17812,-1586,23.1,FALSE,1,FALSE,16808,17402,1586,21.1
FALSE,FALSE,2,TRUE,15526,17629,-2896,23.2,TRUE,0,FALSE,18422,19710,2896,23.6
TRUE,FALSE,0,FALSE,17597,15938,905,14.3,TRUE,0,FALSE,16692,14884,-905,18.1
FALSE,TRUE,0,FALSE,16834,14815,-3887,18.7,FALSE,0,FALSE,20721,18207,3887,21.1
TRUE,TRUE,1,TRUE,19058,19575,3413,20.2,FALSE,0,FALSE,15645,16591,-3413,21
FALSE,TRUE,2,TRUE,16806,18034,-256,22.8,FALSE,0,FALSE,17062,19614,256,23
TRUE,TRUE,0,FALSE,16643,17554,-1820,22.7,FALSE,0,FALSE,18463,18966,1820,23.1
TRUE,TRUE,1,TRUE,16189,17737,625,22.4,FALSE,0,FALSE,15564,18271,-625,21.7
FALSE,FALSE,0,FALSE,14095,17286,-3628,19.6,TRUE,1,TRUE,17723,19295,3628,26.6
FALSE,TRUE,1,FALSE,16804,17544,769,21.7,FALSE,1,TRUE,16035,17064,-769,23.3
FALSE,FALSE,1,TRUE,17305,18192,-576,22.9,TRUE,1,FALSE,17881,18874,576,19.8
FALSE,FALSE,0,FALSE,14539,16806,-3900,21.3,TRUE,1,TRUE,18439,20356,3900,25.5
TRUE,FALSE,1,TRUE,17530,18299,-7,19.2,TRUE,1,FALSE,17537,18530,7,20.9
TRUE,TRUE,0,FALSE,18431,19562,1683,20.7,FALSE,1,TRUE,16748,18129,-1683,23.1
FALSE,FALSE,0,FALSE,14032,16550,-4782,19.3,TRUE,1,TRUE,18814,19958,4782,24.5
TRUE,TRUE,1,TRUE,17869,17810,636,20.5,FALSE,0,FALSE,17233,18024,-636,21.5
TRUE,FALSE,1,TRUE,15974,16174,-3421,18.3,TRUE,0,FALSE,19395,18798,3421,21.9
TRUE,FALSE,1,TRUE,16108,18920,976,24,TRUE,0,FALSE,15132,17321,-976,23
FALSE,FALSE,0,FALSE,16302,17297,-211,21.2,TRUE,1,FALSE,16513,18602,211,21.1
TRUE,FALSE,0,FALSE,16750,17603,1221,21.5,TRUE,0,FALSE,15529,17141,-1221,19.7
TRUE,FALSE,0,FALSE,16506,18669,2037,22.6,TRUE,1,TRUE,14469,17378,-2037,21.7
TRUE,TRUE,1,TRUE,16389,17937,817,24.1,FALSE,0,FALSE,15572,18031,-817,22.9
TRUE,TRUE,0,FALSE,15760,18295,-137,21.5,FALSE,1,TRUE,15897,18646,137,22.7
TRUE,TRUE,1,TRUE,15176,16820,-1539,22.6,FALSE,0,FALSE,16715,18317,1539,20.5
FALSE,FALSE,0,FALSE,15196,16908,-1707,19.1,TRUE,1,TRUE,16903,18194,1707,21.6
TRUE,FALSE,1,TRUE,16250,17537,-556,22.8,TRUE,0,FALSE,16806,17772,556,14.3
TRUE,TRUE,1,TRUE,16541,16779,-146,19.9,FALSE,1,FALSE,16687,17496,146,22.5
TRUE,TRUE,1,FALSE,18657,19205,4083,22.7,FALSE,1,TRUE,14574,16321,-4083,19.1
TRUE,FALSE,0,FALSE,16873,19105,1389,22.3,TRUE,1,TRUE,15484,17687,-1389,22.6
FALSE,FALSE,1,TRUE,14383,15898,-890,21.1,TRUE,1,FALSE,15273,16426,890,20.8
FALSE,TRUE,0,FALSE,14420,15196,-2519,19.2,FALSE,0,FALSE,16939,16291,2519,19.4
FALSE,FALSE,0,FALSE,14720,15031,-4440,18.3,TRUE,0,FALSE,19160,19051,4440,20.1
TRUE,TRUE,0,FALSE,17406,19761,1140,25.1,FALSE,2,TRUE,16266,19056,-1140,19
FALSE,TRUE,0,FALSE,15210,15974,-1656,17.2,FALSE,0,FALSE,16866,17806,1656,21.9
TRUE,FALSE,0,FALSE,17272,15840,2171,19.2,TRUE,2,TRUE,15101,16101,-2171,19.9
TRUE,TRUE,0,FALSE,19358,19257,3841,20.6,FALSE,0,FALSE,15517,16773,-3841,21.6
TRUE,FALSE,1,FALSE,16855,16360,-885,23.2,TRUE,1,TRUE,17740,18532,885,21.6
FALSE,FALSE,2,TRUE,15209,16256,-2752,19.1,TRUE,0,FALSE,17961,18542,2752,24.1
TRUE,TRUE,0,FALSE,19542,17935,2081,20.7,FALSE,0,FALSE,17461,17469,-2081,20
FALSE,TRUE,0,FALSE,15267,17321,453,23.2,FALSE,0,FALSE,14814,17340,-453,20.9
FALSE,TRUE,1,TRUE,15243,17194,830,22.4,FALSE,1,FALSE,14413,18196,-830,22
FALSE,FALSE,0,FALSE,16214,17234,94,20.3,TRUE,0,FALSE,16120,17679,-94,16.8
FALSE,FALSE,2,TRUE,15976,18227,-722,17.8,TRUE,0,FALSE,16698,17336,722,23.2
FALSE,FALSE,1,FALSE,16557,17632,-1491,23,TRUE,1,TRUE,18048,18431,1491,22.2
FALSE,FALSE,0,FALSE,16142,16953,-3109,19.8,TRUE,2,TRUE,19251,18698,3109,20.1
FALSE,TRUE,0,FALSE,17984,18708,537,23,FALSE,1,TRUE,17447,19185,-537,17.8
TRUE,FALSE,2,TRUE,20038,21588,4079,22.2,TRUE,0,FALSE,15959,16020,-4079,20.8
TRUE,FALSE,0,FALSE,19571,18463,4006,21.3,TRUE,0,FALSE,15565,16382,-4006,21
FALSE,TRUE,0,FALSE,14557,15128,-3582,20,FALSE,2,TRUE,18139,20523,3582,24.6
TRUE,FALSE,0,FALSE,16029,18567,-355,20.5,TRUE,1,TRUE,16384,18334,355,22.4
TRUE,TRUE,0,FALSE,18053,16741,3464,20.7,FALSE,0,FALSE,14589,15747,-3464,17.8
TRUE,TRUE,1,TRUE,18098,18905,2217,22.5,FALSE,1,FALSE,15881,16722,-2217,22.9
TRUE,TRUE,2,TRUE,18343,19519,3049,23.5,FALSE,0,FALSE,15294,18008,-3049,23.4
TRUE,FALSE,1,TRUE,15596,17998,-305,19.8,TRUE,0,FALSE,15901,18472,305,19.9
FALSE,FALSE,1,TRUE,15812,17882,1325,22.9,TRUE,1,FALSE,14487,17403,-1325,21.8
TRUE,TRUE,0,FALSE,15947,16477,-53,22.1,FALSE,1,TRUE,16000,16390,53,20.3
FALSE,FALSE,0,FALSE,14997,16532,-2865,19.6,TRUE,1,TRUE,17862,17973,2865,23.7
FALSE,TRUE,0,FALSE,16463,17576,-93,21.5,FALSE,1,TRUE,16556,18137,93,21.7
FALSE,TRUE,0,FALSE,16072,17054,-420,22.5,FALSE,1,TRUE,16492,18239,420,21.2
TRUE,TRUE,1,TRUE,19140,19579,5008,25.3,FALSE,1,FALSE,14132,17224,-5008,17.9
FALSE,TRUE,0,FALSE,14547,15883,-2074,18.8,FALSE,2,TRUE,16621,17678,2074,19.6
TRUE,FALSE,1,FALSE,15644,17717,-3,18.8,TRUE,0,FALSE,15647,16704,3,19
FALSE,TRUE,0,FALSE,15734,17911,-837,21.3,FALSE,2,TRUE,16571,18571,837,24.9
TRUE,TRUE,1,TRUE,16794,17320,510,22.9,FALSE,1,FALSE,16284,18067,-510,21.6
FALSE,FALSE,1,TRUE,15930,17257,-3549,20,TRUE,0,FALSE,19479,19664,3549,21.4
TRUE,FALSE,0,FALSE,16936,18646,272,24,TRUE,1,TRUE,16664,18287,-272,19.9
TRUE,TRUE,0,FALSE,17941,19379,2187,23,FALSE,0,FALSE,15754,17190,-2187,20.6
FALSE,FALSE,0,FALSE,13698,15671,-4907,22.2,TRUE,1,FALSE,18605,18227,4907,24.2
TRUE,TRUE,1,TRUE,15943,19262,63,23.8,FALSE,0,FALSE,15880,18614,-63,21
TRUE,FALSE,1,FALSE,15891,18304,-2132,22.2,TRUE,1,TRUE,18023,18788,2132,23
FALSE,FALSE,1,FALSE,16216,19002,-976,21.1,TRUE,1,TRUE,17192,19966,976,22.2
FALSE,TRUE,0,FALSE,14754,17158,-1342,18.6,FALSE,1,TRUE,16096,19124,1342,21.8
TRUE,TRUE,1,TRUE,16909,18318,2304,22.9,FALSE,0,FALSE,14605,15786,-2304,20.8
TRUE,FALSE,0,FALSE,18858,19691,4219,21.8,TRUE,1,TRUE,14639,16312,-4219,21.9
FALSE,TRUE,0,FALSE,15952,17112,-2049,18,FALSE,0,FALSE,18001,19452,2049,24.3
FALSE,FALSE,0,FALSE,13286,15085,-4179,18.7,TRUE,1,TRUE,17465,18908,4179,23.6
FALSE,FALSE,0,FALSE,16812,18466,-66,26.9,TRUE,1,TRUE,16878,19539,66,24.5
TRUE,FALSE,2,TRUE,17906,18001,510,17.8,TRUE,0,FALSE,17396,17859,-510,21.5
FALSE,TRUE,1,FALSE,16408,19181,2591,26.3,FALSE,1,TRUE,13817,17614,-2591,20.8
FALSE,TRUE,0,FALSE,15056,16369,-3772,19.8,FALSE,1,TRUE,18828,19403,3772,17.7
FALSE,TRUE,1,TRUE,17831,18269,965,24,FALSE,0,FALSE,16866,19147,-965,23.3
FALSE,FALSE,0,FALSE,13738,16678,-3468,22.3,TRUE,2,TRUE,17206,18836,3468,25.9
TRUE,TRUE,0,FALSE,20317,20330,6153,21.2,FALSE,0,FALSE,14164,16414,-6153,19.6
FALSE,FALSE,0,FALSE,14091,16184,-2216,23.3,TRUE,1,TRUE,16307,18914,2216,22.9
FALSE,FALSE,1,TRUE,16036,16916,-2308,19.1,TRUE,0,FALSE,18344,18683,2308,20.6
TRUE,TRUE,1,FALSE,17052,17392,1917,21,FALSE,1,TRUE,15135,17571,-1917,19.4
FALSE,FALSE,0,FALSE,16354,18778,-1676,26.8,TRUE,1,TRUE,18030,20537,1676,24.4
TRUE,TRUE,1,TRUE,18297,19476,2709,24.2,FALSE,0,FALSE,15588,18217,-2709,21.4
FALSE,FALSE,0,FALSE,15748,16524,-1304,22.2,TRUE,1,TRUE,17052,17076,1304,21.6
TRUE,TRUE,1,TRUE,17886,20099,1824,22.9,FALSE,0,FALSE,16062,18690,-1824,22.2
FALSE,FALSE,0,FALSE,17069,16703,229,17.4,TRUE,2,TRUE,16840,16748,-229,21.2
TRUE,FALSE,1,FALSE,16631,19310,1507,25.2,TRUE,0,FALSE,15124,17643,-1507,21.4
FALSE,FALSE,1,TRUE,14766,18364,-1787,23.1,TRUE,0,FALSE,16553,19499,1787,23.5
FALSE,FALSE,0,FALSE,17113,19396,815,23.4,TRUE,0,FALSE,16298,17999,-815,18.2
FALSE,FALSE,1,TRUE,15120,16713,-4767,16.7,TRUE,0,FALSE,19887,21774,4767,23.8
FALSE,FALSE,0,FALSE,15339,16302,-1861,22.1,TRUE,1,TRUE,17200,18834,1861,26.2
FALSE,FALSE,1,TRUE,13438,14164,-7655,17.4,TRUE,0,FALSE,21093,18649,7655,23.4
TRUE,FALSE,0,FALSE,15582,17281,-2058,21.2,TRUE,0,FALSE,17640,19332,2058,22.4
TRUE,FALSE,1,TRUE,15441,17550,-575,20.1,TRUE,0,FALSE,16016,17758,575,21.3
FALSE,TRUE,1,FALSE,16002,18467,1765,24.5,FALSE,0,FALSE,14237,17766,-1765,21.2
FALSE,TRUE,1,FALSE,16009,18033,540,22,FALSE,1,TRUE,15469,17764,-540,18.5
TRUE,FALSE,0,FALSE,18106,16668,862,18.6,TRUE,1,TRUE,17244,17110,-862,20.4
TRUE,TRUE,1,TRUE,16501,18428,2761,22.1,FALSE,0,FALSE,13740,16769,-2761,20.1
FALSE,FALSE,0,FALSE,15505,17721,-1249,22.7,TRUE,1,TRUE,16754,18574,1249,21.4
TRUE,FALSE,0,FALSE,16195,19145,-75,24.4,TRUE,1,TRUE,16270,18490,75,21.7
TRUE,TRUE,1,TRUE,20294,18459,5805,23,FALSE,0,FALSE,14489,13682,-5805,17.8
FALSE,FALSE,1,FALSE,15475,18145,-810,19.8,TRUE,1,TRUE,16285,18450,810,21.2
FALSE,TRUE,1,FALSE,16243,18154,1034,22.5,FALSE,0,FALSE,15209,17448,-1034,22.7
TRUE,TRUE,0,FALSE,15065,17137,-2595,23.1,FALSE,1,FALSE,17660,19993,2595,26
TRUE,FALSE,0,FALSE,14359,17258,-334,22.8,TRUE,1,TRUE,14693,17331,334,22.3
TRUE,TRUE,2,TRUE,19377,20008,3806,23.3,FALSE,0,FALSE,15571,17847,-3806,23.1
FALSE,FALSE,0,FALSE,14135,17185,-2711,22,TRUE,0,FALSE,16846,19732,2711,23
TRUE,TRUE,0,FALSE,17448,18315,2551,24.2,FALSE,0,FALSE,14897,16561,-2551,19.5
FALSE,TRUE,1,TRUE,15958,17693,66,21.3,FALSE,0,FALSE,15892,18139,-66,25.4
FALSE,FALSE,1,TRUE,18287,18402,2242,21.3,TRUE,0,FALSE,16045,17675,-2242,22.5
FALSE,FALSE,1,FALSE,15534,17975,-893,25.2,TRUE,0,FALSE,16427,18188,893,23.1
FALSE,FALSE,0,FALSE,14935,17703,-1208,23,TRUE,1,TRUE,16143,17855,1208,24.8
TRUE,FALSE,0,FALSE,19331,19387,4003,25.5,TRUE,1,TRUE,15328,16821,-4003,21.5
TRUE,FALSE,1,TRUE,17131,19719,819,24,TRUE,0,FALSE,16312,17570,-819,20.6
TRUE,TRUE,0,FALSE,17983,18340,4009,23,FALSE,1,FALSE,13974,16405,-4009,18.3
FALSE,FALSE,1,TRUE,16842,18443,-259,22.1,TRUE,0,FALSE,17101,19444,259,24.7
FALSE,TRUE,0,FALSE,17569,17101,1728,21.2,FALSE,0,FALSE,15841,17839,-1728,18
FALSE,FALSE,1,FALSE,15882,16956,474,24.1,TRUE,1,TRUE,15408,16563,-474,20.7
FALSE,TRUE,0,FALSE,17049,17241,1863,20.2,FALSE,0,FALSE,15186,16913,-1863,20.4
FALSE,FALSE,0,FALSE,13556,16451,-3846,20,TRUE,1,TRUE,17402,18757,3846,25.3
FALSE,FALSE,0,FALSE,14692,18342,-2373,22.7,TRUE,1,TRUE,17065,19934,2373,25
TRUE,FALSE,1,TRUE,17000,16417,218,20.4,TRUE,0,FALSE,16782,16621,-218,20.9
TRUE,TRUE,0,FALSE,17200,18984,2208,23.5,FALSE,0,FALSE,14992,17055,-2208,21.5
FALSE,FALSE,1,TRUE,15409,18408,-1440,21.7,TRUE,0,FALSE,16849,18781,1440,24.1
FALSE,FALSE,1,TRUE,17283,16235,-845,18.4,TRUE,0,FALSE,18128,17978,845,20.8
FALSE,FALSE,0,FALSE,15477,15965,-2635,17.3,TRUE,1,TRUE,18112,18659,2635,24.1
TRUE,FALSE,2,TRUE,16763,18897,2817,22.4,TRUE,0,FALSE,13946,16483,-2817,20.7
TRUE,FALSE,2,TRUE,18434,20263,2812,22.3,TRUE,0,FALSE,15622,17766,-2812,22.6
FALSE,FALSE,0,FALSE,13731,16666,-3864,21.8,TRUE,1,TRUE,17595,19425,3864,26.3
TRUE,FALSE,1,TRUE,17251,19984,334,23.3,TRUE,0,FALSE,16917,19029,-334,23
TRUE,TRUE,1,TRUE,17051,18864,1909,24.6,FALSE,0,FALSE,15142,16428,-1909,19.6
FALSE,TRUE,0,FALSE,16346,18557,-346,20.9,FALSE,0,FALSE,16692,18915,346,18.2
TRUE,TRUE,0,FALSE,21095,21242,5802,24.9,FALSE,1,TRUE,15293,15846,-5802,18.6
TRUE,TRUE,1,TRUE,16434,18641,1085,22.8,FALSE,0,FALSE,15349,17593,-1085,22
FALSE,TRUE,1,TRUE,15834,18362,-2383,19.7,FALSE,0,FALSE,18217,20169,2383,18.2
TRUE,FALSE,1,FALSE,16968,18900,306,21.4,TRUE,0,FALSE,16662,17005,-306,20.8
FALSE,TRUE,0,FALSE,15949,17005,-1568,20.9,FALSE,1,TRUE,17517,18855,1568,21.5
TRUE,FALSE,1,TRUE,16056,17578,-1419,23.4,TRUE,1,FALSE,17475,18734,1419,22.7
TRUE,TRUE,1,FALSE,18392,18818,2263,22.2,FALSE,1,TRUE,16129,17184,-2263,21.3
TRUE,TRUE,0,FALSE,16415,18271,1374,23,FALSE,1,TRUE,15041,17046,-1374,21.7
TRUE,FALSE,1,TRUE,19948,20064,4301,22,TRUE,0,FALSE,15647,16620,-4301,20.5
TRUE,TRUE,0,FALSE,18189,19191,3905,22,FALSE,0,FALSE,14284,15478,-3905,18.1
TRUE,FALSE,0,FALSE,14398,15990,-2919,19.4,TRUE,1,TRUE,17317,18308,2919,20.7
TRUE,TRUE,1,TRUE,17359,20592,2923,26.5,FALSE,0,FALSE,14436,17805,-2923,24.2
FALSE,FALSE,0,FALSE,15817,17535,-1059,21,TRUE,2,TRUE,16876,18486,1059,21.4
FALSE,FALSE,1,FALSE,15861,19121,-406,27,TRUE,1,TRUE,16267,19135,406,23.5
TRUE,FALSE,1,TRUE,16355,18991,1143,23.8,TRUE,0,FALSE,15212,17740,-1143,21.6
TRUE,FALSE,0,FALSE,18333,18622,736,22.5,TRUE,1,TRUE,17597,18356,-736,20.5
FALSE,TRUE,0,FALSE,14562,16952,-4816,19.6,FALSE,1,TRUE,19378,20702,4816,25.9
TRUE,FALSE,2,TRUE,19677,20488,3977,23.6,TRUE,0,FALSE,15700,16539,-3977,20.8
TRUE,FALSE,0,FALSE,18793,18395,3026,21.7,TRUE,1,TRUE,15767,15038,-3026,17.4
FALSE,FALSE,1,TRUE,14276,16422,-4262,19,TRUE,0,FALSE,18538,18848,4262,22.4
FALSE,TRUE,1,FALSE,16808,17831,2476,22.7,FALSE,1,TRUE,14332,17059,-2476,24.8
FALSE,FALSE,0,FALSE,15002,16448,-3545,21.7,TRUE,2,TRUE,18547,19654,3545,22.4
FALSE,FALSE,1,FALSE,14354,15677,-4324,17.3,TRUE,1,TRUE,18678,18656,4324,21.3
TRUE,FALSE,1,TRUE,15926,19262,-496,22.3,TRUE,0,FALSE,16422,20099,496,21.8
FALSE,FALSE,0,FALSE,14742,16162,-1620,24.1,TRUE,1,TRUE,16362,17604,1620,22.6
TRUE,TRUE,0,FALSE,16481,17069,-1334,20.1,FALSE,1,TRUE,17815,18676,1334,19.8
FALSE,TRUE,0,FALSE,16307,17660,-796,19.4,FALSE,0,FALSE,17103,17877,796,21.5
TRUE,TRUE,1,TRUE,16569,19120,1398,23.8,FALSE,0,FALSE,15171,17316,-1398,23.3
TRUE,TRUE,0,FALSE,17322,19067,3005,22.9,FALSE,0,FALSE,14317,17129,-3005,19.7
FALSE,TRUE,0,FALSE,14711,16559,-3156,22.2,FALSE,0,FALSE,17867,19846,3156,23.8
TRUE,FALSE,2,TRUE,16009,18511,-473,26.8,TRUE,0,FALSE,16482,18128,473,24.6
FALSE,FALSE,0,FALSE,15102,16437,-3397,19.6,TRUE,1,FALSE,18499,18719,3397,22.5
FALSE,FALSE,0,FALSE,15499,17298,-1937,22.2,TRUE,1,TRUE,17436,18812,1937,20.4
TRUE,TRUE,0,FALSE,18456,19319,3765,21.8,FALSE,0,FALSE,14691,16658,-3765,19.3
FALSE,TRUE,1,TRUE,15767,17413,384,22.4,FALSE,1,FALSE,15383,18103,-384,25
TRUE,TRUE,1,TRUE,18890,19229,2708,22.3,FALSE,0,FALSE,16182,18547,-2708,23
FALSE,TRUE,0,FALSE,14901,17696,-2427,20.9,FALSE,0,FALSE,17328,19158,2427,22.4
TRUE,TRUE,1,TRUE,16785,19346,1901,24.5,FALSE,0,FALSE,14884,18662,-1901,21.1
TRUE,FALSE,1,TRUE,18786,18509,2480,23.5,TRUE,1,FALSE,16306,16810,-2480,22.1
FALSE,FALSE,1,FALSE,14727,16272,-3581,21.9,TRUE,1,TRUE,18308,18739,3581,24.8
TRUE,TRUE,2,TRUE,18009,18763,2911,20,FALSE,0,FALSE,15098,17385,-2911,21.2
FALSE,FALSE,1,FALSE,14526,17366,-1245,22.4,TRUE,1,TRUE,15771,18736,1245,24.1
FALSE,FALSE,1,TRUE,16627,17397,166,21.2,TRUE,1,FALSE,16461,17894,-166,20.9
FALSE,FALSE,0,FALSE,13075,15488,-6309,16.9,TRUE,0,FALSE,19384,18603,6309,27
FALSE,FALSE,0,FALSE,16105,17502,-2047,21.4,TRUE,1,TRUE,18152,20057,2047,20.8
FALSE,TRUE,0,FALSE,14782,16677,-1464,21.3,FALSE,1,TRUE,16246,18186,1464,23.8
TRUE,TRUE,2,TRUE,15889,18189,874,21.7,FALSE,0,FALSE,15015,18491,-874,21.5
FALSE,TRUE,1,TRUE,15158,17387,-627,25,FALSE,0,FALSE,15785,17204,627,24.3
FALSE,FALSE,0,FALSE,15073,17578,-334,22.7,TRUE,0,FALSE,15407,17870,334,25.1
FALSE,TRUE,1,TRUE,17125,18785,449,24,FALSE,0,FALSE,16676,17575,-449,17.7
FALSE,FALSE,0,FALSE,16377,16818,-780,20.9,TRUE,0,FALSE,17157,16891,780,20
FALSE,FALSE,1,FALSE,15888,18421,-205,23.4,TRUE,0,FALSE,16093,17357,205,21.7
FALSE,FALSE,0,FALSE,14414,17356,-1731,22.6,TRUE,0,FALSE,16145,18941,1731,26.8
FALSE,FALSE,1,TRUE,18329,18315,947,21.9,TRUE,0,FALSE,17382,18503,-947,19.4
FALSE,TRUE,0,FALSE,16245,16720,-713,21.5,FALSE,1,TRUE,16958,17831,713,20.7
TRUE,TRUE,1,TRUE,16120,17683,1171,22.3,FALSE,0,FALSE,14949,18823,-1171,20.7
FALSE,TRUE,0,FALSE,15548,16604,-459,19.1,FALSE,1,TRUE,16007,16911,459,19.6
TRUE,TRUE,0,FALSE,17432,18495,2673,20.9,FALSE,1,TRUE,14759,17107,-2673,21.6
TRUE,TRUE,1,TRUE,16922,17350,-251,20.7,FALSE,0,FALSE,17173,19025,251,22.1
FALSE,TRUE,0,FALSE,16142,18818,534,24.5,FALSE,2,TRUE,15608,18184,-534,27.7
FALSE,FALSE,1,TRUE,14630,17694,-4005,21.1,TRUE,0,FALSE,18635,19942,4005,27.1
TRUE,TRUE,2,TRUE,15131,18134,-318,23.9,FALSE,0,FALSE,15449,18048,318,21.6
FALSE,TRUE,1,FALSE,17697,18512,2682,20.3,FALSE,1,TRUE,15015,16394,-2682,16.5
FALSE,TRUE,1,TRUE,16116,17653,2092,24.4,FALSE,0,FALSE,14024,15890,-2092,19.1
TRUE,FALSE,0,FALSE,18485,19949,2300,22.8,TRUE,0,FALSE,16185,17801,-2300,18.7
TRUE,TRUE,1,TRUE,16980,18593,2642,24.1,FALSE,0,FALSE,14338,17247,-2642,18.8
TRUE,TRUE,0,FALSE,17066,17494,2833,23.6,FALSE,1,TRUE,14233,17274,-2833,17.2
FALSE,TRUE,0,FALSE,17202,17447,-336,21.4,FALSE,1,TRUE,17538,18506,336,21.4
FALSE,FALSE,1,TRUE,14702,16461,-5136,21.4,TRUE,0,FALSE,19838,20174,5136,28.9
TRUE,FALSE,0,FALSE,18692,19886,1872,23.8,TRUE,0,FALSE,16820,16307,-1872,21.5
FALSE,FALSE,1,TRUE,18549,16837,-1048,18.2,TRUE,1,FALSE,19597,17287,1048,20.1
TRUE,FALSE,1,TRUE,15859,18390,-88,24.2,TRUE,0,FALSE,15947,19322,88,22.2
TRUE,FALSE,0,FALSE,16044,18226,-1427,22.4,TRUE,0,FALSE,17471,19234,1427,24.3
TRUE,FALSE,1,FALSE,15941,16613,-2440,18,TRUE,0,FALSE,18381,18216,2440,21.9
FALSE,TRUE,0,FALSE,15675,16844,-1614,22.9,FALSE,1,TRUE,17289,19100,1614,21.5
TRUE,FALSE,1,TRUE,15682,17438,-1075,23.4,TRUE,0,FALSE,16757,17365,1075,21.3
TRUE,TRUE,2,TRUE,15843,17154,-1799,19,FALSE,0,FALSE,17642,18458,1799,19.6
TRUE,TRUE,1,TRUE,18248,19855,3296,20.1,FALSE,0,FALSE,14952,16624,-3296,20.1
TRUE,FALSE,0,FALSE,15333,18073,-1942,20.1,TRUE,1,TRUE,17275,18016,1942,23.6
TRUE,TRUE,1,TRUE,17496,18253,2013,24.6,FALSE,0,FALSE,15483,18006,-2013,22.9
TRUE,TRUE,2,TRUE,19809,18530,3574,22.1,FALSE,0,FALSE,16235,17320,-3574,16.6
TRUE,TRUE,1,TRUE,19329,19021,6000,24.6,FALSE,1,FALSE,13329,13988,-6000,14.2
FALSE,FALSE,0,FALSE,15600,14986,-3128,19.3,TRUE,1,FALSE,18728,17306,3128,23.2
TRUE,FALSE,2,TRUE,16292,18889,1229,27.4,TRUE,0,FALSE,15063,17830,-1229,22
FALSE,TRUE,1,FALSE,17677,18225,1285,26.9,FALSE,1,TRUE,16392,16925,-1285,17.3
FALSE,FALSE,0,FALSE,15141,17635,-3274,17.6,TRUE,1,TRUE,18415,19020,3274,23.8
FALSE,FALSE,0,FALSE,14897,17306,-1770,21.2,TRUE,1,TRUE,16667,16981,1770,19.1
TRUE,TRUE,1,TRUE,17520,18610,1892,21.1,FALSE,0,FALSE,15628,17720,-1892,25
FALSE,TRUE,0,FALSE,17164,18932,525,22.2,FALSE,0,FALSE,16639,18030,-525,21.5
FALSE,TRUE,1,TRUE,15999,17033,-415,23.4,FALSE,0,FALSE,16414,17531,415,22.6
TRUE,FALSE,0,FALSE,14542,17517,-1751,23.4,TRUE,1,TRUE,16293,19102,1751,22.9
TRUE,TRUE,1,FALSE,20225,17976,4453,19.4,FALSE,1,TRUE,15772,15518,-4453,18.9
FALSE,TRUE,1,TRUE,18203,18175,1393,19.9,FALSE,0,FALSE,16810,17734,-1393,22.4
TRUE,FALSE,2,TRUE,16787,18618,534,25.3,TRUE,0,FALSE,16253,18464,-534,19.7
FALSE,TRUE,0,FALSE,14959,16588,-3301,22.6,FALSE,1,TRUE,18260,18834,3301,20.3
TRUE,FALSE,2,TRUE,15132,16489,-2022,19,TRUE,0,FALSE,17154,18512,2022,24.2
FALSE,FALSE,0,FALSE,16354,17848,176,25.2,TRUE,1,TRUE,16178,18020,-176,20.2
FALSE,FALSE,1,FALSE,14652,17192,-458,20.5,TRUE,1,TRUE,15110,17751,458,21
FALSE,TRUE,0,FALSE,15331,17540,676,18.2,FALSE,1,TRUE,14655,18116,-676,21.6
TRUE,FALSE,1,TRUE,17002,18755,2536,21.8,TRUE,1,FALSE,14466,15416,-2536,21
TRUE,FALSE,0,FALSE,16308,16771,-1751,18.9,TRUE,1,FALSE,18059,19555,1751,20
TRUE,FALSE,0,FALSE,16282,16826,-1516,19.8,TRUE,2,TRUE,17798,18293,1516,20.1
FALSE,TRUE,0,FALSE,14110,15832,-2566,16.2,FALSE,0,FALSE,16676,18078,2566,22.8
FALSE,TRUE,0,FALSE,15426,17467,-2023,22.6,FALSE,1,TRUE,17449,20145,2023,25.1
FALSE,FALSE,1,FALSE,15983,17562,-276,22.2,TRUE,0,FALSE,16259,17383,276,18.9
TRUE,TRUE,2,TRUE,16801,18563,1574,21.1,FALSE,0,FALSE,15227,16729,-1574,20
TRUE,FALSE,0,FALSE,17141,19142,2378,23.2,TRUE,1,TRUE,14763,16952,-2378,20.6
FALSE,TRUE,0,FALSE,15122,17694,-3223,19.5,FALSE,2,TRUE,18345,20212,3223,23.5
FALSE,FALSE,0,FALSE,16878,19372,808,23.8,TRUE,1,TRUE,16070,17957,-808,21.4
TRUE,TRUE,0,FALSE,18274,18615,3803,23.8,FALSE,0,FALSE,14471,15790,-3803,20.1
FALSE,FALSE,0,FALSE,14176,17054,-3360,19.4,TRUE,1,TRUE,17536,18896,3360,22.8
TRUE,FALSE,0,FALSE,17549,19231,2397,24.3,TRUE,1,FALSE,15152,17826,-2397,24.8
FALSE,TRUE,0,FALSE,16049,16758,-883,21.7,FALSE,0,FALSE,16932,18586,883,18.7
FALSE,TRUE,0,FALSE,14017,15893,-2638,22.9,FALSE,2,TRUE,16655,18371,2638,23.1
TRUE,TRUE,0,FALSE,20139,21898,5035,21.8,FALSE,0,FALSE,15104,16478,-5035,22.3
FALSE,TRUE,0,FALSE,16659,17777,-1003,23.4,FALSE,2,TRUE,17662,18676,1003,21.7
FALSE,TRUE,0,FALSE,15975,18165,-1963,22.7,FALSE,1,TRUE,17938,19316,1963,22.5
FALSE,FALSE,0,FALSE,16728,18284,-1071,22.1,TRUE,1,TRUE,17799,19755,1071,24.8
TRUE,TRUE,0,FALSE,16693,18761,897,22.7,FALSE,0,FALSE,15796,17671,-897,23.7
TRUE,TRUE,2,TRUE,15925,17913,1946,22.8,FALSE,0,FALSE,13979,16621,-1946,21.3
FALSE,FALSE,1,FALSE,16763,17433,-219,19.3,TRUE,1,TRUE,16982,18873,219,18.3
TRUE,TRUE,0,FALSE,16852,18660,1588,23.9,FALSE,0,FALSE,15264,17329,-1588,21.3
FALSE,FALSE,0,FALSE,14950,18134,-1889,23.4,TRUE,1,TRUE,16839,18857,1889,22.9
TRUE,FALSE,1,TRUE,14863,17436,-720,19.5,TRUE,0,FALSE,15583,17004,720,22.3
FALSE,TRUE,0,FALSE,15853,18223,-2388,22,FALSE,2,TRUE,18241,20201,2388,20.5
FALSE,FALSE,0,FALSE,13428,14121,-5668,16.7,TRUE,1,TRUE,19096,18907,5668,21.8
TRUE,FALSE,1,TRUE,17570,18283,527,23.8,TRUE,0,FALSE,17043,16790,-527,17.6
TRUE,TRUE,1,FALSE,16561,17961,1496,23.2,FALSE,1,TRUE,15065,18691,-1496,19.1
FALSE,FALSE,0,FALSE,15070,15375,-4245,14.2,TRUE,2,TRUE,19315,18448,4245,19.3
FALSE,TRUE,1,TRUE,19190,18615,3386,20.2,FALSE,1,FALSE,15804,16205,-3386,22.4
FALSE,FALSE,0,FALSE,14269,16844,-3145,20,TRUE,1,TRUE,17414,19010,3145,23.5
FALSE,FALSE,1,TRUE,14916,17511,-1325,23.9,TRUE,0,FALSE,16241,17526,1325,25.1
TRUE,FALSE,2,TRUE,16256,17637,-1623,23.1,TRUE,0,FALSE,17879,18781,1623,24.3
TRUE,FALSE,1,TRUE,15231,17617,1076,22.1,TRUE,0,FALSE,14155,16858,-1076,22.3
TRUE,FALSE,1,TRUE,16070,16577,-1156,17.3,TRUE,0,FALSE,17226,17244,1156,21.1
FALSE,FALSE,1,FALSE,15416,17935,450,22.8,TRUE,0,FALSE,14966,17944,-450,22
TRUE,TRUE,1,FALSE,19036,18857,4363,24.6,FALSE,0,FALSE,14673,14390,-4363,16.4
TRUE,TRUE,1,TRUE,18214,19670,2262,22,FALSE,0,FALSE,15952,16785,-2262,22.8
FALSE,TRUE,0,FALSE,17430,18068,-367,21.2,FALSE,0,FALSE,17797,17881,367,20.5
TRUE,FALSE,0,FALSE,16590,19041,1214,22.8,TRUE,1,TRUE,15376,16961,-1214,22.4
TRUE,TRUE,1,TRUE,15508,17062,1728,21.7,FALSE,0,FALSE,13780,17399,-1728,22.3
TRUE,TRUE,0,FALSE,16789,19024,959,21.8,FALSE,1,TRUE,15830,18107,-959,21.3
TRUE,TRUE,1,FALSE,16298,18210,924,23,FALSE,1,TRUE,15374,17887,-924,20.9
TRUE,TRUE,1,TRUE,19320,20189,4544,25.1,FALSE,0,FALSE,14776,17063,-4544,20.6
FALSE,FALSE,2,TRUE,14926,16530,-4847,21,TRUE,0,FALSE,19773,19513,4847,21.8
TRUE,TRUE,1,TRUE,17496,18327,1849,22,FALSE,1,FALSE,15647,17658,-1849,22.4
TRUE,FALSE,0,FALSE,15177,15795,-3891,15.2,TRUE,0,FALSE,19068,18484,3891,21.8
FALSE,TRUE,0,FALSE,17025,18038,-1314,23.1,FALSE,1,TRUE,18339,19980,1314,23.2
TRUE,TRUE,0,FALSE,18203,18324,2718,22.3,FALSE,0,FALSE,15485,18233,-2718,21.6
FALSE,FALSE,0,FALSE,15160,17505,-2174,21.7,TRUE,2,TRUE,17334,18773,2174,22.7
TRUE,TRUE,1,TRUE,15304,18188,1093,22.8,FALSE,0,FALSE,14211,17468,-1093,21.5
TRUE,FALSE,0,FALSE,17503,17699,-215,19.2,TRUE,0,FALSE,17718,18137,215,21
TRUE,TRUE,1,FALSE,16468,15869,635,22.6,FALSE,1,TRUE,15833,17026,-635,22.8
TRUE,FALSE,0,FALSE,19035,18221,120,21.9,TRUE,1,FALSE,18915,17012,-120,20.8
TRUE,FALSE,1,TRUE,18413,18554,194,21.9,TRUE,0,FALSE,18219,17893,-194,23
TRUE,TRUE,1,TRUE,18470,18925,3581,26.3,FALSE,0,FALSE,14889,17347,-3581,23.8
FALSE,FALSE,0,FALSE,16291,16699,-3622,19.1,TRUE,0,FALSE,19913,19260,3622,22.3
TRUE,TRUE,1,TRUE,16301,17430,-303,21,FALSE,1,FALSE,16604,17118,303,21
FALSE,FALSE,1,TRUE,17183,18225,-1295,19.6,TRUE,0,FALSE,18478,18530,1295,24.7
FALSE,FALSE,0,FALSE,13361,16819,-3006,17.4,TRUE,2,TRUE,16367,18699,3006,21.9
TRUE,TRUE,1,FALSE,14807,17246,1090,21.4,FALSE,1,TRUE,13717,16875,-1090,19.7
TRUE,FALSE,1,TRUE,15195,18358,324,21.7,TRUE,0,FALSE,14871,16564,-324,22.8
TRUE,TRUE,0,FALSE,14788,17345,-2025,21.5,FALSE,1,TRUE,16813,19793,2025,23.3
FALSE,TRUE,0,FALSE,16604,17328,-416,20.3,FALSE,1,TRUE,17020,18235,416,20.1
FALSE,TRUE,1,FALSE,15661,18861,62,23.2,FALSE,1,TRUE,15599,17707,-62,20.2
FALSE,TRUE,0,FALSE,16259,17235,-67,22.1,FALSE,1,TRUE,16326,18576,67,20
TRUE,FALSE,1,TRUE,19716,19989,5163,23.4,TRUE,0,FALSE,14553,16021,-5163,18.2
TRUE,TRUE,1,TRUE,18612,19203,2728,22.7,FALSE,0,FALSE,15884,17246,-2728,22.5
FALSE,FALSE,1,TRUE,14711,18284,-3559,20.4,TRUE,0,FALSE,18270,19684,3559,25.6
TRUE,TRUE,2,TRUE,16886,18261,184,22.1,FALSE,0,FALSE,16702,18392,-184,23.7
FALSE,TRUE,1,TRUE,14980,16983,-2040,20.6,FALSE,0,FALSE,17020,17995,2040,22.4
TRUE,TRUE,1,TRUE,16544,17551,2151,20.8,FALSE,0,FALSE,14393,16825,-2151,22.2
FALSE,FALSE,0,FALSE,16174,16725,-2452,14.9,TRUE,0,FALSE,18626,18359,2452,21
TRUE,TRUE,2,TRUE,18047,19362,3255,22.8,FALSE,0,FALSE,14792,17103,-3255,19.7
TRUE,TRUE,0,FALSE,17484,20325,1128,23,FALSE,1,TRUE,16356,19467,-1128,22.6
TRUE,TRUE,1,FALSE,17826,19427,1909,22.5,FALSE,0,FALSE,15917,18448,-1909,22
TRUE,FALSE,0,FALSE,18673,18121,3397,22.3,TRUE,0,FALSE,15276,16628,-3397,18.6
FALSE,FALSE,0,FALSE,17540,17368,-3563,18.2,TRUE,1,TRUE,21103,18688,3563,19.8
FALSE,TRUE,1,TRUE,16808,17370,-361,23.1,FALSE,0,FALSE,17169,15684,361,21.4
TRUE,FALSE,1,FALSE,15227,18442,-513,20.3,TRUE,0,FALSE,15740,17450,513,22.6
TRUE,FALSE,0,FALSE,19392,18570,4872,23.9,TRUE,0,FALSE,14520,15494,-4872,20.3
FALSE,FALSE,1,FALSE,17194,18397,985,23.4,TRUE,0,FALSE,16209,16295,-985,21.5
TRUE,TRUE,1,TRUE,15672,17821,-1599,23.8,FALSE,1,FALSE,17271,19691,1599,23.6
TRUE,FALSE,1,TRUE,18565,19562,1719,21.6,TRUE,0,FALSE,16846,17859,-1719,24.2
FALSE,FALSE,0,FALSE,13921,16963,-2641,20.7,TRUE,1,FALSE,16562,19170,2641,24.2
FALSE,TRUE,0,FALSE,14521,16234,-2846,20.1,FALSE,2,TRUE,17367,18559,2846,22.9
FALSE,FALSE,0,FALSE,15049,17888,-3891,20.9,TRUE,1,TRUE,18940,20164,3891,22.1
TRUE,FALSE,1,TRUE,20127,19575,6202,23.4,TRUE,0,FALSE,13925,14207,-6202,17.5
TRUE,FALSE,0,FALSE,17194,19539,2330,25.3,TRUE,0,FALSE,14864,17372,-2330,21.9
FALSE,TRUE,0,FALSE,19122,19334,3089,23.8,FALSE,0,FALSE,16033,17584,-3089,16.9
TRUE,FALSE,0,FALSE,16359,17998,540,19.8,TRUE,0,FALSE,15819,17131,-540,18.7
TRUE,TRUE,1,FALSE,17027,17816,508,21.3,FALSE,1,TRUE,16519,19520,-508,23.1
FALSE,TRUE,1,TRUE,17665,18125,625,21.3,FALSE,0,FALSE,17040,19160,-625,22.8
TRUE,TRUE,1,TRUE,17209,18853,2481,21.9,FALSE,0,FALSE,14728,16891,-2481,19.5
TRUE,TRUE,1,TRUE,19187,19762,2796,21.1,FALSE,0,FALSE,16391,17093,-2796,20.5
TRUE,FALSE,1,TRUE,17482,19093,2089,21.4,TRUE,0,FALSE,15393,16970,-2089,22.2
TRUE,TRUE,1,TRUE,16035,16853,-608,19,FALSE,0,FALSE,16643,17556,608,21
FALSE,TRUE,0,FALSE,16070,16510,-1923,19.9,FALSE,0,FALSE,17993,18263,1923,21.1
FALSE,FALSE,0,FALSE,15617,18169,-951,20.9,TRUE,1,TRUE,16568,18715,951,20.6
TRUE,TRUE,1,TRUE,16130,17156,1428,24.2,FALSE,0,FALSE,14702,16455,-1428,20
FALSE,TRUE,1,TRUE,17172,18972,1131,19.6,FALSE,1,FALSE,16041,17827,-1131,23.1
FALSE,FALSE,1,FALSE,15475,16428,-1972,19.5,TRUE,0,FALSE,17447,17438,1972,23
FALSE,TRUE,0,FALSE,16248,18067,-2242,17.1,FALSE,1,TRUE,18490,19886,2242,22.9
TRUE,TRUE,1,TRUE,16745,17908,2287,21.5,FALSE,1,FALSE,14458,18176,-2287,18
FALSE,FALSE,0,FALSE,16472,18966,1367,21.9,TRUE,1,FALSE,15105,16570,-1367,18
TRUE,TRUE,2,TRUE,18133,20427,2580,25.9,FALSE,0,FALSE,15553,17473,-2580,21.4
FALSE,FALSE,1,TRUE,17068,15357,786,15.3,TRUE,0,FALSE,16282,15919,-786,19.9
TRUE,TRUE,2,TRUE,16635,19221,152,23.5,FALSE,0,FALSE,16483,19278,-152,23.3
TRUE,TRUE,0,FALSE,17950,18805,2802,22.6,FALSE,1,TRUE,15148,18524,-2802,21.3
FALSE,FALSE,0,FALSE,14494,15922,-1610,22.4,TRUE,1,TRUE,16104,17315,1610,23.9
TRUE,FALSE,0,FALSE,18595,18307,1543,19.9,TRUE,1,TRUE,17052,18328,-1543,17.2
TRUE,FALSE,0,FALSE,19767,17678,1915,18,TRUE,0,FALSE,17852,15072,-1915,17.6
TRUE,FALSE,1,TRUE,14970,17530,-595,21.2,TRUE,0,FALSE,15565,17166,595,23.8
FALSE,TRUE,0,FALSE,15891,17964,-1190,20.7,FALSE,0,FALSE,17081,18875,1190,22.4
TRUE,TRUE,1,FALSE,16472,18393,1820,25.2,FALSE,1,TRUE,14652,17587,-1820,23.9
FALSE,FALSE,2,TRUE,15210,17099,-2630,18.5,TRUE,0,FALSE,17840,19343,2630,22.2
TRUE,FALSE,0,FALSE,16096,16891,-1327,17.5,TRUE,1,TRUE,17423,17680,1327,19.8
TRUE,FALSE,0,FALSE,16870,18433,1417,20.7,TRUE,1,FALSE,15453,17417,-1417,22.1
FALSE,TRUE,1,TRUE,15842,18640,71,24,FALSE,0,FALSE,15771,18231,-71,22.7
TRUE,FALSE,0,FALSE,15297,18319,17,20.2,TRUE,1,TRUE,15280,17267,-17,21
FALSE,TRUE,2,TRUE,16412,18381,151,21.2,FALSE,0,FALSE,16261,17541,-151,21.2
TRUE,TRUE,1,TRUE,19013,20151,4817,22.5,FALSE,1,FALSE,14196,16931,-4817,18.4
FALSE,FALSE,0,FALSE,14842,16718,-3400,20.3,TRUE,1,TRUE,18242,19481,3400,24.1
FALSE,TRUE,0,FALSE,16684,17071,-944,21.3,FALSE,1,TRUE,17628,17627,944,18.7
FALSE,FALSE,1,TRUE,15235,17625,-2839,19.5,TRUE,1,FALSE,18074,17607,2839,22
TRUE,TRUE,1,TRUE,18159,17740,818,23.8,FALSE,0,FALSE,17341,17905,-818,19.2
FALSE,FALSE,0,FALSE,13916,15087,-6286,16.6,TRUE,2,TRUE,20202,19820,6286,25.9
FALSE,FALSE,0,FALSE,15107,16753,-3799,20,TRUE,1,TRUE,18906,20038,3799,22.6
TRUE,FALSE,2,TRUE,18597,19612,4428,24.3,TRUE,0,FALSE,14169,16123,-4428,22.1
TRUE,TRUE,0,FALSE,18640,20923,4388,24.9,FALSE,1,TRUE,14252,17396,-4388,22.1
FALSE,FALSE,1,TRUE,15483,17110,-3045,21.3,TRUE,0,FALSE,18528,18744,3045,24.9
FALSE,FALSE,0,FALSE,15242,18202,-1497,26,TRUE,1,FALSE,16739,18980,1497,25.7
FALSE,FALSE,1,TRUE,14945,16491,-1696,21.5,TRUE,0,FALSE,16641,18644,1696,22.6
TRUE,FALSE,0,FALSE,17197,16987,733,18.5,TRUE,1,FALSE,16464,18467,-733,24.5
TRUE,TRUE,1,TRUE,17292,17127,-606,20,FALSE,0,FALSE,17898,18614,606,19.7
FALSE,FALSE,0,FALSE,14822,18244,-2420,23.1,TRUE,1,FALSE,17242,18997,2420,24.6
FALSE,FALSE,0,FALSE,15027,17054,-2037,21.1,TRUE,1,TRUE,17064,16944,2037,19.7
TRUE,FALSE,0,FALSE,15502,17035,631,22.1,TRUE,1,TRUE,14871,15631,-631,20.7
FALSE,FALSE,1,FALSE,16931,18446,-1570,20.9,TRUE,1,TRUE,18501,20549,1570,22.8
TRUE,FALSE,1,TRUE,16787,18466,-471,20.1,TRUE,0,FALSE,17258,17596,471,22.9
TRUE,FALSE,0,FALSE,15022,18105,-1211,22,TRUE,0,FALSE,16233,18213,1211,21.6
TRUE,TRUE,1,FALSE,17365,19227,2740,24.5,FALSE,1,TRUE,14625,17519,-2740,21.3
TRUE,FALSE,1,FALSE,17658,19584,1947,24.1,TRUE,0,FALSE,15711,17063,-1947,24.7
TRUE,TRUE,0,FALSE,19549,20404,4712,26.6,FALSE,0,FALSE,14837,16606,-4712,20.3
FALSE,TRUE,1,TRUE,16516,19033,1115,22.4,FALSE,0,FALSE,15401,17777,-1115,20.9
TRUE,FALSE,0,FALSE,15177,18017,-833,18.9,TRUE,0,FALSE,16010,18133,833,25.2
TRUE,FALSE,0,FALSE,18520,19054,564,22,TRUE,1,TRUE,17956,18421,-564,22.6
FALSE,TRUE,1,FALSE,18600,19763,-589,18.3,FALSE,0,FALSE,19189,17969,589,22.3
TRUE,TRUE,0,FALSE,18439,19278,3020,24.9,FALSE,0,FALSE,15419,16685,-3020,21.1
TRUE,TRUE,1,TRUE,15632,15789,-1339,19.6,FALSE,1,FALSE,16971,18591,1339,21.6
FALSE,TRUE,1,TRUE,17161,17817,1487,15.7,FALSE,1,FALSE,15674,17240,-1487,20.3
TRUE,TRUE,2,TRUE,15263,17693,579,21.6,FALSE,0,FALSE,14684,17730,-579,24.5
TRUE,TRUE,0,FALSE,16396,17294,975,16.8,FALSE,0,FALSE,15421,16635,-975,19.1
TRUE,TRUE,1,TRUE,17592,17430,1417,18.6,FALSE,0,FALSE,16175,16259,-1417,22
TRUE,TRUE,2,TRUE,17802,18461,2768,23.9,FALSE,0,FALSE,15034,17050,-2768,21.1
TRUE,TRUE,0,FALSE,20047,19339,3897,22.6,FALSE,1,TRUE,16150,16781,-3897,19.9
FALSE,FALSE,0,FALSE,13795,16505,-4631,20.3,TRUE,1,TRUE,18426,20117,4631,22.9
FALSE,FALSE,0,FALSE,15714,17852,-46,24.3,TRUE,2,TRUE,15760,18310,46,19.3
FALSE,FALSE,0,FALSE,16418,17847,-258,24.3,TRUE,1,TRUE,16676,18266,258,21.1
TRUE,FALSE,1,TRUE,18012,19378,2845,26.1,TRUE,0,FALSE,15167,15346,-2845,18.5
FALSE,FALSE,0,FALSE,14558,15833,-3177,19.4,TRUE,1,TRUE,17735,19104,3177,20.7
TRUE,TRUE,1,TRUE,17779,18276,2988,24.7,FALSE,0,FALSE,14791,17878,-2988,21
TRUE,TRUE,1,TRUE,16931,18085,2443,22.5,FALSE,0,FALSE,14488,16519,-2443,20.1
TRUE,TRUE,2,TRUE,16555,18782,-11,22.4,FALSE,0,FALSE,16566,18958,11,22.7
TRUE,FALSE,1,TRUE,16891,18030,286,18.5,TRUE,0,FALSE,16605,18013,-286,21.4
FALSE,TRUE,2,TRUE,16940,17580,90,22.2,FALSE,0,FALSE,16850,18399,-90,21.9
TRUE,FALSE,0,FALSE,17242,19085,403,23.6,TRUE,0,FALSE,16839,17295,-403,21.6
TRUE,TRUE,0,FALSE,17734,19335,3135,20.7,FALSE,0,FALSE,14599,16713,-3135,22.8
FALSE,FALSE,0,FALSE,17982,18544,372,20.4,TRUE,1,TRUE,17610,18384,-372,22.3
TRUE,FALSE,1,TRUE,16162,18095,-1636,21.1,TRUE,0,FALSE,17798,18967,1636,22.6
TRUE,TRUE,2,TRUE,18574,19415,5586,22.7,FALSE,0,FALSE,12988,15357,-5586,18.7
FALSE,FALSE,0,FALSE,15123,17214,-2105,23.2,TRUE,1,TRUE,17228,18308,2105,23.4
TRUE,FALSE,1,FALSE,16075,18425,-1374,21.1,TRUE,1,TRUE,17449,19078,1374,23.7
FALSE,FALSE,0,FALSE,14443,16433,-2166,19.8,TRUE,1,FALSE,16609,19318,2166,18.8
TRUE,FALSE,0,FALSE,16656,18582,930,25.2,TRUE,0,FALSE,15726,18307,-930,20.5
FALSE,FALSE,1,TRUE,15938,17247,-950,19.6,TRUE,0,FALSE,16888,17897,950,18.5
TRUE,TRUE,1,TRUE,14116,16837,-2421,21.7,FALSE,1,FALSE,16537,18522,2421,26.4
TRUE,FALSE,0,FALSE,17054,17591,-891,21.1,TRUE,1,TRUE,17945,18224,891,21.9
TRUE,FALSE,0,FALSE,15306,17734,-211,22.6,TRUE,1,TRUE,15517,17502,211,20.2
TRUE,TRUE,0,FALSE,16193,18763,-405,23.5,FALSE,2,TRUE,16598,20286,405,24.8
TRUE,TRUE,0,FALSE,18126,18581,2361,22.2,FALSE,1,TRUE,15765,16079,-2361,17.6
TRUE,FALSE,1,TRUE,17592,17635,-134,21.4,TRUE,0,FALSE,17726,18200,134,22.1
TRUE,TRUE,1,TRUE,16282,16018,2062,17.3,FALSE,0,FALSE,14220,14898,-2062,17.4
TRUE,TRUE,1,FALSE,17167,18274,2089,24.7,FALSE,1,TRUE,15078,16503,-2089,20.2
FALSE,FALSE,0,FALSE,15679,16096,-5377,17.2,TRUE,2,TRUE,21056,19345,5377,23
TRUE,TRUE,1,TRUE,16045,17256,-282,21.6,FALSE,1,FALSE,16327,17335,282,18.2
FALSE,FALSE,0,FALSE,16564,18202,-443,21.3,TRUE,0,FALSE,17007,18649,443,21.6
FALSE,FALSE,0,FALSE,14376,17660,-3122,20.8,TRUE,0,FALSE,17498,18889,3122,23.1
FALSE,FALSE,1,TRUE,14128,16843,-2425,21.4,TRUE,0,FALSE,16553,18621,2425,23.3
TRUE,FALSE,0,FALSE,14584,17432,-813,20.1,TRUE,1,TRUE,15397,16592,813,19.5
TRUE,FALSE,0,FALSE,18457,19590,1378,21.8,TRUE,2,TRUE,17079,17912,-1378,21.9
FALSE,FALSE,0,FALSE,18282,19001,1542,24,TRUE,1,TRUE,16740,17942,-1542,21.2
FALSE,FALSE,0,FALSE,17130,18060,-1553,23.2,TRUE,1,TRUE,18683,18484,1553,24.7
TRUE,TRUE,1,TRUE,17759,19034,4250,24.9,FALSE,0,FALSE,13509,16348,-4250,22.3
TRUE,TRUE,1,FALSE,17194,18529,2772,19.7,FALSE,0,FALSE,14422,16389,-2772,18.8
TRUE,TRUE,1,TRUE,16527,18240,-484,22.5,FALSE,0,FALSE,17011,19656,484,22.1
TRUE,TRUE,2,TRUE,17915,18641,1110,22.3,FALSE,0,FALSE,16805,19185,-1110,23.5
FALSE,FALSE,1,FALSE,17610,18110,1467,23.2,TRUE,1,TRUE,16143,18099,-1467,22.2
TRUE,TRUE,2,TRUE,19453,18043,1095,16.5,FALSE,0,FALSE,18358,17949,-1095,22.7
TRUE,TRUE,1,TRUE,18772,18771,5169,25.5,FALSE,0,FALSE,13603,16618,-5169,20
FALSE,FALSE,0,FALSE,14626,17441,-1547,22.9,TRUE,2,TRUE,16173,18357,1547,24.6
TRUE,TRUE,0,FALSE,20387,18610,5680,23.2,FALSE,1,TRUE,14707,16435,-5680,19.6
FALSE,TRUE,0,FALSE,17256,18564,823,23.6,FALSE,0,FALSE,16433,18728,-823,23
TRUE,TRUE,2,TRUE,16601,18535,1799,23.1,FALSE,0,FALSE,14802,18093,-1799,23.1
FALSE,FALSE,1,FALSE,14672,17598,-757,24.7,TRUE,1,TRUE,15429,17029,757,24.2
TRUE,TRUE,1,TRUE,17001,17576,91,18.7,FALSE,0,FALSE,16910,17915,-91,23.7
FALSE,FALSE,1,FALSE,18213,18240,-1538,21.7,TRUE,1,TRUE,19751,18610,1538,22.5
TRUE,FALSE,2,TRUE,19862,20693,2228,25.2,TRUE,0,FALSE,17634,19169,-2228,22.8
FALSE,TRUE,0,FALSE,18179,19225,4869,24.2,FALSE,1,TRUE,13310,15982,-4869,21
TRUE,FALSE,0,FALSE,15796,17499,640,23.4,TRUE,0,FALSE,15156,17619,-640,23.6
TRUE,FALSE,0,FALSE,15377,16348,-1871,17.7,TRUE,0,FALSE,17248,18123,1871,22.7
FALSE,FALSE,0,FALSE,14874,16128,-2189,18.2,TRUE,1,TRUE,17063,17966,2189,20.7
FALSE,TRUE,0,FALSE,17780,17456,474,24.5,FALSE,0,FALSE,17306,18231,-474,20.7
FALSE,FALSE,0,FALSE,16804,16732,-1072,18.4,TRUE,0,FALSE,17876,17378,1072,19.4
FALSE,TRUE,0,FALSE,17372,17530,-2817,20.2,FALSE,1,TRUE,20189,19230,2817,21.8
TRUE,FALSE,1,TRUE,15162,16973,-243,19.5,TRUE,0,FALSE,15405,17438,243,23.5
FALSE,FALSE,1,TRUE,14742,16390,-1517,20.2,TRUE,0,FALSE,16259,17955,1517,25.5
FALSE,FALSE,0,FALSE,13078,15827,-3205,18.4,TRUE,1,TRUE,16283,19227,3205,21
FALSE,FALSE,0,FALSE,13886,17234,-2820,20.3,TRUE,1,TRUE,16706,19985,2820,25.5
TRUE,TRUE,1,TRUE,16632,16709,1722,21.2,FALSE,0,FALSE,14910,15699,-1722,22.4
TRUE,TRUE,2,TRUE,17215,19549,1978,26.4,FALSE,0,FALSE,15237,17954,-1978,19.9
TRUE,TRUE,0,FALSE,17528,18271,171,19.1,FALSE,0,FALSE,17357,17653,-171,20.9
FALSE,FALSE,1,TRUE,16555,19152,659,25.2,TRUE,1,FALSE,15896,18747,-659,23.8
TRUE,FALSE,1,TRUE,15246,16135,-2974,17.4,TRUE,1,FALSE,18220,18881,2974,19.8
FALSE,FALSE,0,FALSE,14033,15049,-3078,18.4,TRUE,1,TRUE,17111,18355,3078,20.4
FALSE,TRUE,0,FALSE,16778,17473,1153,20.5,FALSE,1,TRUE,15625,17191,-1153,20.3
TRUE,TRUE,2,TRUE,18960,20136,3878,22.5,FALSE,0,FALSE,15082,17274,-3878,20.4
TRUE,TRUE,2,TRUE,17065,18930,2717,22,FALSE,0,FALSE,14348,17373,-2717,22.7
TRUE,TRUE,0,FALSE,18283,19207,3038,24.3,FALSE,1,TRUE,15245,16043,-3038,14.7
FALSE,FALSE,0,FALSE,15190,16345,-1903,19.6,TRUE,1,TRUE,17093,16929,1903,20.6
TRUE,TRUE,0,FALSE,18192,18534,3518,22.9,FALSE,1,TRUE,14674,15691,-3518,18.8
TRUE,FALSE,0,FALSE,17329,17342,216,21.2,TRUE,0,FALSE,17113,17083,-216,18.1
FALSE,TRUE,0,FALSE,16422,18934,-509,24.7,FALSE,1,TRUE,16931,19130,509,21.8
FALSE,FALSE,0,FALSE,17385,18061,978,20.8,TRUE,1,FALSE,16407,17689,-978,22.6
TRUE,TRUE,1,TRUE,16663,18021,1884,18.8,FALSE,0,FALSE,14779,16150,-1884,20.8
TRUE,TRUE,1,FALSE,17902,18882,2224,18.6,FALSE,1,TRUE,15678,16820,-2224,20.8
FALSE,FALSE,1,FALSE,17398,18429,-1079,20.6,TRUE,1,TRUE,18477,18177,1079,23.3
FALSE,FALSE,0,FALSE,15532,17712,-1768,20.1,TRUE,2,TRUE,17300,19490,1768,25.3
FALSE,FALSE,1,TRUE,15412,17010,-886,19.7,TRUE,0,FALSE,16298,17486,886,20.5
TRUE,TRUE,0,FALSE,17718,18091,3017,20.9,FALSE,0,FALSE,14701,16641,-3017,19.7
FALSE,TRUE,1,TRUE,17055,17918,-431,19.9,FALSE,0,FALSE,17486,17798,431,22.1
FALSE,FALSE,0,FALSE,16020,17180,-2618,21.5,TRUE,0,FALSE,18638,19817,2618,21.2
FALSE,TRUE,2,TRUE,16254,17969,-740,20.3,FALSE,0,FALSE,16994,18634,740,23.8
TRUE,TRUE,1,FALSE,19201,18883,3982,21.4,FALSE,0,FALSE,15219,15426,-3982,18.2
FALSE,FALSE,0,FALSE,15994,17730,-2028,21.1,TRUE,1,TRUE,18022,19470,2028,24.2
TRUE,FALSE,1,FALSE,20352,19537,5649,23.2,TRUE,1,TRUE,14703,15869,-5649,20
FALSE,FALSE,0,FALSE,12756,16250,-4949,19,TRUE,2,TRUE,17705,20260,4949,25.3
TRUE,TRUE,2,TRUE,18661,19718,4867,23.3,FALSE,0,FALSE,13794,15507,-4867,16.9
FALSE,FALSE,2,TRUE,15488,18660,-978,26.5,TRUE,0,FALSE,16466,18886,978,22
FALSE,FALSE,0,FALSE,17547,18409,2425,21.4,TRUE,0,FALSE,15122,16983,-2425,23.3
TRUE,TRUE,1,TRUE,19189,20302,3815,22.7,FALSE,0,FALSE,15374,17576,-3815,20.3
TRUE,TRUE,1,TRUE,16749,18142,976,19.2,FALSE,0,FALSE,15773,15885,-976,20.9
TRUE,TRUE,1,TRUE,16214,18139,862,25.7,FALSE,0,FALSE,15352,18565,-862,21.9
FALSE,TRUE,0,FALSE,15500,18238,-403,21.6,FALSE,1,TRUE,15903,18264,403,24.2
FALSE,FALSE,0,FALSE,14735,17898,-2204,21.9,TRUE,1,FALSE,16939,19374,2204,24.3
TRUE,TRUE,1,TRUE,17489,16724,-219,22.1,FALSE,0,FALSE,17708,17999,219,22.6
TRUE,TRUE,1,FALSE,20380,20228,5330,23,FALSE,1,TRUE,15050,16188,-5330,17.3
TRUE,TRUE,2,TRUE,18048,19194,3414,22.7,FALSE,0,FALSE,14634,17586,-3414,23.7
FALSE,TRUE,0,FALSE,15843,16776,792,22,FALSE,0,FALSE,15051,17398,-792,18.5
TRUE,TRUE,0,FALSE,16810,18437,-146,22.4,FALSE,2,TRUE,16956,18836,146,23.5
FALSE,TRUE,1,FALSE,15204,17694,-1578,18.2,FALSE,0,FALSE,16782,19418,1578,25
TRUE,TRUE,0,FALSE,16006,18385,-769,22.5,FALSE,1,TRUE,16775,19086,769,23.5
TRUE,FALSE,0,FALSE,16746,17690,1860,20.4,TRUE,0,FALSE,14886,15892,-1860,22.5
TRUE,TRUE,0,FALSE,17648,18419,3525,18.1,FALSE,0,FALSE,14123,15440,-3525,18.3
TRUE,TRUE,1,TRUE,18047,18071,679,20.2,FALSE,1,FALSE,17368,18376,-679,20.6
FALSE,FALSE,0,FALSE,13976,17001,-2555,21,TRUE,1,TRUE,16531,18897,2555,23.4
FALSE,TRUE,0,FALSE,17264,18859,765,19.6,FALSE,2,TRUE,16499,18434,-765,21.2
FALSE,TRUE,0,FALSE,16767,18062,-1221,22.8,FALSE,2,TRUE,17988,20442,1221,25.2
TRUE,FALSE,0,FALSE,19488,20329,4492,23,TRUE,1,TRUE,14996,17118,-4492,18.1
FALSE,FALSE,0,FALSE,15875,17351,186,24.1,TRUE,0,FALSE,15689,17624,-186,23.2
TRUE,TRUE,1,TRUE,17717,19042,1227,20.3,FALSE,0,FALSE,16490,18046,-1227,22.5
TRUE,FALSE,1,FALSE,16864,19251,-70,24,TRUE,1,TRUE,16934,19707,70,22.3
FALSE,FALSE,0,FALSE,14788,17425,-1605,22.7,TRUE,0,FALSE,16393,18760,1605,25.2
FALSE,FALSE,0,FALSE,14743,15965,-3465,19.7,TRUE,1,TRUE,18208,19316,3465,22.4
FALSE,TRUE,1,FALSE,17949,16183,-431,17.2,FALSE,1,TRUE,18380,17205,431,20.7
TRUE,FALSE,0,FALSE,17737,18303,1083,19.3,TRUE,0,FALSE,16654,17852,-1083,20.7
FALSE,FALSE,0,FALSE,15307,18407,-1259,21.8,TRUE,0,FALSE,16566,18767,1259,25
FALSE,FALSE,0,FALSE,13973,15260,-6801,16.6,TRUE,1,FALSE,20774,19871,6801,23.4
TRUE,TRUE,1,TRUE,18089,18770,1158,22.5,FALSE,1,FALSE,16931,18579,-1158,20.2
TRUE,TRUE,2,TRUE,17224,18597,2053,23.7,FALSE,0,FALSE,15171,17226,-2053,23.7
TRUE,FALSE,0,FALSE,17649,18664,604,18.7,TRUE,1,TRUE,17045,16681,-604,18.7
TRUE,FALSE,1,FALSE,16886,17965,75,24.4,TRUE,1,TRUE,16811,17349,-75,19.5
FALSE,TRUE,0,FALSE,14584,16647,-542,23.5,FALSE,0,FALSE,15126,17574,542,21.1
TRUE,TRUE,0,FALSE,17331,17982,1099,20.1,FALSE,1,TRUE,16232,18080,-1099,19.5
TRUE,TRUE,1,TRUE,17763,18822,2183,24.6,FALSE,0,FALSE,15580,18559,-2183,21.2
TRUE,TRUE,2,TRUE,16814,18549,791,22,FALSE,0,FALSE,16023,18325,-791,22.8
FALSE,FALSE,0,FALSE,14500,16097,-3614,20.9,TRUE,1,FALSE,18114,19531,3614,22.2
FALSE,TRUE,2,TRUE,17435,19432,1220,23.6,FALSE,0,FALSE,16215,18843,-1220,24.1
FALSE,TRUE,0,FALSE,14682,17105,-1827,19.9,FALSE,0,FALSE,16509,19164,1827,23.5
FALSE,FALSE,0,FALSE,16752,18737,583,22.9,TRUE,1,TRUE,16169,17986,-583,20.1
FALSE,TRUE,1,FALSE,15649,18818,-334,22.7,FALSE,1,TRUE,15983,19872,334,23.8
FALSE,FALSE,0,FALSE,16124,17595,-2494,23.2,TRUE,1,TRUE,18618,18783,2494,23
TRUE,TRUE,0,FALSE,21132,19294,2658,23.6,FALSE,0,FALSE,18474,16887,-2658,15.4
TRUE,FALSE,1,TRUE,17569,17411,-116,22.8,TRUE,1,FALSE,17685,17714,116,20.7
TRUE,TRUE,2,TRUE,17097,16795,-197,20.2,FALSE,0,FALSE,17294,19186,197,21.9
FALSE,FALSE,0,FALSE,16906,18034,760,21.8,TRUE,0,FALSE,16146,17513,-760,24.4
TRUE,FALSE,0,FALSE,16632,18912,1224,23.3,TRUE,1,TRUE,15408,17653,-1224,22.8
FALSE,FALSE,0,FALSE,13449,15122,-6076,18,TRUE,1,FALSE,19525,18229,6076,19.3
FALSE,FALSE,1,TRUE,16712,17809,-2339,19,TRUE,0,FALSE,19051,18726,2339,22.8
TRUE,TRUE,0,FALSE,16372,18954,2590,27.9,FALSE,1,TRUE,13782,17629,-2590,22.6
FALSE,TRUE,1,TRUE,17384,19286,2175,23.5,FALSE,0,FALSE,15209,17877,-2175,22.2
FALSE,TRUE,1,TRUE,17075,18328,1188,22.9,FALSE,0,FALSE,15887,18612,-1188,18.2
FALSE,FALSE,0,FALSE,18860,22224,1651,23.3,TRUE,1,TRUE,17209,18322,-1651,21.5
FALSE,FALSE,0,FALSE,15381,19473,-187,21.1,TRUE,1,TRUE,15568,17338,187,23.8
FALSE,FALSE,0,FALSE,13545,15716,-4868,18,TRUE,1,TRUE,18413,19876,4868,24.2
FALSE,FALSE,0,FALSE,13256,16464,-4149,20.2,TRUE,1,FALSE,17405,19686,4149,27.2
FALSE,FALSE,0,FALSE,14423,16966,-2602,21.9,TRUE,0,FALSE,17025,18392,2602,24.9
TRUE,TRUE,1,TRUE,17551,18910,-1018,24.4,FALSE,0,FALSE,18569,17796,1018,20.4
TRUE,FALSE,0,FALSE,19537,18358,2718,18.9,TRUE,1,TRUE,16819,17173,-2718,21.1
TRUE,TRUE,1,TRUE,20218,18620,4899,19.9,FALSE,0,FALSE,15319,16205,-4899,16.5
TRUE,FALSE,0,FALSE,15191,16443,-1344,19.3,TRUE,1,TRUE,16535,19040,1344,20.7
TRUE,TRUE,1,TRUE,18802,18095,3781,22.4,FALSE,0,FALSE,15021,16370,-3781,22.2
TRUE,TRUE,1,TRUE,17116,19290,3328,23.7,FALSE,0,FALSE,13788,15594,-3328,17.3
TRUE,TRUE,1,TRUE,18230,17602,2114,19.5,FALSE,0,FALSE,16116,17527,-2114,19.8
FALSE,TRUE,1,TRUE,15829,18055,-464,22.8,FALSE,0,FALSE,16293,18102,464,20.8
TRUE,FALSE,2,TRUE,14729,18508,-17,22.8,TRUE,0,FALSE,14746,17920,17,19.2
TRUE,FALSE,0,FALSE,17793,19086,1300,20.8,TRUE,1,TRUE,16493,16030,-1300,22.1
TRUE,TRUE,2,TRUE,17525,19534,3884,24,FALSE,0,FALSE,13641,17219,-3884,23.8
FALSE,FALSE,1,TRUE,17579,18266,475,22.4,TRUE,0,FALSE,17104,17260,-475,20.5
TRUE,TRUE,2,TRUE,18227,19568,2689,25.6,FALSE,0,FALSE,15538,16741,-2689,22.4
FALSE,FALSE,1,FALSE,14898,17842,-1367,19.2,TRUE,0,FALSE,16265,18039,1367,21.9
FALSE,TRUE,1,TRUE,15769,17360,-2999,22.2,FALSE,0,FALSE,18768,18836,2999,23.2
FALSE,FALSE,1,FALSE,19272,16786,-967,18.8,TRUE,0,FALSE,20239,17751,967,22.2
FALSE,TRUE,1,TRUE,17788,19078,1969,25.5,FALSE,1,FALSE,15819,17581,-1969,23.4
FALSE,FALSE,0,FALSE,14738,17148,-4199,19.7,TRUE,1,TRUE,18937,20334,4199,24.1
TRUE,TRUE,0,FALSE,16113,17058,-105,23.1,FALSE,1,TRUE,16218,17954,105,21.7
FALSE,TRUE,1,FALSE,18967,17807,3652,23.1,FALSE,0,FALSE,15315,16265,-3652,19.4
FALSE,FALSE,0,FALSE,15416,18096,-83,25.3,TRUE,1,TRUE,15499,18160,83,23
FALSE,TRUE,0,FALSE,18096,18969,2526,23.2,FALSE,1,TRUE,15570,17590,-2526,19.4
FALSE,FALSE,1,TRUE,14411,16806,-1864,21,TRUE,1,FALSE,16275,18751,1864,19.8
TRUE,TRUE,1,FALSE,15668,18873,787,25,FALSE,1,TRUE,14881,18392,-787,22.1
FALSE,TRUE,1,FALSE,16288,17321,-1222,19.3,FALSE,1,TRUE,17510,19655,1222,22.1
FALSE,TRUE,0,FALSE,18575,18974,-204,19.8,FALSE,1,TRUE,18779,17624,204,21.1
FALSE,TRUE,1,TRUE,17379,19080,1759,25.1,FALSE,1,FALSE,15620,17370,-1759,22
FALSE,FALSE,1,TRUE,15222,17667,-1650,22,TRUE,1,FALSE,16872,19025,1650,21.7
TRUE,TRUE,1,TRUE,16191,18795,290,23.8,FALSE,0,FALSE,15901,18178,-290,24.2
FALSE,TRUE,1,TRUE,14930,17328,-3418,23.1,FALSE,0,FALSE,18348,20017,3418,26.3
FALSE,TRUE,0,FALSE,17062,19299,1922,23.8,FALSE,0,FALSE,15140,17429,-1922,19.1
FALSE,FALSE,0,FALSE,14763,16159,-3584,20.5,TRUE,1,TRUE,18347,18616,3584,25.4
FALSE,TRUE,0,FALSE,15351,13858,-2827,16.9,FALSE,1,TRUE,18178,16533,2827,18.1
FALSE,FALSE,0,FALSE,17625,18727,817,21.2,TRUE,1,FALSE,16808,16405,-817,20.9
TRUE,FALSE,0,FALSE,15933,19079,75,25.9,TRUE,1,TRUE,15858,18543,-75,26.2
FALSE,FALSE,0,FALSE,18229,19238,-1502,19.8,TRUE,1,TRUE,19731,19559,1502,18.6
TRUE,FALSE,0,FALSE,15356,17995,-1706,23,TRUE,1,TRUE,17062,18999,1706,20.9
TRUE,FALSE,1,FALSE,17005,18098,274,21.6,TRUE,1,TRUE,16731,17080,-274,20
TRUE,FALSE,0,FALSE,16747,18344,1058,19.8,TRUE,1,TRUE,15689,16609,-1058,19.8
FALSE,FALSE,0,FALSE,16060,16426,-1776,18.7,TRUE,0,FALSE,17836,19691,1776,24.8
FALSE,TRUE,0,FALSE,14998,15234,-2698,19.7,FALSE,1,TRUE,17696,18874,2698,23.2
FALSE,TRUE,0,FALSE,16182,17791,-95,22.1,FALSE,1,TRUE,16277,18904,95,21.6
FALSE,TRUE,1,FALSE,17065,19772,519,21.4,FALSE,1,TRUE,16546,18766,-519,20.4
FALSE,TRUE,1,TRUE,15544,18579,-873,22.2,FALSE,0,FALSE,16417,18279,873,24
TRUE,FALSE,1,TRUE,16541,18666,-1514,22.5,TRUE,0,FALSE,18055,19295,1514,23.9
TRUE,FALSE,1,TRUE,15112,16369,-973,18.4,TRUE,0,FALSE,16085,17043,973,23.1
FALSE,FALSE,0,FALSE,17550,18186,-1499,22.9,TRUE,1,FALSE,19049,19468,1499,24.7
TRUE,TRUE,2,TRUE,18323,20458,4011,26.2,FALSE,0,FALSE,14312,17726,-4011,20.8
TRUE,TRUE,2,TRUE,18553,18785,4957,24.8,FALSE,0,FALSE,13596,15567,-4957,21.4
FALSE,FALSE,0,FALSE,15252,17517,-615,22.5,TRUE,1,TRUE,15867,17864,615,22.9
TRUE,TRUE,0,FALSE,16863,17725,783,20.6,FALSE,1,TRUE,16080,18026,-783,18.6
FALSE,FALSE,1,TRUE,13925,18363,-3617,21.6,TRUE,0,FALSE,17542,20330,3617,26
TRUE,TRUE,0,FALSE,16828,17273,912,21.7,FALSE,1,TRUE,15916,17514,-912,21.7
FALSE,TRUE,1,FALSE,15391,16275,-2746,18.9,FALSE,0,FALSE,18137,19050,2746,24.7
TRUE,TRUE,0,FALSE,16350,18701,1290,24.5,FALSE,0,FALSE,15060,17364,-1290,23.6
TRUE,FALSE,0,FALSE,17159,19172,-71,22.3,TRUE,1,TRUE,17230,18178,71,22.9
FALSE,FALSE,1,FALSE,15484,18316,-2528,22.6,TRUE,1,TRUE,18012,19198,2528,23.6
TRUE,TRUE,0,FALSE,17024,19195,901,25.4,FALSE,0,FALSE,16123,18013,-901,21.4
TRUE,TRUE,0,FALSE,18680,19206,2013,22,FALSE,2,TRUE,16667,18184,-2013,21
FALSE,FALSE,2,TRUE,14657,16983,-3113,18.8,TRUE,0,FALSE,17770,18754,3113,20.1
FALSE,TRUE,1,TRUE,15550,17134,-1467,19.1,FALSE,0,FALSE,17017,19050,1467,21.3
FALSE,FALSE,1,TRUE,15861,17082,-3197,20.8,TRUE,0,FALSE,19058,18482,3197,20.8
TRUE,FALSE,0,FALSE,15202,19256,-31,22.5,TRUE,1,TRUE,15233,18407,31,21.8
FALSE,FALSE,1,FALSE,15214,16970,-802,21.1,TRUE,1,TRUE,16016,17812,802,20.9
FALSE,TRUE,1,TRUE,16171,16898,-1642,21.4,FALSE,1,FALSE,17813,18938,1642,23.5
FALSE,FALSE,0,FALSE,18184,20169,2989,23.8,TRUE,0,FALSE,15195,15650,-2989,19.2
TRUE,TRUE,1,TRUE,16751,17829,2197,24.7,FALSE,0,FALSE,14554,16122,-2197,19.3
FALSE,FALSE,1,TRUE,16973,18787,2983,25,TRUE,1,FALSE,13990,17210,-2983,19.9
TRUE,FALSE,2,TRUE,17239,19174,1167,22.2,TRUE,0,FALSE,16072,16806,-1167,18.2
FALSE,FALSE,0,FALSE,14660,17284,-3941,23.2,TRUE,1,TRUE,18601,19670,3941,19.5
FALSE,TRUE,1,TRUE,17429,17309,720,21.1,FALSE,0,FALSE,16709,17492,-720,21
TRUE,TRUE,0,FALSE,18513,18739,4098,25,FALSE,0,FALSE,14415,17735,-4098,19.4
TRUE,TRUE,1,TRUE,16225,17742,2430,23.1,FALSE,0,FALSE,13795,15719,-2430,17.9
FALSE,TRUE,1,TRUE,16267,17908,206,24.7,FALSE,0,FALSE,16061,18272,-206,22.8
FALSE,TRUE,0,FALSE,15478,17551,-1003,23.3,FALSE,0,FALSE,16481,19122,1003,23.6
FALSE,FALSE,2,TRUE,16335,18087,600,21.2,TRUE,0,FALSE,15735,18168,-600,24.6
TRUE,FALSE,0,FALSE,14826,16660,-1596,20.4,TRUE,1,FALSE,16422,17978,1596,21.4
TRUE,TRUE,0,FALSE,19092,19183,2035,22.6,FALSE,1,TRUE,17057,17995,-2035,21.4
FALSE,TRUE,1,FALSE,17619,18563,1273,18.6,FALSE,1,TRUE,16346,17941,-1273,18.6
TRUE,FALSE,0,FALSE,16872,17906,-1232,19.9,TRUE,1,TRUE,18104,18178,1232,22.5
TRUE,TRUE,1,TRUE,17265,17683,1726,23.3,FALSE,0,FALSE,15539,16260,-1726,19.2
TRUE,TRUE,0,FALSE,19308,18764,2036,24.3,FALSE,0,FALSE,17272,16581,-2036,16.4
TRUE,TRUE,1,TRUE,16535,17930,-1123,23,FALSE,1,FALSE,17658,19595,1123,22.5
FALSE,FALSE,0,FALSE,16606,18604,-1325,22.6,TRUE,1,TRUE,17931,18540,1325,23.3
FALSE,TRUE,1,TRUE,17168,17668,-25,21.2,FALSE,0,FALSE,17193,15819,25,19.6
FALSE,FALSE,0,FALSE,14839,17555,-1089,21.5,TRUE,0,FALSE,15928,18337,1089,22.5
TRUE,TRUE,0,FALSE,17812,18372,1745,24.4,FALSE,1,TRUE,16067,17192,-1745,21.6
FALSE,FALSE,0,FALSE,14827,17341,-1838,20.1,TRUE,1,TRUE,16665,18925,1838,23
TRUE,FALSE,1,FALSE,15578,17702,-1018,22.9,TRUE,0,FALSE,16596,18826,1018,24
FALSE,FALSE,1,TRUE,16628,17255,-105,21.5,TRUE,1,FALSE,16733,16021,105,21.3
FALSE,TRUE,1,TRUE,14609,16875,-2141,21.8,FALSE,1,FALSE,16750,19314,2141,25.3
FALSE,FALSE,0,FALSE,13325,16064,-3573,17.1,TRUE,2,TRUE,16898,18561,3573,23
TRUE,FALSE,0,FALSE,15277,17286,-2105,23.4,TRUE,1,TRUE,17382,17374,2105,19.1
FALSE,TRUE,0,FALSE,16287,17787,25,22.6,FALSE,0,FALSE,16262,17785,-25,22.6
FALSE,FALSE,1,TRUE,12747,14396,-6435,18,TRUE,0,FALSE,19182,19512,6435,22.7
FALSE,TRUE,1,TRUE,17687,18503,-609,20.6,FALSE,0,FALSE,18296,19007,609,22.5
TRUE,TRUE,1,FALSE,17187,18382,1546,23.2,FALSE,0,FALSE,15641,18321,-1546,24
FALSE,FALSE,0,FALSE,14015,15677,-4929,17.8,TRUE,1,TRUE,18944,19022,4929,22.8
TRUE,TRUE,0,FALSE,16291,18130,164,22.8,FALSE,0,FALSE,16127,18352,-164,22.7
TRUE,FALSE,0,FALSE,16289,19421,1025,22.9,TRUE,2,TRUE,15264,18145,-1025,27.1
TRUE,TRUE,0,FALSE,17234,18799,1474,22.8,FALSE,0,FALSE,15760,17798,-1474,20.1
FALSE,TRUE,0,FALSE,14663,15749,-2454,20.1,FALSE,1,FALSE,17117,19565,2454,21.3
TRUE,TRUE,1,FALSE,16278,18389,269,24.4,FALSE,0,FALSE,16009,17909,-269,21.9
TRUE,FALSE,1,FALSE,19025,16965,-524,15,TRUE,1,TRUE,19549,17869,524,18.5
TRUE,FALSE,0,FALSE,15366,17861,-1364,23,TRUE,1,TRUE,16730,17948,1364,24.3
FALSE,FALSE,0,FALSE,14526,17736,-2320,24.6,TRUE,1,TRUE,16846,19454,2320,24.8
TRUE,TRUE,1,TRUE,16547,19666,1268,25.9,FALSE,0,FALSE,15279,17961,-1268,24.9
TRUE,TRUE,1,TRUE,14936,17688,-1543,23.1,FALSE,0,FALSE,16479,18197,1543,25
FALSE,FALSE,1,TRUE,15594,16987,-2997,21.3,TRUE,0,FALSE,18591,19016,2997,22.2
FALSE,TRUE,0,FALSE,17416,18429,-367,20.8,FALSE,1,TRUE,17783,20200,367,24.3
FALSE,FALSE,1,TRUE,15722,17329,-3309,22.1,TRUE,0,FALSE,19031,20070,3309,23
FALSE,TRUE,1,FALSE,16091,20383,1188,25.6,FALSE,1,TRUE,14903,17532,-1188,24.4
FALSE,TRUE,0,FALSE,15048,17356,-1138,18.3,FALSE,1,TRUE,16186,18223,1138,25.3
TRUE,TRUE,0,FALSE,23335,20839,6790,23.9,FALSE,0,FALSE,16545,15491,-6790,12.9
TRUE,TRUE,1,FALSE,18272,19342,3723,23.3,FALSE,1,TRUE,14549,15565,-3723,19.6
FALSE,FALSE,1,TRUE,16270,18195,748,22.3,TRUE,0,FALSE,15522,18272,-748,20.8
TRUE,FALSE,0,FALSE,17298,16912,326,23.3,TRUE,1,TRUE,16972,15440,-326,21
TRUE,TRUE,2,TRUE,17230,17823,1449,24.4,FALSE,0,FALSE,15781,18353,-1449,22.9
FALSE,TRUE,1,TRUE,17098,17045,-635,20.1,FALSE,0,FALSE,17733,18056,635,20.8
FALSE,TRUE,1,FALSE,17380,18220,1060,21.1,FALSE,1,TRUE,16320,17732,-1060,21.5
FALSE,FALSE,1,FALSE,16829,17978,-489,19.8,TRUE,1,TRUE,17318,17790,489,21.6
FALSE,TRUE,0,FALSE,14538,16871,-2335,21.8,FALSE,1,TRUE,16873,19658,2335,23.6
TRUE,TRUE,1,TRUE,15159,17115,-2496,21.7,FALSE,1,FALSE,17655,19289,2496,24
FALSE,FALSE,0,FALSE,14874,16504,-2695,17.7,TRUE,1,TRUE,17569,17546,2695,24.9
FALSE,TRUE,2,TRUE,17721,18253,1160,22.6,FALSE,0,FALSE,16561,17314,-1160,21.3
TRUE,TRUE,1,TRUE,20273,19742,4982,25.4,FALSE,0,FALSE,15291,17771,-4982,19.5
TRUE,TRUE,1,TRUE,20103,17668,4688,22,FALSE,0,FALSE,15415,16685,-4688,17.2
TRUE,TRUE,0,FALSE,16491,17031,1774,19.9,FALSE,0,FALSE,14717,15726,-1774,17
TRUE,TRUE,1,TRUE,17640,19566,2768,23.3,FALSE,0,FALSE,14872,16805,-2768,22
TRUE,TRUE,1,TRUE,15518,16862,-686,19.7,FALSE,1,FALSE,16204,17481,686,24.9
FALSE,TRUE,2,TRUE,17381,18495,1418,22,FALSE,0,FALSE,15963,17951,-1418,22.5
FALSE,FALSE,1,TRUE,15127,17750,-5,23.8,TRUE,0,FALSE,15132,18019,5,20.3
FALSE,FALSE,0,FALSE,13794,14884,-4000,18.3,TRUE,0,FALSE,17794,17417,4000,24.5
TRUE,FALSE,0,FALSE,15139,17354,-243,24,TRUE,1,TRUE,15382,16555,243,20.6
FALSE,TRUE,0,FALSE,15929,18460,-709,22.9,FALSE,1,TRUE,16638,18607,709,23.2
TRUE,FALSE,2,TRUE,14974,18286,-726,22.4,TRUE,0,FALSE,15700,18317,726,21.6
TRUE,FALSE,1,TRUE,19695,19512,3936,25.8,TRUE,1,FALSE,15759,17401,-3936,20.5
TRUE,TRUE,1,TRUE,15154,17000,-277,21.9,FALSE,0,FALSE,15431,16792,277,22.4
FALSE,FALSE,1,TRUE,14766,16507,-2769,19,TRUE,0,FALSE,17535,17327,2769,22.9
FALSE,FALSE,1,TRUE,17341,18528,1513,20.9,TRUE,0,FALSE,15828,16943,-1513,22.2
TRUE,TRUE,2,TRUE,15464,17833,-736,21.8,FALSE,0,FALSE,16200,17927,736,22.3
TRUE,TRUE,0,FALSE,18529,19610,1334,25.1,FALSE,1,TRUE,17195,18954,-1334,20.2
TRUE,FALSE,0,FALSE,18149,18067,3036,20.2,TRUE,1,TRUE,15113,16301,-3036,22.2
FALSE,TRUE,1,FALSE,15840,16848,1811,21.2,FALSE,1,TRUE,14029,17479,-1811,22.1
TRUE,TRUE,0,FALSE,17915,19197,1451,21.5,FALSE,0,FALSE,16464,17212,-1451,22.2
FALSE,TRUE,1,FALSE,16242,18244,-598,23.5,FALSE,1,TRUE,16840,18390,598,22.9
TRUE,TRUE,1,TRUE,18498,20017,1446,23.8,FALSE,0,FALSE,17052,18420,-1446,22.9
FALSE,TRUE,1,TRUE,19120,17735,1618,21.9,FALSE,0,FALSE,17502,17342,-1618,20.7
TRUE,FALSE,1,TRUE,17948,16194,93,19.3,TRUE,0,FALSE,17855,17470,-93,21.9
FALSE,FALSE,0,FALSE,16517,17531,1183,21.9,TRUE,0,FALSE,15334,16644,-1183,19.2
FALSE,FALSE,0,FALSE,13452,15569,-3453,17,TRUE,1,TRUE,16905,16289,3453,21.2
FALSE,FALSE,0,FALSE,15687,17057,-1655,21,TRUE,1,TRUE,17342,18380,1655,21.5
FALSE,FALSE,1,TRUE,14763,16834,-4462,17.9,TRUE,0,FALSE,19225,19824,4462,25.5
FALSE,FALSE,0,FALSE,16417,16981,557,21.1,TRUE,0,FALSE,15860,15920,-557,19.4
TRUE,TRUE,0,FALSE,18168,20892,2527,25.4,FALSE,0,FALSE,15641,17419,-2527,22
FALSE,FALSE,0,FALSE,15903,17263,-1831,18.9,TRUE,2,TRUE,17734,19867,1831,22.6
TRUE,TRUE,1,FALSE,14702,16741,649,24.4,FALSE,1,TRUE,14053,16672,-649,21.4
FALSE,FALSE,0,FALSE,18874,19652,3091,22.4,TRUE,0,FALSE,15783,17154,-3091,21.5
FALSE,FALSE,1,TRUE,15225,17939,-2707,21.1,TRUE,0,FALSE,17932,19765,2707,20.9
FALSE,FALSE,0,FALSE,15858,17491,-512,24.6,TRUE,2,TRUE,16370,18335,512,24.1
FALSE,FALSE,0,FALSE,14693,15883,-3874,16.9,TRUE,0,FALSE,18567,18306,3874,22.3
TRUE,TRUE,1,TRUE,15574,17686,-100,21.7,FALSE,0,FALSE,15674,17467,100,24
FALSE,FALSE,0,FALSE,15692,17765,506,22.1,TRUE,1,TRUE,15186,16185,-506,18.2
TRUE,TRUE,0,FALSE,18297,19315,4796,25.1,FALSE,0,FALSE,13501,16203,-4796,20.3
TRUE,FALSE,2,TRUE,19247,16835,-1709,20.5,TRUE,0,FALSE,20956,18420,1709,18.2
FALSE,FALSE,0,FALSE,15414,17341,-553,23.6,TRUE,0,FALSE,15967,17455,553,19.4
TRUE,FALSE,1,TRUE,19601,20002,3190,22.7,TRUE,1,FALSE,16411,17656,-3190,21.4
FALSE,FALSE,1,FALSE,15189,17014,-1720,22.5,TRUE,1,TRUE,16909,19070,1720,24.8
FALSE,TRUE,0,FALSE,16452,17540,-480,23.2,FALSE,0,FALSE,16932,17187,480,19.2
FALSE,FALSE,0,FALSE,14899,17481,-1081,23.8,TRUE,1,TRUE,15980,18112,1081,20.9
TRUE,TRUE,1,TRUE,18964,19620,5436,25.5,FALSE,0,FALSE,13528,16161,-5436,18.3
TRUE,TRUE,1,TRUE,18923,18586,5323,23.6,FALSE,0,FALSE,13600,16234,-5323,19.1
FALSE,FALSE,0,FALSE,17472,18276,-214,22.9,TRUE,2,TRUE,17686,18632,214,21.1
FALSE,FALSE,1,TRUE,14665,15990,-2705,18.8,TRUE,0,FALSE,17370,17747,2705,22.6
TRUE,TRUE,1,FALSE,16415,17432,1419,21.3,FALSE,1,TRUE,14996,17350,-1419,22.3
FALSE,FALSE,0,FALSE,13960,15286,-5431,19.1,TRUE,0,FALSE,19391,19967,5431,20
FALSE,FALSE,0,FALSE,14773,16673,-4125,20.2,TRUE,1,TRUE,18898,19385,4125,23.7
TRUE,TRUE,2,TRUE,19181,19634,3153,24.7,FALSE,0,FALSE,16028,16438,-3153,18.5
FALSE,TRUE,1,TRUE,14528,16282,-3991,17.5,FALSE,0,FALSE,18519,19811,3991,23.9
FALSE,FALSE,0,FALSE,15827,17709,-1694,21.8,TRUE,1,FALSE,17521,18312,1694,23.9
FALSE,FALSE,1,FALSE,16179,17928,989,21.5,TRUE,0,FALSE,15190,17297,-989,21.2
TRUE,FALSE,1,TRUE,15049,17760,-1564,24.7,TRUE,0,FALSE,16613,18713,1564,24.2
FALSE,FALSE,0,FALSE,15453,18464,-664,20.9,TRUE,1,TRUE,16117,17849,664,18
TRUE,FALSE,1,TRUE,14645,18690,-1377,25.6,TRUE,1,FALSE,16022,18870,1377,28.9
FALSE,FALSE,1,TRUE,15766,16285,-1089,19.7,TRUE,0,FALSE,16855,18419,1089,22.6
TRUE,TRUE,2,TRUE,18890,18772,4234,22.7,FALSE,0,FALSE,14656,17077,-4234,21.4
FALSE,FALSE,1,FALSE,16450,18541,-702,23.8,TRUE,1,TRUE,17152,18630,702,22.6
FALSE,TRUE,1,FALSE,16490,17576,-508,22.5,FALSE,1,TRUE,16998,18970,508,25.7
TRUE,TRUE,0,FALSE,17408,18740,2366,19.3,FALSE,1,TRUE,15042,17593,-2366,23.1
TRUE,FALSE,1,TRUE,16951,18426,248,22.9,TRUE,1,FALSE,16703,18645,-248,24.5
TRUE,TRUE,1,TRUE,17120,17636,1426,16.3,FALSE,0,FALSE,15694,17508,-1426,20.7
FALSE,FALSE,0,FALSE,14310,17797,-740,20.7,TRUE,1,TRUE,15050,17721,740,24.2
FALSE,FALSE,2,TRUE,14689,18046,-1724,24.1,TRUE,0,FALSE,16413,18308,1724,26
TRUE,TRUE,1,TRUE,18341,19070,3311,21.7,FALSE,0,FALSE,15030,16388,-3311,22.8
FALSE,TRUE,0,FALSE,17772,19337,3401,25.1,FALSE,1,TRUE,14371,16945,-3401,20.4
FALSE,TRUE,0,FALSE,16262,18551,-1293,22.4,FALSE,0,FALSE,17555,19176,1293,24.3
TRUE,FALSE,0,FALSE,16239,18466,906,18.9,TRUE,1,TRUE,15333,16699,-906,22.1
FALSE,FALSE,0,FALSE,16944,17663,-2761,19.3,TRUE,1,TRUE,19705,20038,2761,22.7
TRUE,TRUE,2,TRUE,16939,17733,1419,21.1,FALSE,0,FALSE,15520,17002,-1419,22.7
FALSE,TRUE,0,FALSE,14615,18302,-1530,22.1,FALSE,1,TRUE,16145,19416,1530,24.3
TRUE,FALSE,0,FALSE,17706,18475,216,23.1,TRUE,0,FALSE,17490,17225,-216,20.4
FALSE,TRUE,1,TRUE,17727,18993,1521,21.7,FALSE,1,FALSE,16206,17078,-1521,19.8
FALSE,FALSE,0,FALSE,12988,14678,-5264,15.3,TRUE,2,TRUE,18252,19305,5264,27.3
TRUE,TRUE,1,TRUE,17613,19092,3949,23.4,FALSE,0,FALSE,13664,16652,-3949,21.6
TRUE,TRUE,1,TRUE,18632,19093,2907,22.7,FALSE,0,FALSE,15725,17918,-2907,20.4
TRUE,TRUE,1,TRUE,15476,18246,-706,23.3,FALSE,0,FALSE,16182,19119,706,24.4
FALSE,TRUE,0,FALSE,15717,17679,-527,22.4,FALSE,1,TRUE,16244,17887,527,19.9
TRUE,FALSE,1,TRUE,18253,17351,1683,24,TRUE,0,FALSE,16570,17523,-1683,20.3
FALSE,TRUE,0,FALSE,14349,16271,-1005,20.5,FALSE,0,FALSE,15354,16522,1005,22.8
FALSE,FALSE,1,TRUE,15407,17007,-1122,23.2,TRUE,0,FALSE,16529,17309,1122,21.4
FALSE,TRUE,1,TRUE,15273,17539,-808,21.1,FALSE,0,FALSE,16081,17850,808,23.8
FALSE,TRUE,0,FALSE,14868,16330,-2281,18.2,FALSE,1,TRUE,17149,17924,2281,20.9
TRUE,FALSE,0,FALSE,14892,17899,-1750,19.9,TRUE,1,TRUE,16642,18527,1750,25
TRUE,TRUE,0,FALSE,18509,20432,2974,22.3,FALSE,1,TRUE,15535,19011,-2974,21.3
TRUE,FALSE,0,FALSE,17096,19253,419,24.1,TRUE,1,TRUE,16677,18791,-419,24.7
TRUE,FALSE,2,TRUE,17377,19245,2101,24.7,TRUE,0,FALSE,15276,17649,-2101,19.3
FALSE,FALSE,1,TRUE,16554,18512,-776,23.5,TRUE,0,FALSE,17330,18346,776,25.9
TRUE,FALSE,0,FALSE,15256,16513,-957,21,TRUE,1,TRUE,16213,18780,957,23.5
TRUE,TRUE,2,TRUE,17710,19233,4311,23,FALSE,0,FALSE,13399,15994,-4311,20.1
FALSE,FALSE,1,TRUE,15041,16622,-1207,21.4,TRUE,0,FALSE,16248,18370,1207,22.8
TRUE,TRUE,2,TRUE,19027,19029,4616,24.7,FALSE,0,FALSE,14411,16979,-4616,18.7
TRUE,TRUE,2,TRUE,18718,18807,2404,21.4,FALSE,0,FALSE,16314,17880,-2404,22.8
FALSE,FALSE,1,TRUE,16938,19399,600,23.1,TRUE,1,FALSE,16338,18575,-600,22.9
TRUE,TRUE,0,FALSE,16772,18456,1936,25.5,FALSE,1,TRUE,14836,16657,-1936,20.5
TRUE,FALSE,1,TRUE,16035,16424,-4685,16,TRUE,0,FALSE,20720,20024,4685,24.4
FALSE,FALSE,1,TRUE,15518,16768,315,23.4,TRUE,0,FALSE,15203,16829,-315,21.6
FALSE,TRUE,1,FALSE,17543,17748,994,19.5,FALSE,1,TRUE,16549,18295,-994,21.5
TRUE,FALSE,1,FALSE,15829,17924,450,24.2,TRUE,1,TRUE,15379,17263,-450,23.9
TRUE,FALSE,1,FALSE,17389,18695,110,23.1,TRUE,0,FALSE,17279,19097,-110,23.1
TRUE,FALSE,0,FALSE,16683,18315,-396,23.1,TRUE,2,TRUE,17079,17834,396,24.6
FALSE,FALSE,0,FALSE,16985,18802,-805,24,TRUE,1,TRUE,17790,18548,805,22.1
FALSE,TRUE,0,FALSE,14904,15958,-1302,22.2,FALSE,2,TRUE,16206,17917,1302,19.4
FALSE,TRUE,1,TRUE,17551,17463,1763,23.7,FALSE,0,FALSE,15788,17702,-1763,21.3
FALSE,FALSE,1,TRUE,15278,16785,-1993,18.6,TRUE,0,FALSE,17271,18963,1993,21.1
FALSE,FALSE,2,TRUE,15539,17101,8,19.1,TRUE,0,FALSE,15531,16529,-8,20.8
TRUE,TRUE,0,FALSE,17860,17606,1240,17.2,FALSE,1,FALSE,16620,17955,-1240,20.2
TRUE,TRUE,1,TRUE,15156,17247,-1063,20.7,FALSE,0,FALSE,16219,19282,1063,22.9
TRUE,TRUE,1,TRUE,18152,18823,22,22.3,FALSE,1,FALSE,18130,17050,-22,20
TRUE,TRUE,0,FALSE,16587,18340,-16,25.2,FALSE,2,TRUE,16603,17843,16,24.2
FALSE,FALSE,1,TRUE,15562,18694,-526,23.5,TRUE,0,FALSE,16088,18198,526,21.9
TRUE,FALSE,0,FALSE,14944,16969,-916,20,TRUE,1,TRUE,15860,17628,916,19.3
FALSE,FALSE,1,TRUE,15269,16739,-2793,19.4,TRUE,0,FALSE,18062,17794,2793,20.4
FALSE,FALSE,0,FALSE,17166,18945,-1561,22.4,TRUE,2,TRUE,18727,18020,1561,17.7
TRUE,FALSE,0,FALSE,14813,16945,-3707,18.2,TRUE,2,TRUE,18520,18687,3707,22.5
FALSE,TRUE,0,FALSE,15787,16711,-2457,20.5,FALSE,1,FALSE,18244,18336,2457,23.8
FALSE,FALSE,0,FALSE,14795,15646,-2348,17.2,TRUE,1,TRUE,17143,16892,2348,19.3
TRUE,TRUE,1,TRUE,19848,19712,5275,22.4,FALSE,0,FALSE,14573,16050,-5275,22.7
FALSE,TRUE,0,FALSE,13886,15720,-3413,22.2,FALSE,1,TRUE,17299,18799,3413,24.5
TRUE,FALSE,0,FALSE,16149,17146,-1286,21.2,TRUE,0,FALSE,17435,17994,1286,19
TRUE,FALSE,0,FALSE,15312,16667,-1785,17.4,TRUE,2,TRUE,17097,18248,1785,21.6
TRUE,TRUE,1,TRUE,17267,18482,3107,22.4,FALSE,0,FALSE,14160,16386,-3107,21.8
FALSE,FALSE,1,TRUE,15961,17670,-41,22.4,TRUE,0,FALSE,16002,18678,41,23.3
TRUE,TRUE,0,FALSE,17704,18183,639,19.6,FALSE,0,FALSE,17065,17012,-639,20.8
FALSE,FALSE,0,FALSE,14808,18642,-2041,24,TRUE,1,TRUE,16849,19732,2041,22.7
FALSE,TRUE,1,TRUE,16374,18711,412,22.7,FALSE,0,FALSE,15962,18618,-412,23.4
FALSE,TRUE,0,FALSE,16933,18512,2836,24.2,FALSE,1,FALSE,14097,18064,-2836,20.7
TRUE,TRUE,0,FALSE,18156,18548,957,20.8,FALSE,2,TRUE,17199,18079,-957,21.8
TRUE,FALSE,0,FALSE,19397,19301,2287,23.2,TRUE,0,FALSE,17110,16750,-2287,18.4
FALSE,TRUE,0,FALSE,17033,16630,-462,20.9,FALSE,0,FALSE,17495,17816,462,21.3
TRUE,FALSE,1,TRUE,19061,19093,1362,23.6,TRUE,0,FALSE,17699,17501,-1362,19.1
TRUE,FALSE,1,FALSE,16653,19603,140,22.9,TRUE,0,FALSE,16513,17866,-140,22.9
TRUE,TRUE,1,TRUE,16781,17452,633,23.7,FALSE,0,FALSE,16148,17747,-633,18
FALSE,FALSE,0,FALSE,15978,18068,-323,21,TRUE,1,TRUE,16301,17854,323,20.3
TRUE,FALSE,0,FALSE,15859,19145,-1296,24.1,TRUE,1,TRUE,17155,18918,1296,25.7
TRUE,FALSE,0,FALSE,16205,16887,-3622,19.6,TRUE,2,TRUE,19827,18795,3622,22.4
TRUE,FALSE,0,FALSE,17528,17194,-541,19.7,TRUE,1,TRUE,18069,16648,541,22.3
TRUE,TRUE,0,FALSE,17154,18697,1933,20.2,FALSE,0,FALSE,15221,15905,-1933,17.4
FALSE,FALSE,0,FALSE,16112,18339,-692,24.7,TRUE,2,TRUE,16804,19097,692,22.3
FALSE,FALSE,0,FALSE,16210,17888,766,22.6,TRUE,0,FALSE,15444,18550,-766,20.2
TRUE,TRUE,1,FALSE,18369,20686,2334,27.6,FALSE,1,TRUE,16035,18851,-2334,24.9
TRUE,TRUE,0,FALSE,16097,17793,-143,24.3,FALSE,0,FALSE,16240,17331,143,19.8
FALSE,FALSE,0,FALSE,13196,15515,-5525,19.4,TRUE,0,FALSE,18721,21100,5525,25.2
FALSE,FALSE,0,FALSE,15552,17234,-1493,20.1,TRUE,1,TRUE,17045,18413,1493,25
TRUE,TRUE,1,TRUE,17597,17045,2534,19,FALSE,0,FALSE,15063,14506,-2534,18.8
FALSE,FALSE,0,FALSE,15709,17397,-5900,21.6,TRUE,2,TRUE,21609,22269,5900,27
FALSE,TRUE,2,TRUE,17035,18139,851,23,FALSE,0,FALSE,16184,17812,-851,21.9
TRUE,FALSE,2,TRUE,15000,17972,198,22.9,TRUE,0,FALSE,14802,17246,-198,22
TRUE,FALSE,0,FALSE,18426,20198,380,24,TRUE,1,TRUE,18046,20872,-380,21.1
TRUE,TRUE,2,TRUE,17634,19000,2018,24.2,FALSE,0,FALSE,15616,16739,-2018,23.3
TRUE,FALSE,1,FALSE,20251,20985,6942,26.3,TRUE,1,TRUE,13309,14604,-6942,18.6
FALSE,TRUE,1,TRUE,16034,16642,-754,19.9,FALSE,0,FALSE,16788,17371,754,22.4
FALSE,TRUE,0,FALSE,14147,16605,-1400,22.6,FALSE,1,TRUE,15547,18321,1400,19.7
FALSE,FALSE,1,TRUE,18304,19032,1606,23.7,TRUE,1,FALSE,16698,17996,-1606,19.8
FALSE,FALSE,1,TRUE,15104,17002,-2130,18.6,TRUE,0,FALSE,17234,19034,2130,25.9
FALSE,TRUE,1,TRUE,18847,19480,987,21.3,FALSE,0,FALSE,17860,18838,-987,20.6
TRUE,FALSE,0,FALSE,15782,18460,1344,25.3,TRUE,0,FALSE,14438,17265,-1344,23.6
TRUE,FALSE,1,TRUE,16893,18950,568,23.8,TRUE,0,FALSE,16325,17854,-568,23.1
FALSE,FALSE,1,FALSE,18545,19051,2621,20,TRUE,1,TRUE,15924,17050,-2621,20.6
FALSE,FALSE,0,FALSE,16918,18911,-403,23.3,TRUE,1,TRUE,17321,19486,403,22.5
TRUE,TRUE,1,TRUE,18722,18343,3593,18.7,FALSE,0,FALSE,15129,17616,-3593,20.9
TRUE,TRUE,1,TRUE,18247,18839,3400,23.5,FALSE,1,FALSE,14847,16439,-3400,20.9
FALSE,FALSE,1,TRUE,17471,17895,1019,21.7,TRUE,0,FALSE,16452,17858,-1019,20.6
TRUE,FALSE,0,FALSE,17641,19312,1496,23.7,TRUE,1,TRUE,16145,17960,-1496,21.4
FALSE,FALSE,0,FALSE,14605,16395,-3921,18.1,TRUE,1,TRUE,18526,19679,3921,24.2
TRUE,TRUE,0,FALSE,16249,17860,675,22.4,FALSE,1,TRUE,15574,17483,-675,22
FALSE,TRUE,0,FALSE,17157,17928,-702,22.6,FALSE,2,TRUE,17859,20038,702,20.8
TRUE,TRUE,0,FALSE,15165,17251,-1286,21.8,FALSE,1,TRUE,16451,18946,1286,24.4
FALSE,FALSE,0,FALSE,15427,17722,-174,21.5,TRUE,1,TRUE,15601,18225,174,22.9
TRUE,TRUE,0,FALSE,17878,18248,2301,21.4,FALSE,0,FALSE,15577,17645,-2301,20.3
FALSE,TRUE,0,FALSE,18000,19946,2504,23.6,FALSE,0,FALSE,15496,17585,-2504,19.1
TRUE,FALSE,0,FALSE,15851,19296,-1341,21.5,TRUE,1,TRUE,17192,18851,1341,23.7
FALSE,FALSE,1,TRUE,15832,17750,-2174,22.9,TRUE,0,FALSE,18006,18075,2174,22.1
FALSE,TRUE,1,TRUE,18931,18806,1804,22.2,FALSE,0,FALSE,17127,17986,-1804,21.1
FALSE,TRUE,0,FALSE,16157,17238,68,20.1,FALSE,1,TRUE,16089,17607,-68,21.3
TRUE,TRUE,0,FALSE,18354,17746,1775,20.7,FALSE,0,FALSE,16579,17751,-1775,20.8
FALSE,FALSE,0,FALSE,17274,20199,424,24.6,TRUE,1,TRUE,16850,19149,-424,24.5
FALSE,FALSE,1,FALSE,15372,17002,-2585,21.3,TRUE,1,TRUE,17957,16798,2585,20.9
TRUE,FALSE,1,TRUE,20175,20673,1610,21.5,TRUE,0,FALSE,18565,18185,-1610,21.2
FALSE,FALSE,1,FALSE,15486,17388,904,20.5,TRUE,1,TRUE,14582,17193,-904,21.6
TRUE,TRUE,1,FALSE,16074,18077,-855,23.7,FALSE,1,TRUE,16929,17850,855,21.1
TRUE,FALSE,0,FALSE,16849,18439,1991,23.1,TRUE,1,TRUE,14858,16462,-1991,22.3
FALSE,FALSE,0,FALSE,16291,17343,-2893,18.8,TRUE,2,TRUE,19184,19370,2893,23.6
FALSE,FALSE,0,FALSE,16164,17971,-2274,23.3,TRUE,1,TRUE,18438,20143,2274,24
TRUE,FALSE,1,TRUE,17002,17795,-154,22.1,TRUE,1,FALSE,17156,18407,154,22.5
FALSE,FALSE,0,FALSE,15342,17286,-1630,19.4,TRUE,1,TRUE,16972,17416,1630,21.6
FALSE,FALSE,0,FALSE,13119,15498,-6878,19.9,TRUE,2,TRUE,19997,20454,6878,27.5
TRUE,TRUE,1,TRUE,17472,18967,1177,22.4,FALSE,0,FALSE,16295,18204,-1177,18.3
TRUE,FALSE,0,FALSE,15681,19274,919,23.1,TRUE,1,TRUE,14762,17747,-919,23
TRUE,TRUE,0,FALSE,18634,19500,2077,23.9,FALSE,1,TRUE,16557,17696,-2077,19.6
FALSE,FALSE,0,FALSE,13881,16550,-2973,20.9,TRUE,1,TRUE,16854,18490,2973,22.2
FALSE,TRUE,1,FALSE,18145,17219,-3228,19.9,FALSE,1,TRUE,21373,19294,3228,23.7
TRUE,TRUE,1,TRUE,17308,16748,-999,20.3,FALSE,1,FALSE,18307,18214,999,21.2
FALSE,FALSE,0,FALSE,13049,14294,-6395,16.3,TRUE,2,TRUE,19444,19094,6395,23.9
TRUE,TRUE,0,FALSE,20075,18552,5853,22,FALSE,0,FALSE,14222,14682,-5853,17.9
FALSE,FALSE,0,FALSE,14377,15120,-5141,15.8,TRUE,1,TRUE,19518,19865,5141,24.1
TRUE,TRUE,0,FALSE,17270,17435,2318,21.3,FALSE,0,FALSE,14952,15779,-2318,22
TRUE,TRUE,0,FALSE,18967,19855,3595,24,FALSE,1,TRUE,15372,17260,-3595,21.7
FALSE,FALSE,0,FALSE,14044,16501,-6604,19.1,TRUE,2,TRUE,20648,18515,6604,23.6
FALSE,FALSE,0,FALSE,16467,18715,-530,26.1,TRUE,1,TRUE,16997,18838,530,22.7
TRUE,TRUE,0,FALSE,17846,18045,-796,19.8,FALSE,0,FALSE,18642,18639,796,19.4
TRUE,TRUE,2,TRUE,19993,17656,3439,20.3,FALSE,0,FALSE,16554,16743,-3439,20.9
FALSE,TRUE,1,TRUE,16223,19667,1423,23.2,FALSE,1,FALSE,14800,18645,-1423,24.2
FALSE,TRUE,1,TRUE,14071,16382,-3952,20.2,FALSE,0,FALSE,18023,18397,3952,22.8
TRUE,TRUE,2,TRUE,15284,18267,-884,24.5,FALSE,0,FALSE,16168,18738,884,22.7
FALSE,TRUE,1,FALSE,16346,19072,2655,27.2,FALSE,1,TRUE,13691,17746,-2655,21.8
FALSE,FALSE,1,TRUE,14358,16775,-2031,22.5,TRUE,0,FALSE,16389,17896,2031,22.3
TRUE,TRUE,1,FALSE,17206,20071,2893,24.8,FALSE,1,TRUE,14313,16483,-2893,21.8
TRUE,TRUE,0,FALSE,14767,18018,-976,23.6,FALSE,1,FALSE,15743,19426,976,21.5
TRUE,TRUE,0,FALSE,18291,18548,2182,17.6,FALSE,0,FALSE,16109,17536,-2182,21
FALSE,FALSE,0,FALSE,14979,17163,-1968,20.3,TRUE,1,TRUE,16947,20095,1968,23.8
TRUE,FALSE,0,FALSE,17214,18251,-1806,23.1,TRUE,1,TRUE,19020,18128,1806,20.4
FALSE,FALSE,0,FALSE,16461,15402,-5941,17.7,TRUE,2,TRUE,22402,19499,5941,24.1
TRUE,FALSE,0,FALSE,14027,16596,-2105,21.9,TRUE,0,FALSE,16132,18411,2105,26.1
TRUE,FALSE,0,FALSE,17432,19324,993,22.4,TRUE,0,FALSE,16439,18731,-993,20.9
TRUE,TRUE,0,FALSE,15969,17938,-809,23.1,FALSE,0,FALSE,16778,17928,809,21.6
FALSE,TRUE,0,FALSE,16308,17166,-1903,19.5,FALSE,1,TRUE,18211,18564,1903,21.4
FALSE,FALSE,0,FALSE,14119,16231,-2325,21.6,TRUE,1,TRUE,16444,18309,2325,23.5
TRUE,TRUE,2,TRUE,16044,19133,-100,21.4,FALSE,0,FALSE,16144,20338,100,23.4
FALSE,FALSE,1,TRUE,15011,16617,-4396,18.3,TRUE,0,FALSE,19407,19320,4396,24.5
FALSE,FALSE,0,FALSE,14517,15493,-3525,16.9,TRUE,2,TRUE,18042,18771,3525,20.2
FALSE,FALSE,0,FALSE,13653,16539,-3728,22,TRUE,0,FALSE,17381,19615,3728,22
FALSE,TRUE,0,FALSE,17833,18351,1256,19.1,FALSE,0,FALSE,16577,18050,-1256,19.3
TRUE,TRUE,1,TRUE,17759,18824,3082,22.8,FALSE,1,FALSE,14677,15624,-3082,16.8
FALSE,FALSE,0,FALSE,16158,17652,197,24,TRUE,0,FALSE,15961,16411,-197,20.5
FALSE,FALSE,1,FALSE,16147,18863,482,22.2,TRUE,1,TRUE,15665,17949,-482,19.9
FALSE,FALSE,0,FALSE,17065,18634,1019,22,TRUE,1,TRUE,16046,18307,-1019,23.3
TRUE,TRUE,2,TRUE,17287,18953,817,21.5,FALSE,0,FALSE,16470,18687,-817,21.8
TRUE,TRUE,2,TRUE,15997,19158,499,19.5,FALSE,0,FALSE,15498,16717,-499,21
TRUE,TRUE,0,FALSE,15387,18342,-923,21.5,FALSE,1,TRUE,16310,19576,923,23.2
TRUE,FALSE,1,TRUE,16313,17908,-531,21.1,TRUE,1,FALSE,16844,17667,531,20.5
FALSE,FALSE,0,FALSE,15987,18632,1033,25.2,TRUE,0,FALSE,14954,18260,-1033,23.1
TRUE,FALSE,0,FALSE,16304,16307,-2336,16.9,TRUE,1,FALSE,18640,17775,2336,21.1
TRUE,TRUE,1,FALSE,18177,17640,-1253,20.3,FALSE,1,TRUE,19430,19267,1253,23.5
TRUE,FALSE,1,TRUE,17493,18552,2851,24,TRUE,0,FALSE,14642,17239,-2851,19.8
TRUE,TRUE,1,TRUE,19443,19743,5349,25.4,FALSE,0,FALSE,14094,15612,-5349,19
FALSE,FALSE,0,FALSE,14920,17571,-1670,18.6,TRUE,2,TRUE,16590,18111,1670,23.3
FALSE,FALSE,0,FALSE,17511,17230,225,21.6,TRUE,0,FALSE,17286,16443,-225,20.6
TRUE,TRUE,1,TRUE,16819,17163,459,19.7,FALSE,1,FALSE,16360,18310,-459,23.5
TRUE,TRUE,0,FALSE,14703,16970,-2127,19.8,FALSE,1,TRUE,16830,18589,2127,23.3
TRUE,TRUE,0,FALSE,16801,18747,575,20.3,FALSE,1,TRUE,16226,18041,-575,21.4
FALSE,TRUE,0,FALSE,16254,18913,-329,24.8,FALSE,0,FALSE,16583,19143,329,27.2
TRUE,FALSE,1,TRUE,15478,18212,-2375,20.4,TRUE,0,FALSE,17853,18505,2375,23.6
TRUE,FALSE,0,FALSE,15363,16498,-2623,20.6,TRUE,1,FALSE,17986,18810,2623,22.6
TRUE,TRUE,0,FALSE,17121,16462,217,21.2,FALSE,1,FALSE,16904,16028,-217,17.3
FALSE,FALSE,0,FALSE,15069,14655,-4160,17.2,TRUE,1,TRUE,19229,20728,4160,23.1
FALSE,FALSE,1,TRUE,15891,15926,-498,17.9,TRUE,0,FALSE,16389,17711,498,19.6
FALSE,FALSE,0,FALSE,13316,16245,-4500,18.8,TRUE,1,TRUE,17816,19225,4500,21.5
FALSE,TRUE,0,FALSE,15956,17199,-43,21.5,FALSE,0,FALSE,15999,18353,43,22.6
TRUE,TRUE,2,TRUE,15661,18396,-643,22.5,FALSE,0,FALSE,16304,19595,643,25.6
TRUE,TRUE,0,FALSE,16789,17947,1206,19.8,FALSE,0,FALSE,15583,16979,-1206,19.2
FALSE,TRUE,2,TRUE,16347,17442,-3529,21.2,FALSE,0,FALSE,19876,18951,3529,21.4
FALSE,FALSE,0,FALSE,14901,16728,-1123,20.1,TRUE,1,TRUE,16024,17704,1123,23.2
FALSE,TRUE,1,TRUE,17018,17105,1096,19,FALSE,0,FALSE,15922,16985,-1096,19.6
FALSE,FALSE,0,FALSE,16342,16909,-5219,16.5,TRUE,0,FALSE,21561,20389,5219,26.3
FALSE,FALSE,1,TRUE,14801,16202,-3527,20.9,TRUE,0,FALSE,18328,18103,3527,23
FALSE,TRUE,0,FALSE,17333,17113,1936,20.9,FALSE,0,FALSE,15397,15666,-1936,19.7
FALSE,FALSE,0,FALSE,15052,16945,-1729,19.4,TRUE,1,TRUE,16781,18203,1729,22.6
TRUE,TRUE,0,FALSE,15585,17392,-797,22.7,FALSE,0,FALSE,16382,18235,797,24.1
FALSE,FALSE,0,FALSE,15273,17980,-764,21.4,TRUE,1,TRUE,16037,19122,764,24.8
FALSE,TRUE,0,FALSE,15666,15541,-2484,18.8,FALSE,1,TRUE,18150,18776,2484,23.5
FALSE,FALSE,1,FALSE,14591,17470,-2269,21.9,TRUE,1,TRUE,16860,18548,2269,22.3
FALSE,FALSE,0,FALSE,14690,15769,-1753,19.1,TRUE,0,FALSE,16443,19093,1753,21
FALSE,FALSE,0,FALSE,17151,17777,-1122,19.3,TRUE,2,TRUE,18273,18703,1122,23.4
FALSE,TRUE,0,FALSE,16378,17819,428,21.1,FALSE,2,TRUE,15950,18377,-428,21.6
FALSE,FALSE,0,FALSE,15661,15375,-945,20.8,TRUE,0,FALSE,16606,17709,945,23.4
FALSE,TRUE,0,FALSE,16589,18105,-17,23.1,FALSE,1,TRUE,16606,18460,17,22
FALSE,TRUE,2,TRUE,15900,17700,-1286,23.4,FALSE,0,FALSE,17186,18695,1286,21.4
TRUE,TRUE,0,FALSE,14927,15638,-2614,19.6,FALSE,1,TRUE,17541,17518,2614,21.4
TRUE,TRUE,1,FALSE,16875,18159,2231,24.7,FALSE,1,TRUE,14644,17936,-2231,19
FALSE,TRUE,1,FALSE,17847,18916,3060,20.7,FALSE,0,FALSE,14787,17078,-3060,22.1
TRUE,TRUE,0,FALSE,16369,18278,311,20.1,FALSE,0,FALSE,16058,18328,-311,21.6
TRUE,TRUE,2,TRUE,17320,18965,2850,26.4,FALSE,0,FALSE,14470,17319,-2850,24.8
TRUE,TRUE,1,TRUE,18532,20134,3195,23.1,FALSE,0,FALSE,15337,18764,-3195,22.3
FALSE,TRUE,0,FALSE,17136,18233,1363,20.2,FALSE,1,FALSE,15773,18380,-1363,21.8
FALSE,FALSE,0,FALSE,17137,18448,1025,19.2,TRUE,1,TRUE,16112,18647,-1025,18.7
FALSE,TRUE,1,FALSE,19114,18680,2544,24.5,FALSE,1,TRUE,16570,18701,-2544,20.9
FALSE,FALSE,0,FALSE,13555,13939,-6373,15,TRUE,2,TRUE,19928,19095,6373,24.2
TRUE,TRUE,0,FALSE,14707,16234,-2268,21.3,FALSE,1,TRUE,16975,18736,2268,25.4
FALSE,TRUE,0,FALSE,16025,17956,-44,21.4,FALSE,1,TRUE,16069,18313,44,22
FALSE,TRUE,0,FALSE,16776,15799,357,19.6,FALSE,0,FALSE,16419,15825,-357,18.6
TRUE,FALSE,0,FALSE,15379,17670,236,23.2,TRUE,1,TRUE,15143,17707,-236,21.7
TRUE,TRUE,1,TRUE,17196,19002,2973,23.9,FALSE,0,FALSE,14223,17562,-2973,23.9
TRUE,TRUE,1,TRUE,17200,19346,2977,23.4,FALSE,0,FALSE,14223,16295,-2977,21.1
FALSE,FALSE,1,FALSE,17472,17708,-423,18,TRUE,1,TRUE,17895,18918,423,22.1
FALSE,TRUE,0,FALSE,15435,17093,-1077,23.1,FALSE,0,FALSE,16512,19653,1077,24.9
TRUE,TRUE,1,TRUE,16588,19189,1782,22.9,FALSE,1,FALSE,14806,17230,-1782,18.9
TRUE,TRUE,0,FALSE,16784,17848,941,22.8,FALSE,0,FALSE,15843,17719,-941,17.6
TRUE,FALSE,1,TRUE,16982,18420,-1346,19.1,TRUE,0,FALSE,18328,20027,1346,21.2
TRUE,TRUE,0,FALSE,17635,16554,-1430,17.5,FALSE,1,TRUE,19065,18903,1430,21.9
FALSE,FALSE,0,FALSE,15913,18220,-1091,22.5,TRUE,1,TRUE,17004,19112,1091,20.8
FALSE,FALSE,1,TRUE,14487,16054,-2088,17,TRUE,0,FALSE,16575,18801,2088,21.7
FALSE,TRUE,0,FALSE,15643,18376,-1045,23.3,FALSE,0,FALSE,16688,18207,1045,22.9
TRUE,FALSE,0,FALSE,16853,18782,213,23.3,TRUE,0,FALSE,16640,19365,-213,24.9
TRUE,TRUE,1,FALSE,18242,17997,4484,19.5,FALSE,0,FALSE,13758,15119,-4484,19.9
TRUE,TRUE,0,FALSE,16866,17575,-1543,19.4,FALSE,1,FALSE,18409,18098,1543,20.7
FALSE,FALSE,0,FALSE,14673,18411,-2599,23.2,TRUE,1,TRUE,17272,19229,2599,27.1
TRUE,TRUE,0,FALSE,15463,17936,-338,21.5,FALSE,1,TRUE,15801,17945,338,21.7
TRUE,FALSE,1,TRUE,15824,16324,-2047,21,TRUE,1,FALSE,17871,18654,2047,20.5
TRUE,FALSE,0,FALSE,17129,17579,1192,22.7,TRUE,0,FALSE,15937,17130,-1192,22.5
TRUE,FALSE,0,FALSE,16335,17761,1167,23.6,TRUE,1,TRUE,15168,17272,-1167,20.6
FALSE,FALSE,0,FALSE,17099,18702,1579,20.8,TRUE,1,TRUE,15520,17479,-1579,22.8
TRUE,TRUE,1,TRUE,19077,20483,5271,23.4,FALSE,0,FALSE,13806,16486,-5271,19.1
TRUE,FALSE,0,FALSE,14983,17958,-1607,27.1,TRUE,1,TRUE,16590,19001,1607,21.2
TRUE,FALSE,0,FALSE,17368,18134,280,21.9,TRUE,0,FALSE,17088,19152,-280,22.7
FALSE,FALSE,0,FALSE,15286,17397,-2811,22.5,TRUE,2,TRUE,18097,20099,2811,24.7
FALSE,FALSE,0,FALSE,16317,17669,-1025,20.9,TRUE,0,FALSE,17342,19436,1025,24.5
TRUE,FALSE,2,TRUE,16364,19838,409,24.5,TRUE,0,FALSE,15955,18157,-409,22.9
FALSE,TRUE,1,TRUE,14623,15613,-417,17.3,FALSE,0,FALSE,15040,16847,417,20.7
TRUE,TRUE,0,FALSE,19938,18437,4534,22.2,FALSE,1,TRUE,15404,16730,-4534,21.4
FALSE,FALSE,0,FALSE,16221,17699,-1437,21.6,TRUE,2,TRUE,17658,19355,1437,22.7
TRUE,TRUE,1,TRUE,16544,17779,-3011,19.4,FALSE,0,FALSE,19555,18978,3011,22.2
TRUE,FALSE,0,FALSE,17908,19202,653,22.9,TRUE,1,TRUE,17255,18772,-653,24.7
FALSE,FALSE,0,FALSE,15831,19463,1134,27.1,TRUE,1,TRUE,14697,18303,-1134,23.8
TRUE,TRUE,0,FALSE,17668,18804,1024,23,FALSE,0,FALSE,16644,18054,-1024,22.6
FALSE,FALSE,0,FALSE,15470,17038,-1708,21.7,TRUE,0,FALSE,17178,17715,1708,20.7
TRUE,FALSE,0,FALSE,16448,17691,442,20.7,TRUE,0,FALSE,16006,17150,-442,22.1
TRUE,FALSE,0,FALSE,14877,17258,-1550,20.5,TRUE,0,FALSE,16427,18276,1550,21.1
TRUE,TRUE,0,FALSE,18917,19563,4611,22.6,FALSE,0,FALSE,14306,16252,-4611,21.3
FALSE,TRUE,0,FALSE,16356,16343,-2865,20.2,FALSE,2,TRUE,19221,20183,2865,22.3
FALSE,FALSE,0,FALSE,14676,16668,-1563,17,TRUE,1,TRUE,16239,17900,1563,20.1
FALSE,TRUE,0,FALSE,13126,14222,-4394,17.5,FALSE,1,TRUE,17520,18039,4394,19.5
TRUE,FALSE,0,FALSE,17769,18832,1417,20.7,TRUE,1,TRUE,16352,17716,-1417,21.5
FALSE,FALSE,0,FALSE,16051,17315,-485,19.9,TRUE,1,TRUE,16536,17668,485,19.9
FALSE,TRUE,1,FALSE,17395,18998,2234,25.2,FALSE,1,TRUE,15161,17392,-2234,22.6
TRUE,TRUE,1,TRUE,16819,17190,1896,19.9,FALSE,0,FALSE,14923,16121,-1896,21.6
FALSE,FALSE,2,TRUE,16315,17744,199,23.6,TRUE,0,FALSE,16116,17341,-199,22.7
TRUE,TRUE,1,TRUE,16846,17698,-1705,24.6,FALSE,1,FALSE,18551,19377,1705,24
FALSE,TRUE,1,FALSE,15951,18136,-675,23.6,FALSE,0,FALSE,16626,19348,675,23.4
TRUE,FALSE,1,TRUE,16858,18658,1160,22.8,TRUE,0,FALSE,15698,17117,-1160,24.4
TRUE,TRUE,0,FALSE,17335,16110,1287,17.6,FALSE,1,TRUE,16048,16859,-1287,19.8
FALSE,TRUE,0,FALSE,16781,17415,-2063,19.4,FALSE,0,FALSE,18844,18863,2063,23.2
TRUE,FALSE,0,FALSE,17225,18183,2559,22.2,TRUE,0,FALSE,14666,15590,-2559,20.9
TRUE,FALSE,0,FALSE,16948,18271,2346,25.2,TRUE,1,TRUE,14602,16847,-2346,21.1
FALSE,FALSE,1,TRUE,16056,16268,-1151,18.8,TRUE,1,FALSE,17207,18192,1151,23.5
TRUE,FALSE,0,FALSE,15440,15725,-1729,18,TRUE,0,FALSE,17169,15607,1729,18.5
FALSE,TRUE,1,TRUE,16058,15685,-1441,17.8,FALSE,0,FALSE,17499,17707,1441,24
TRUE,TRUE,1,TRUE,16315,18479,763,25.6,FALSE,0,FALSE,15552,17236,-763,21.8
TRUE,TRUE,1,TRUE,17326,18168,1209,18.8,FALSE,0,FALSE,16117,17594,-1209,23.1
FALSE,FALSE,0,FALSE,16851,18647,1706,22.5,TRUE,1,TRUE,15145,17493,-1706,21.9
TRUE,TRUE,0,FALSE,16853,18346,2097,23.4,FALSE,0,FALSE,14756,16777,-2097,22.8
TRUE,TRUE,1,TRUE,17556,19338,2201,21.1,FALSE,0,FALSE,15355,17917,-2201,22.7
FALSE,TRUE,0,FALSE,17840,18114,-2425,17.5,FALSE,2,TRUE,20265,19941,2425,19.7
FALSE,TRUE,0,FALSE,18725,19513,2376,24.3,FALSE,0,FALSE,16349,18188,-2376,21.5
TRUE,TRUE,0,FALSE,16781,18303,679,22.2,FALSE,1,TRUE,16102,16903,-679,19.2
FALSE,FALSE,1,TRUE,15376,16791,-4864,20.6,TRUE,0,FALSE,20240,20127,4864,24.7
FALSE,FALSE,0,FALSE,14193,17801,-3116,21.8,TRUE,0,FALSE,17309,19150,3116,24.7
TRUE,FALSE,0,FALSE,16862,18123,-542,20.6,TRUE,2,TRUE,17404,18377,542,22.2
TRUE,TRUE,2,TRUE,17003,18427,1634,23.9,FALSE,0,FALSE,15369,17881,-1634,26.1
FALSE,FALSE,0,FALSE,15506,17710,-672,23.1,TRUE,1,TRUE,16178,19130,672,21.4
FALSE,FALSE,0,FALSE,18724,18411,622,22.1,TRUE,2,TRUE,18102,18092,-622,22
TRUE,TRUE,1,FALSE,16422,18048,1571,24.2,FALSE,1,TRUE,14851,17488,-1571,21.1
TRUE,TRUE,1,FALSE,18337,18978,3211,19.4,FALSE,0,FALSE,15126,15338,-3211,18.2
TRUE,TRUE,1,TRUE,15385,16039,-3134,21,FALSE,0,FALSE,18519,18811,3134,23.2
FALSE,FALSE,0,FALSE,15566,17340,-1951,21.1,TRUE,1,TRUE,17517,18212,1951,23.3
TRUE,TRUE,0,FALSE,18326,19015,3517,23.9,FALSE,1,FALSE,14809,16659,-3517,20.3
FALSE,FALSE,0,FALSE,16299,17800,80,22.6,TRUE,1,TRUE,16219,18399,-80,21
FALSE,FALSE,0,FALSE,13991,17215,-1380,22.1,TRUE,1,TRUE,15371,17796,1380,22.4
TRUE,FALSE,0,FALSE,14205,16546,-1115,20.3,TRUE,1,TRUE,15320,16368,1115,19.2
FALSE,TRUE,0,FALSE,17955,18774,3187,27,FALSE,1,TRUE,14768,17894,-3187,23
TRUE,TRUE,0,FALSE,20862,18335,6423,23.2,FALSE,0,FALSE,14439,14568,-6423,14.8
FALSE,FALSE,0,FALSE,14197,17915,-2313,25.5,TRUE,0,FALSE,16510,19125,2313,23.1
FALSE,TRUE,1,FALSE,16788,19474,1346,26.4,FALSE,1,TRUE,15442,18555,-1346,24.2
TRUE,FALSE,1,TRUE,14798,16659,-2402,17.9,TRUE,0,FALSE,17200,18416,2402,22.7
FALSE,FALSE,0,FALSE,15598,17735,-1293,22,TRUE,1,TRUE,16891,17995,1293,23.7
TRUE,FALSE,0,FALSE,16655,19541,2089,23.8,TRUE,1,TRUE,14566,17866,-2089,22.4
FALSE,FALSE,1,TRUE,16804,18899,2290,20.6,TRUE,0,FALSE,14514,17034,-2290,18
TRUE,TRUE,2,TRUE,15977,17653,-1397,19.8,FALSE,0,FALSE,17374,19202,1397,23
FALSE,FALSE,1,TRUE,15654,18324,-360,23.3,TRUE,1,FALSE,16014,18385,360,25.4
TRUE,TRUE,1,TRUE,19035,19265,5465,23.9,FALSE,0,FALSE,13570,15773,-5465,19
FALSE,FALSE,1,FALSE,16247,19687,1032,22.6,TRUE,1,TRUE,15215,18589,-1032,24.3
FALSE,TRUE,0,FALSE,18074,19746,1887,23.5,FALSE,0,FALSE,16187,18451,-1887,22
TRUE,TRUE,1,FALSE,17274,18134,3640,23.3,FALSE,0,FALSE,13634,15786,-3640,20.2
TRUE,FALSE,0,FALSE,17839,18614,1452,20.1,TRUE,1,TRUE,16387,17925,-1452,19.8
TRUE,TRUE,0,FALSE,16700,17393,1806,21.8,FALSE,1,TRUE,14894,17389,-1806,20.3
TRUE,FALSE,0,FALSE,15852,17369,66,19.2,TRUE,1,TRUE,15786,17426,-66,23.2
TRUE,TRUE,0,FALSE,15296,17179,-112,22.1,FALSE,1,TRUE,15408,17991,112,22.2
TRUE,TRUE,1,TRUE,14426,17085,-323,21.9,FALSE,0,FALSE,14749,17700,323,24.3
TRUE,TRUE,0,FALSE,15856,19023,-82,24.8,FALSE,1,TRUE,15938,18278,82,25.4
TRUE,TRUE,0,FALSE,17895,16640,2088,19.1,FALSE,1,TRUE,15807,16758,-2088,20.2
FALSE,TRUE,0,FALSE,15728,17183,-2701,20.8,FALSE,0,FALSE,18429,19458,2701,20.8
TRUE,TRUE,0,FALSE,17333,16881,781,23.2,FALSE,1,FALSE,16552,18625,-781,23.4
FALSE,TRUE,0,FALSE,16404,17425,283,19.7,FALSE,1,TRUE,16121,16817,-283,21.6
TRUE,FALSE,1,TRUE,15738,17430,-360,20.6,TRUE,1,FALSE,16098,18138,360,23
FALSE,FALSE,0,FALSE,13580,16571,-4279,20.7,TRUE,2,TRUE,17859,21100,4279,26.6
FALSE,FALSE,1,TRUE,16773,17641,120,23.7,TRUE,0,FALSE,16653,18895,-120,22.4
FALSE,FALSE,0,FALSE,14993,16251,-1845,21.5,TRUE,1,TRUE,16838,18130,1845,22.9
FALSE,TRUE,0,FALSE,15219,17357,-563,24.1,FALSE,1,TRUE,15782,18779,563,22.5
FALSE,FALSE,0,FALSE,16046,16986,-1112,20.3,TRUE,0,FALSE,17158,17928,1112,22
FALSE,FALSE,1,TRUE,15683,17335,-1906,18.6,TRUE,1,FALSE,17589,18811,1906,24
FALSE,FALSE,1,TRUE,16408,17435,-2517,19.9,TRUE,0,FALSE,18925,18634,2517,24.8
FALSE,FALSE,1,FALSE,15104,17634,-2831,22.8,TRUE,1,TRUE,17935,19285,2831,24.2
FALSE,TRUE,1,FALSE,16113,16994,-1063,18,FALSE,0,FALSE,17176,17626,1063,24
TRUE,FALSE,0,FALSE,18894,17942,1573,21.9,TRUE,2,TRUE,17321,18566,-1573,22
FALSE,FALSE,0,FALSE,16652,18147,-427,21.2,TRUE,0,FALSE,17079,18160,427,22.6
FALSE,FALSE,0,FALSE,15409,17089,-2161,21.8,TRUE,0,FALSE,17570,17386,2161,18.7
TRUE,FALSE,0,FALSE,16733,19524,479,19.3,TRUE,1,TRUE,16254,18595,-479,23.3
TRUE,TRUE,0,FALSE,17307,16818,3237,18.9,FALSE,0,FALSE,14070,14711,-3237,15.8
TRUE,FALSE,1,TRUE,15283,17676,230,22.3,TRUE,0,FALSE,15053,17781,-230,21.2
FALSE,FALSE,0,FALSE,14428,16819,-1217,21.5,TRUE,1,TRUE,15645,17358,1217,21.6
TRUE,TRUE,1,TRUE,16679,17760,273,19.3,FALSE,0,FALSE,16406,17673,-273,21.5
FALSE,FALSE,0,FALSE,15400,16607,-2552,18.8,TRUE,1,TRUE,17952,18659,2552,21.2
FALSE,FALSE,0,FALSE,16230,17336,-4,21.6,TRUE,0,FALSE,16234,17475,4,17.7
FALSE,FALSE,1,TRUE,16028,19000,-2863,24.9,TRUE,0,FALSE,18891,19875,2863,24.2
TRUE,TRUE,0,FALSE,15731,18954,-85,25,FALSE,0,FALSE,15816,19586,85,22.9
FALSE,FALSE,0,FALSE,14816,16519,-4490,21.8,TRUE,2,TRUE,19306,20101,4490,24.7
TRUE,FALSE,1,FALSE,15862,19244,-988,22.9,TRUE,1,TRUE,16850,18774,988,23.2
TRUE,FALSE,2,TRUE,14140,17249,-1481,24.1,TRUE,0,FALSE,15621,18755,1481,22.8
TRUE,FALSE,2,TRUE,16699,18503,1109,24.2,TRUE,0,FALSE,15590,17785,-1109,23.7
FALSE,FALSE,0,FALSE,13405,15189,-5392,18.2,TRUE,1,TRUE,18797,18093,5392,23.1
TRUE,FALSE,0,FALSE,17538,18073,238,22.4,TRUE,1,TRUE,17300,17233,-238,19.1
FALSE,TRUE,0,FALSE,19038,19801,4941,26.1,FALSE,0,FALSE,14097,15099,-4941,19
FALSE,FALSE,0,FALSE,18082,18637,24,20.9,TRUE,2,TRUE,18058,18402,-24,20
FALSE,FALSE,1,TRUE,14004,16302,-1113,21.7,TRUE,0,FALSE,15117,17683,1113,21.2
TRUE,FALSE,0,FALSE,16349,18699,754,25.3,TRUE,1,TRUE,15595,18686,-754,24.3
FALSE,FALSE,0,FALSE,15373,18734,-1942,25.2,TRUE,2,TRUE,17315,18594,1942,22.6
TRUE,TRUE,2,TRUE,16559,18848,-167,23.5,FALSE,0,FALSE,16726,18809,167,23.7
TRUE,TRUE,1,TRUE,16513,18070,3537,20.3,FALSE,0,FALSE,12976,15094,-3537,18.6
TRUE,TRUE,1,FALSE,19886,20060,5349,24,FALSE,0,FALSE,14537,16421,-5349,18.9
TRUE,TRUE,2,TRUE,17167,19248,2793,24.7,FALSE,0,FALSE,14374,16968,-2793,22.5
TRUE,TRUE,1,TRUE,16809,18916,2192,24.1,FALSE,0,FALSE,14617,18452,-2192,24.6
FALSE,FALSE,0,FALSE,18178,17540,-286,20,TRUE,1,TRUE,18464,18034,286,17.1
FALSE,FALSE,0,FALSE,14742,15941,-3540,21.5,TRUE,1,TRUE,18282,19220,3540,22.7
TRUE,FALSE,0,FALSE,15126,17342,-568,20.7,TRUE,0,FALSE,15694,17687,568,23.1
FALSE,FALSE,0,FALSE,15449,16663,-2975,19.5,TRUE,1,TRUE,18424,19205,2975,25.8
FALSE,TRUE,0,FALSE,15233,16168,-3184,20.8,FALSE,0,FALSE,18417,18513,3184,21.8
FALSE,FALSE,0,FALSE,14602,17042,-2185,20.8,TRUE,1,TRUE,16787,19522,2185,23.2
TRUE,FALSE,0,FALSE,15390,18666,-387,24.5,TRUE,0,FALSE,15777,17787,387,23.9
TRUE,TRUE,0,FALSE,16766,18538,1543,23.1,FALSE,1,TRUE,15223,17710,-1543,20.8
TRUE,FALSE,0,FALSE,16093,16579,-1908,18.1,TRUE,1,FALSE,18001,18233,1908,22
TRUE,TRUE,1,TRUE,15575,16473,737,22,FALSE,0,FALSE,14838,17164,-737,20.1
TRUE,TRUE,0,FALSE,16953,17147,1073,19.9,FALSE,1,TRUE,15880,17688,-1073,21
FALSE,FALSE,1,TRUE,15529,17721,-413,20.4,TRUE,1,FALSE,15942,18725,413,23.7
TRUE,TRUE,1,FALSE,16836,19773,2569,24.2,FALSE,1,TRUE,14267,17395,-2569,22.8
FALSE,TRUE,0,FALSE,13820,13497,-3996,15.8,FALSE,1,TRUE,17816,16483,3996,19
TRUE,TRUE,1,TRUE,19321,18437,2574,22.6,FALSE,0,FALSE,16747,18078,-2574,22.8
FALSE,TRUE,0,FALSE,15834,18088,-191,22.8,FALSE,1,TRUE,16025,18270,191,20.8
TRUE,FALSE,1,TRUE,16585,16982,-536,19.1,TRUE,0,FALSE,17121,17846,536,23.4
FALSE,FALSE,1,TRUE,15483,16690,-1429,17.4,TRUE,0,FALSE,16912,17373,1429,22.5
TRUE,TRUE,1,FALSE,17834,19145,3797,27.6,FALSE,1,TRUE,14037,16903,-3797,20.2
TRUE,TRUE,1,TRUE,16858,18543,2407,25.1,FALSE,0,FALSE,14451,17604,-2407,22.1
TRUE,FALSE,0,FALSE,20619,18696,2828,20.5,TRUE,1,TRUE,17791,16734,-2828,19.8
TRUE,FALSE,1,TRUE,18449,19139,2334,25.7,TRUE,0,FALSE,16115,17893,-2334,23.1
TRUE,FALSE,0,FALSE,17354,20449,2301,22.4,TRUE,0,FALSE,15053,17037,-2301,24
FALSE,TRUE,0,FALSE,16097,16760,853,21.4,FALSE,1,TRUE,15244,16397,-853,18.2
TRUE,FALSE,0,FALSE,16138,17204,-243,21.1,TRUE,1,FALSE,16381,16786,243,18.8
TRUE,TRUE,1,TRUE,17794,17983,4793,22,FALSE,0,FALSE,13001,14314,-4793,21.7
TRUE,TRUE,1,TRUE,19218,19389,3248,19.7,FALSE,0,FALSE,15970,17242,-3248,20.5
TRUE,FALSE,1,TRUE,18501,19714,2907,23,TRUE,0,FALSE,15594,17014,-2907,21.5
FALSE,FALSE,0,FALSE,15922,19022,-1454,24.8,TRUE,0,FALSE,17376,19638,1454,20.7
TRUE,TRUE,0,FALSE,16119,16372,292,20.3,FALSE,1,TRUE,15827,16578,-292,20.6
FALSE,TRUE,1,TRUE,14625,16487,-2978,20,FALSE,0,FALSE,17603,19447,2978,19
FALSE,FALSE,1,TRUE,16685,17591,-335,19.3,TRUE,1,FALSE,17020,18272,335,22.8
FALSE,FALSE,1,FALSE,13895,16914,-2894,21,TRUE,1,TRUE,16789,18656,2894,20.8
TRUE,FALSE,0,FALSE,19890,17275,4401,17.4,TRUE,1,TRUE,15489,15090,-4401,20.4
FALSE,TRUE,0,FALSE,15164,16581,-4055,19,FALSE,1,FALSE,19219,18829,4055,23.6
FALSE,TRUE,0,FALSE,17498,19402,2084,22.4,FALSE,0,FALSE,15414,16533,-2084,22.8
TRUE,TRUE,0,FALSE,19452,20776,2593,21.2,FALSE,2,TRUE,16859,17086,-2593,21.3
FALSE,FALSE,1,TRUE,17322,18525,1372,25.5,TRUE,0,FALSE,15950,16205,-1372,21.3
TRUE,TRUE,1,TRUE,17243,18171,2803,23.1,FALSE,0,FALSE,14440,16533,-2803,18.6
FALSE,FALSE,1,FALSE,18020,19285,-533,21.4,TRUE,0,FALSE,18553,18341,533,19.8
FALSE,FALSE,2,TRUE,16289,17723,-963,20.8,TRUE,0,FALSE,17252,17787,963,23
TRUE,TRUE,2,TRUE,18303,19140,2642,26.3,FALSE,0,FALSE,15661,18774,-2642,23.1
FALSE,TRUE,0,FALSE,15728,16927,-1615,21.2,FALSE,0,FALSE,17343,18512,1615,20.5
TRUE,TRUE,0,FALSE,16097,18426,1212,22.6,FALSE,2,TRUE,14885,16688,-1212,21.6
FALSE,FALSE,2,TRUE,14414,16249,-2363,21.5,TRUE,0,FALSE,16777,18393,2363,23.3
TRUE,TRUE,1,TRUE,15852,17330,-1918,19.4,FALSE,1,FALSE,17770,19069,1918,21.3
TRUE,TRUE,0,FALSE,15202,17438,145,21.5,FALSE,1,FALSE,15057,18167,-145,24.7
TRUE,TRUE,0,FALSE,15572,19166,902,24.2,FALSE,1,TRUE,14670,18306,-902,23.1
FALSE,TRUE,0,FALSE,16488,17386,-870,20.8,FALSE,1,TRUE,17358,18506,870,24.1
FALSE,FALSE,1,TRUE,14353,15067,-4550,16.8,TRUE,0,FALSE,18903,18550,4550,21.6
TRUE,FALSE,1,FALSE,19133,20110,4238,22.3,TRUE,1,TRUE,14895,16635,-4238,16.8
FALSE,FALSE,0,FALSE,15314,18205,-1659,23.3,TRUE,0,FALSE,16973,19771,1659,25.3
FALSE,FALSE,0,FALSE,17690,18278,1377,19.2,TRUE,0,FALSE,16313,15849,-1377,19.4
TRUE,TRUE,2,TRUE,20183,20663,3663,21.6,FALSE,0,FALSE,16520,17915,-3663,19.2
TRUE,TRUE,1,FALSE,18408,19614,2969,22.5,FALSE,0,FALSE,15439,17039,-2969,21
FALSE,FALSE,0,FALSE,15595,15756,-3682,15.9,TRUE,0,FALSE,19277,20322,3682,24
TRUE,TRUE,0,FALSE,17119,18174,-1362,20.9,FALSE,0,FALSE,18481,19037,1362,23.5
FALSE,TRUE,0,FALSE,17658,17546,108,21.4,FALSE,1,FALSE,17550,17634,-108,23.5
TRUE,TRUE,0,FALSE,19600,20132,5344,21.8,FALSE,0,FALSE,14256,16626,-5344,19.4
FALSE,FALSE,0,FALSE,16336,16919,-3908,19,TRUE,1,TRUE,20244,19623,3908,20.8
TRUE,TRUE,1,TRUE,16860,18168,2984,22.6,FALSE,0,FALSE,13876,16603,-2984,21.6
TRUE,TRUE,2,TRUE,14501,16819,-250,20.1,FALSE,0,FALSE,14751,16330,250,21.2
FALSE,FALSE,0,FALSE,17148,17427,1084,22.6,TRUE,2,TRUE,16064,16769,-1084,20.7
TRUE,TRUE,0,FALSE,18559,18239,2606,22.3,FALSE,1,TRUE,15953,17275,-2606,20.3
FALSE,FALSE,1,FALSE,16250,16288,154,21.5,TRUE,1,TRUE,16096,17267,-154,23
TRUE,TRUE,1,TRUE,15791,17326,960,22.4,FALSE,0,FALSE,14831,18138,-960,22.3
FALSE,FALSE,0,FALSE,15634,16435,-3194,22.2,TRUE,1,FALSE,18828,19110,3194,20.5
TRUE,TRUE,0,FALSE,15148,16687,-44,21.5,FALSE,0,FALSE,15192,18288,44,24.6
TRUE,TRUE,2,TRUE,17893,17157,1181,20.6,FALSE,0,FALSE,16712,18091,-1181,18.2
TRUE,TRUE,1,TRUE,16200,17810,-927,20.2,FALSE,1,FALSE,17127,18546,927,20.7
FALSE,FALSE,0,FALSE,13371,15621,-3170,22.4,TRUE,1,TRUE,16541,18212,3170,22.6
FALSE,FALSE,0,FALSE,15903,18823,-623,20.5,TRUE,1,TRUE,16526,17799,623,20.5
TRUE,FALSE,0,FALSE,15719,17801,-1121,20.2,TRUE,0,FALSE,16840,17797,1121,23.6
FALSE,FALSE,0,FALSE,13267,14831,-5292,18.5,TRUE,1,TRUE,18559,19753,5292,23.7
TRUE,TRUE,2,TRUE,16305,19758,1793,25.3,FALSE,0,FALSE,14512,18829,-1793,20.4
TRUE,TRUE,0,FALSE,18269,20290,3389,25.8,FALSE,0,FALSE,14880,16825,-3389,23.9
FALSE,FALSE,0,FALSE,14956,16656,-3532,21.6,TRUE,0,FALSE,18488,18718,3532,21.7
TRUE,FALSE,1,FALSE,16180,17570,-981,22.9,TRUE,1,TRUE,17161,17306,981,23
FALSE,TRUE,0,FALSE,16808,16741,616,20,FALSE,0,FALSE,16192,16828,-616,19.8
FALSE,TRUE,1,FALSE,17971,19214,3146,23.1,FALSE,1,TRUE,14825,17696,-3146,18.1
TRUE,TRUE,2,TRUE,16998,18708,2619,23.6,FALSE,0,FALSE,14379,17499,-2619,21.7
FALSE,FALSE,2,TRUE,15015,16032,-5065,16.7,TRUE,0,FALSE,20080,19584,5065,22.4
TRUE,TRUE,0,FALSE,14881,18074,-856,20.9,FALSE,0,FALSE,15737,18637,856,23.6
TRUE,TRUE,1,TRUE,15730,18484,739,24.1,FALSE,0,FALSE,14991,18754,-739,23.9
TRUE,TRUE,1,TRUE,19098,18636,2447,20.3,FALSE,0,FALSE,16651,18389,-2447,20.7
TRUE,FALSE,0,FALSE,16169,18880,561,23.5,TRUE,0,FALSE,15608,18140,-561,23.5
FALSE,FALSE,1,TRUE,16954,16923,-1073,19.7,TRUE,0,FALSE,18027,16713,1073,17.6
FALSE,FALSE,0,FALSE,15984,17527,193,20.3,TRUE,0,FALSE,15791,17438,-193,22.2
TRUE,TRUE,0,FALSE,18078,18614,1204,26.1,FALSE,1,TRUE,16874,18308,-1204,20.4
TRUE,TRUE,1,TRUE,16329,16575,948,20.6,FALSE,0,FALSE,15381,16559,-948,17.3
FALSE,TRUE,0,FALSE,17193,18326,-1027,22.4,FALSE,0,FALSE,18220,19760,1027,23.6
TRUE,TRUE,1,TRUE,18401,18465,1843,20.1,FALSE,0,FALSE,16558,17063,-1843,21.2
FALSE,TRUE,0,FALSE,14704,17930,-3517,22.7,FALSE,1,TRUE,18221,19748,3517,23.5
FALSE,FALSE,0,FALSE,16367,18191,-1204,25.4,TRUE,1,TRUE,17571,18908,1204,21.8
FALSE,FALSE,0,FALSE,12905,15457,-3927,19.5,TRUE,0,FALSE,16832,18714,3927,21.1
FALSE,FALSE,0,FALSE,13967,16908,-2681,19.7,TRUE,1,TRUE,16648,17742,2681,19.3
FALSE,FALSE,1,TRUE,16511,18106,300,19.9,TRUE,0,FALSE,16211,16384,-300,22.5
FALSE,FALSE,0,FALSE,17496,19884,4,23.2,TRUE,0,FALSE,17492,18671,-4,25.9
TRUE,TRUE,1,TRUE,17743,19173,1572,25.5,FALSE,0,FALSE,16171,18344,-1572,21.8
TRUE,FALSE,1,TRUE,16888,18788,856,20.2,TRUE,1,FALSE,16032,17150,-856,19.8
FALSE,FALSE,1,FALSE,13742,17269,-2296,20.8,TRUE,1,TRUE,16038,18482,2296,25
FALSE,FALSE,0,FALSE,17793,18271,-1961,18.7,TRUE,1,TRUE,19754,18663,1961,17.3
FALSE,TRUE,0,FALSE,16178,17363,-1320,22.1,FALSE,1,FALSE,17498,18050,1320,18.5
TRUE,FALSE,1,TRUE,17706,18217,-492,21.7,TRUE,0,FALSE,18198,18390,492,23
TRUE,TRUE,2,TRUE,16149,16641,34,19.9,FALSE,0,FALSE,16115,17598,-34,18.4
FALSE,TRUE,0,FALSE,14760,16005,-1964,18.3,FALSE,1,TRUE,16724,19715,1964,20
FALSE,FALSE,0,FALSE,15820,17793,-306,22,TRUE,2,TRUE,16126,18075,306,22.2
FALSE,FALSE,1,FALSE,15173,17165,-2354,18.3,TRUE,1,TRUE,17527,18502,2354,21
FALSE,FALSE,0,FALSE,14769,17725,-1071,21.5,TRUE,0,FALSE,15840,18568,1071,24.2
FALSE,FALSE,0,FALSE,14353,17197,-1009,17.8,TRUE,1,TRUE,15362,17477,1009,22.2
TRUE,TRUE,0,FALSE,16763,17757,147,21.6,FALSE,0,FALSE,16616,18469,-147,24
TRUE,TRUE,0,FALSE,16747,19858,2126,25,FALSE,0,FALSE,14621,18788,-2126,22.7
FALSE,TRUE,0,FALSE,17044,17686,845,21.7,FALSE,1,TRUE,16199,17920,-845,20.7
FALSE,FALSE,0,FALSE,15532,17908,-1779,19,TRUE,0,FALSE,17311,18262,1779,24.2
FALSE,FALSE,2,TRUE,17347,18118,-1305,22.2,TRUE,0,FALSE,18652,19219,1305,21.8
TRUE,TRUE,1,FALSE,18758,18617,2137,22.8,FALSE,0,FALSE,16621,18127,-2137,23.4
TRUE,FALSE,1,FALSE,20711,20463,3673,22,TRUE,1,TRUE,17038,18507,-3673,20.9
TRUE,FALSE,0,FALSE,16539,17585,1947,20.5,TRUE,0,FALSE,14592,16189,-1947,19.6
TRUE,TRUE,1,FALSE,19096,19250,895,20.6,FALSE,0,FALSE,18201,18340,-895,23.5
TRUE,TRUE,2,TRUE,17938,16164,3413,19.9,FALSE,0,FALSE,14525,15768,-3413,19.5
TRUE,TRUE,0,FALSE,17072,17724,-2298,18,FALSE,2,TRUE,19370,18454,2298,24.2
TRUE,TRUE,1,TRUE,19640,18636,5151,21.6,FALSE,0,FALSE,14489,15140,-5151,17.5
TRUE,TRUE,1,TRUE,16891,18224,-51,21.4,FALSE,1,FALSE,16942,17851,51,21.8
TRUE,TRUE,1,TRUE,17485,18330,3075,23.4,FALSE,0,FALSE,14410,16532,-3075,21.4
FALSE,FALSE,0,FALSE,16696,18900,1945,22.5,TRUE,0,FALSE,14751,16286,-1945,19.6
TRUE,TRUE,1,TRUE,17499,19191,2644,23.1,FALSE,0,FALSE,14855,16854,-2644,20.8
TRUE,TRUE,0,FALSE,18288,19569,2569,24.5,FALSE,1,FALSE,15719,17678,-2569,22
FALSE,TRUE,0,FALSE,15684,17384,-1434,17,FALSE,1,FALSE,17118,18793,1434,22.3
FALSE,TRUE,1,FALSE,14737,18532,92,22.9,FALSE,0,FALSE,14645,17804,-92,19.9
FALSE,TRUE,1,TRUE,18715,18626,1326,22.3,FALSE,0,FALSE,17389,18275,-1326,20.8
TRUE,FALSE,1,TRUE,18551,18363,1850,22.5,TRUE,0,FALSE,16701,17529,-1850,21
TRUE,TRUE,1,TRUE,19351,20590,3969,22,FALSE,0,FALSE,15382,17068,-3969,22.1
FALSE,FALSE,0,FALSE,17318,16336,-266,17.5,TRUE,1,TRUE,17584,17860,266,21.7
TRUE,TRUE,1,TRUE,18969,20353,4139,20.5,FALSE,0,FALSE,14830,16929,-4139,17.2
TRUE,TRUE,1,TRUE,17113,18837,3278,20.3,FALSE,0,FALSE,13835,16220,-3278,19.4
FALSE,FALSE,0,FALSE,17201,18755,-1817,20.7,TRUE,1,TRUE,19018,19109,1817,20.1
TRUE,TRUE,0,FALSE,16749,17788,1152,21.7,FALSE,1,TRUE,15597,17388,-1152,18.5
TRUE,FALSE,0,FALSE,16523,18881,2592,22.2,TRUE,1,TRUE,13931,17533,-2592,20.2
FALSE,TRUE,0,FALSE,18285,19465,4581,22.1,FALSE,0,FALSE,13704,15546,-4581,17.5
TRUE,FALSE,1,FALSE,17346,18518,149,21.4,TRUE,0,FALSE,17197,16737,-149,20.5
FALSE,TRUE,0,FALSE,17443,19184,2786,23.8,FALSE,0,FALSE,14657,18303,-2786,21.2
TRUE,FALSE,0,FALSE,16526,17213,562,21.1,TRUE,1,TRUE,15964,16964,-562,23.3
TRUE,TRUE,0,FALSE,17363,17169,903,18.8,FALSE,1,FALSE,16460,16150,-903,20.5
TRUE,FALSE,1,TRUE,18779,19556,3679,25.2,TRUE,0,FALSE,15100,17446,-3679,20.3
FALSE,TRUE,0,FALSE,20317,18795,3899,19.9,FALSE,1,TRUE,16418,16495,-3899,19.7
TRUE,TRUE,1,TRUE,15649,18530,1281,26.9,FALSE,0,FALSE,14368,17419,-1281,22.5
FALSE,TRUE,0,FALSE,16256,17524,329,21.7,FALSE,0,FALSE,15927,18518,-329,22.4
TRUE,TRUE,0,FALSE,16688,18697,1008,24.7,FALSE,1,TRUE,15680,18945,-1008,19.9
FALSE,FALSE,1,FALSE,17724,19917,3192,21,TRUE,0,FALSE,14532,16566,-3192,20.5
FALSE,FALSE,1,FALSE,15320,16625,-4348,17.6,TRUE,1,TRUE,19668,20644,4348,20.8
TRUE,FALSE,1,TRUE,15900,17169,-689,20.3,TRUE,0,FALSE,16589,18600,689,21.8
TRUE,TRUE,1,TRUE,18377,17762,2963,19.3,FALSE,0,FALSE,15414,17621,-2963,22.1
FALSE,FALSE,1,TRUE,15785,17629,-522,21,TRUE,0,FALSE,16307,18643,522,22.1
FALSE,FALSE,0,FALSE,17625,19146,514,20.5,TRUE,0,FALSE,17111,17073,-514,22.3
FALSE,FALSE,0,FALSE,19931,18115,4375,21.3,TRUE,0,FALSE,15556,14866,-4375,16.9
FALSE,TRUE,1,TRUE,19331,19211,4289,21.3,FALSE,0,FALSE,15042,15221,-4289,17.1
TRUE,FALSE,1,TRUE,17048,18842,-32,20.1,TRUE,0,FALSE,17080,17994,32,19.7
FALSE,FALSE,0,FALSE,17910,16867,88,20.7,TRUE,1,FALSE,17822,17456,-88,19.7
TRUE,TRUE,1,TRUE,16614,18570,3295,22.1,FALSE,0,FALSE,13319,15102,-3295,20.5
FALSE,FALSE,0,FALSE,15943,17366,-467,22.9,TRUE,0,FALSE,16410,18727,467,23.5
TRUE,FALSE,0,FALSE,14924,17139,-2611,20.7,TRUE,1,TRUE,17535,18514,2611,21.8
TRUE,FALSE,1,TRUE,15069,16824,-1974,19.8,TRUE,0,FALSE,17043,17413,1974,21.6
TRUE,FALSE,0,FALSE,16366,17010,-963,19.6,TRUE,0,FALSE,17329,17467,963,22
FALSE,FALSE,0,FALSE,14158,16377,-5740,19.4,TRUE,2,TRUE,19898,20086,5740,24
FALSE,FALSE,0,FALSE,14291,18239,-2609,20.7,TRUE,1,TRUE,16900,20025,2609,25.9
FALSE,FALSE,0,FALSE,15078,16578,-1018,20.2,TRUE,1,TRUE,16096,17406,1018,22.2
TRUE,TRUE,0,FALSE,17234,17496,2477,19.5,FALSE,0,FALSE,14757,16391,-2477,19.4
TRUE,TRUE,1,TRUE,17826,18216,3074,22,FALSE,0,FALSE,14752,16943,-3074,20.5
FALSE,FALSE,1,TRUE,18445,18076,552,19.9,TRUE,0,FALSE,17893,18269,-552,20.7
FALSE,FALSE,1,TRUE,15814,17161,-1530,20.5,TRUE,1,FALSE,17344,18083,1530,25.2
FALSE,FALSE,0,FALSE,16735,17923,-2187,20.2,TRUE,1,TRUE,18922,20306,2187,20.8
FALSE,FALSE,0,FALSE,15818,16673,-4100,17.2,TRUE,0,FALSE,19918,20395,4100,22
FALSE,FALSE,0,FALSE,16999,18578,389,23.2,TRUE,2,TRUE,16610,18857,-389,21.6
FALSE,FALSE,0,FALSE,15867,17737,-1806,22.7,TRUE,0,FALSE,17673,18990,1806,20
TRUE,TRUE,0,FALSE,18042,17600,704,22.1,FALSE,0,FALSE,17338,18022,-704,19.8
TRUE,TRUE,2,TRUE,18293,19340,2406,22.8,FALSE,0,FALSE,15887,17056,-2406,22.4
TRUE,TRUE,0,FALSE,15895,18344,42,23.9,FALSE,1,TRUE,15853,17977,-42,25.8
FALSE,FALSE,0,FALSE,14305,17810,-2889,25.1,TRUE,1,TRUE,17194,19916,2889,28.2
TRUE,TRUE,1,TRUE,18186,19555,3131,23.2,FALSE,0,FALSE,15055,17178,-3131,23.1
FALSE,FALSE,0,FALSE,16295,17588,-1271,22.2,TRUE,1,TRUE,17566,17952,1271,21.9
TRUE,TRUE,1,TRUE,20151,19504,6783,22.6,FALSE,0,FALSE,13368,14786,-6783,17.7
FALSE,FALSE,0,FALSE,14735,16488,-2932,21.9,TRUE,0,FALSE,17667,18551,2932,22.3
FALSE,FALSE,1,TRUE,12798,13908,-7868,17.9,TRUE,0,FALSE,20666,19247,7868,22.3
TRUE,TRUE,1,TRUE,16452,18564,271,23.4,FALSE,1,FALSE,16181,18542,-271,22.4
FALSE,FALSE,0,FALSE,16120,18149,-732,21.5,TRUE,1,TRUE,16852,17399,732,20.5
TRUE,TRUE,0,FALSE,18287,19617,1863,22.6,FALSE,0,FALSE,16424,17347,-1863,23.2
FALSE,FALSE,0,FALSE,15902,17995,-1190,24.1,TRUE,1,TRUE,17092,18061,1190,24.1
TRUE,FALSE,0,FALSE,16982,19524,-212,21.8,TRUE,2,TRUE,17194,18312,212,24.2
FALSE,FALSE,0,FALSE,17064,18061,134,23.6,TRUE,1,TRUE,16930,18457,-134,21
FALSE,FALSE,0,FALSE,15424,16080,-3692,20.8,TRUE,2,TRUE,19116,19192,3692,19.5
TRUE,TRUE,0,FALSE,18369,19417,3269,21,FALSE,1,TRUE,15100,17013,-3269,21.3
TRUE,TRUE,0,FALSE,17568,18166,1308,23.6,FALSE,0,FALSE,16260,17622,-1308,20.7
TRUE,FALSE,0,FALSE,18090,17730,1106,22.9,TRUE,1,FALSE,16984,17260,-1106,20.4
FALSE,FALSE,1,TRUE,15786,17823,-92,20.7,TRUE,0,FALSE,15878,18993,92,21.5
FALSE,TRUE,0,FALSE,16596,18596,539,25.2,FALSE,1,TRUE,16057,17778,-539,23.6
FALSE,TRUE,1,FALSE,16093,16927,-3195,15.4,FALSE,0,FALSE,19288,17880,3195,21.3
TRUE,TRUE,2,TRUE,18858,19023,4338,23.7,FALSE,0,FALSE,14520,14416,-4338,16.6
FALSE,TRUE,1,TRUE,15288,16534,-861,20.6,FALSE,0,FALSE,16149,16403,861,20
TRUE,FALSE,1,TRUE,16346,17401,-90,22.7,TRUE,0,FALSE,16436,17299,90,23.4
FALSE,FALSE,0,FALSE,13447,16199,-5698,20.1,TRUE,2,TRUE,19145,19874,5698,24
FALSE,TRUE,1,TRUE,16453,17231,-569,20.6,FALSE,1,FALSE,17022,17444,569,19.9
TRUE,FALSE,0,FALSE,18669,19226,1788,21.3,TRUE,1,TRUE,16881,18465,-1788,20.8
TRUE,TRUE,0,FALSE,16192,18197,1056,20.9,FALSE,1,TRUE,15136,18379,-1056,18.5
FALSE,FALSE,1,TRUE,13701,15431,-4095,18.3,TRUE,0,FALSE,17796,18448,4095,25.5
FALSE,TRUE,0,FALSE,16762,18180,482,24.2,FALSE,0,FALSE,16280,18014,-482,23.1
FALSE,TRUE,0,FALSE,16795,18159,-507,23.5,FALSE,1,FALSE,17302,18949,507,20.3
FALSE,FALSE,0,FALSE,14464,15227,-4820,16.4,TRUE,0,FALSE,19284,17878,4820,20.6
FALSE,FALSE,0,FALSE,16925,18087,-962,23.3,TRUE,1,TRUE,17887,17980,962,21.3
FALSE,TRUE,0,FALSE,14302,15878,-3025,21.1,FALSE,2,TRUE,17327,18784,3025,21.2
FALSE,FALSE,1,FALSE,14786,16676,-1340,23.3,TRUE,1,TRUE,16126,17205,1340,20.5
FALSE,FALSE,0,FALSE,15134,18028,-168,21.4,TRUE,1,TRUE,15302,17761,168,21.4
TRUE,FALSE,1,FALSE,18954,17795,-664,22.8,TRUE,1,TRUE,19618,18344,664,18.2
FALSE,TRUE,1,TRUE,16043,17409,-3089,22,FALSE,0,FALSE,19132,20355,3089,23.5
TRUE,FALSE,0,FALSE,15195,17896,-1573,19.6,TRUE,1,TRUE,16768,19067,1573,20.2
TRUE,FALSE,1,TRUE,17205,18124,721,21.8,TRUE,0,FALSE,16484,16047,-721,21.2
FALSE,TRUE,0,FALSE,16022,17853,511,21.9,FALSE,1,FALSE,15511,18531,-511,24.2
TRUE,FALSE,0,FALSE,15615,17928,-1193,20.1,TRUE,0,FALSE,16808,18747,1193,22.9
FALSE,FALSE,0,FALSE,14433,16813,-3215,20.2,TRUE,1,FALSE,17648,18469,3215,24.3
TRUE,TRUE,2,TRUE,19807,17943,5227,22,FALSE,0,FALSE,14580,15892,-5227,21
TRUE,TRUE,1,TRUE,15704,18292,1012,23.6,FALSE,0,FALSE,14692,17773,-1012,23.4
TRUE,TRUE,1,FALSE,17073,17021,2002,22.1,FALSE,0,FALSE,15071,16633,-2002,20.3
TRUE,TRUE,0,FALSE,18584,18383,3093,20.3,FALSE,0,FALSE,15491,17098,-3093,21.2
FALSE,FALSE,1,TRUE,16187,16701,-2377,21.6,TRUE,0,FALSE,18564,19056,2377,20.6
FALSE,FALSE,1,TRUE,16749,16227,-2419,16.6,TRUE,0,FALSE,19168,19540,2419,24
FALSE,FALSE,1,TRUE,16490,19578,-392,21.4,TRUE,0,FALSE,16882,19116,392,23.2
TRUE,TRUE,2,TRUE,16697,19170,852,23.6,FALSE,0,FALSE,15845,17617,-852,21.4
TRUE,FALSE,2,TRUE,17973,20040,2507,19.6,TRUE,0,FALSE,15466,16844,-2507,20.9
TRUE,FALSE,0,FALSE,16029,17493,1756,23.4,TRUE,0,FALSE,14273,15573,-1756,19.9
TRUE,FALSE,2,TRUE,15752,19171,1064,23.1,TRUE,0,FALSE,14688,16700,-1064,23.5
TRUE,TRUE,1,TRUE,15930,18669,1713,23.4,FALSE,0,FALSE,14217,16524,-1713,18.8
FALSE,FALSE,0,FALSE,15241,16491,-1137,19,TRUE,2,TRUE,16378,17893,1137,22.4
TRUE,FALSE,1,TRUE,17127,18148,2294,20.1,TRUE,0,FALSE,14833,16765,-2294,18.3
FALSE,FALSE,0,FALSE,13519,15833,-4115,18.8,TRUE,1,TRUE,17634,18818,4115,25.1
TRUE,FALSE,0,FALSE,18748,19116,2520,24.3,TRUE,0,FALSE,16228,17024,-2520,22.4
TRUE,FALSE,1,TRUE,16055,17933,93,22.7,TRUE,0,FALSE,15962,16738,-93,21.4
TRUE,TRUE,1,TRUE,16496,18201,1744,20.2,FALSE,0,FALSE,14752,17014,-1744,20.9
TRUE,FALSE,1,TRUE,17217,18979,-315,22.2,TRUE,0,FALSE,17532,18986,315,21.8
FALSE,FALSE,0,FALSE,15482,18715,-1335,23.7,TRUE,2,TRUE,16817,18887,1335,22.8
FALSE,TRUE,0,FALSE,14486,18218,-648,20,FALSE,1,TRUE,15134,17490,648,20.8
FALSE,TRUE,0,FALSE,15809,17592,-3854,19.8,FALSE,0,FALSE,19663,19405,3854,23.8
TRUE,TRUE,1,TRUE,19556,18352,2585,22.9,FALSE,0,FALSE,16971,16593,-2585,16.9
TRUE,TRUE,1,TRUE,17003,17799,2247,18.8,FALSE,0,FALSE,14756,16131,-2247,18.9
FALSE,FALSE,0,FALSE,16451,18416,-977,22,TRUE,0,FALSE,17428,18273,977,18.9
TRUE,TRUE,0,FALSE,17837,19440,2970,23.8,FALSE,0,FALSE,14867,17403,-2970,21.7
TRUE,TRUE,1,TRUE,18056,17829,250,19.5,FALSE,1,FALSE,17806,17542,-250,21
FALSE,TRUE,0,FALSE,16249,17245,-1276,18.9,FALSE,0,FALSE,17525,17893,1276,19.3
TRUE,TRUE,0,FALSE,16946,18077,1482,21.2,FALSE,1,TRUE,15464,17022,-1482,16.1
FALSE,FALSE,0,FALSE,15707,17968,428,24.3,TRUE,1,TRUE,15279,17281,-428,24.7
FALSE,TRUE,0,FALSE,16443,18461,-1706,19.3,FALSE,0,FALSE,18149,19488,1706,24.7
TRUE,FALSE,2,TRUE,17823,19752,1014,21.5,TRUE,0,FALSE,16809,18802,-1014,21.9
TRUE,FALSE,0,FALSE,16241,18365,250,23.6,TRUE,1,TRUE,15991,17423,-250,19.6
TRUE,FALSE,1,FALSE,16464,17075,166,20.9,TRUE,1,TRUE,16298,16680,-166,16.7
FALSE,FALSE,0,FALSE,16924,17938,-465,23.3,TRUE,0,FALSE,17389,18374,465,21.4
TRUE,FALSE,1,TRUE,17251,17415,-733,21.7,TRUE,0,FALSE,17984,17956,733,23.4
FALSE,FALSE,0,FALSE,16917,18964,-1013,21.2,TRUE,1,TRUE,17930,19000,1013,26
TRUE,FALSE,2,TRUE,19453,18832,3773,23.9,TRUE,0,FALSE,15680,16875,-3773,17
FALSE,FALSE,0,FALSE,16891,19197,1060,20.7,TRUE,1,TRUE,15831,17643,-1060,21.1
TRUE,TRUE,1,TRUE,17107,19237,2169,21.8,FALSE,0,FALSE,14938,16784,-2169,21.2
TRUE,FALSE,1,TRUE,15444,17833,1019,23.6,TRUE,0,FALSE,14425,17125,-1019,22.9
TRUE,TRUE,2,TRUE,18283,18731,2684,22.6,FALSE,0,FALSE,15599,17540,-2684,21.1
TRUE,TRUE,0,FALSE,16267,18319,1362,24.6,FALSE,2,TRUE,14905,17620,-1362,22.8
TRUE,TRUE,1,FALSE,17247,18845,915,23.3,FALSE,0,FALSE,16332,17135,-915,21.4
FALSE,FALSE,1,FALSE,18640,18015,1931,22.6,TRUE,1,TRUE,16709,16815,-1931,23.2
TRUE,TRUE,0,FALSE,17086,19170,3655,22.1,FALSE,1,TRUE,13431,16427,-3655,19.8
FALSE,TRUE,0,FALSE,16505,17567,805,20.5,FALSE,1,TRUE,15700,17418,-805,25.6
TRUE,FALSE,0,FALSE,17961,17984,478,17.2,TRUE,1,TRUE,17483,18108,-478,15.9
TRUE,TRUE,1,TRUE,19418,18520,1698,20.4,FALSE,1,FALSE,17720,16283,-1698,16.7
TRUE,TRUE,0,FALSE,15846,18388,-330,21.4,FALSE,1,TRUE,16176,18854,330,23.6
TRUE,TRUE,1,FALSE,16937,18194,592,22.1,FALSE,1,TRUE,16345,17952,-592,21.5
FALSE,TRUE,0,FALSE,14064,16539,-1765,22,FALSE,1,TRUE,15829,18883,1765,24.4
FALSE,TRUE,0,FALSE,15094,18255,-92,24.6,FALSE,1,TRUE,15186,18499,92,22.6
FALSE,TRUE,1,TRUE,15633,17179,-2947,19.3,FALSE,0,FALSE,18580,19368,2947,22.4
TRUE,TRUE,1,TRUE,16868,18060,1982,24.5,FALSE,0,FALSE,14886,17070,-1982,22.7
TRUE,FALSE,1,FALSE,19289,19633,2330,24,TRUE,0,FALSE,16959,17314,-2330,20
TRUE,FALSE,1,TRUE,15138,18807,-105,19.4,TRUE,0,FALSE,15243,17721,105,23.5
TRUE,FALSE,2,TRUE,14942,17727,-1215,21,TRUE,0,FALSE,16157,18483,1215,23.3
FALSE,FALSE,1,TRUE,15703,16893,-951,19.1,TRUE,0,FALSE,16654,18009,951,22.1
TRUE,TRUE,2,TRUE,15427,17667,134,21.7,FALSE,0,FALSE,15293,17811,-134,23.5
TRUE,TRUE,0,FALSE,16620,17711,361,23.8,FALSE,0,FALSE,16259,18383,-361,22.3
TRUE,FALSE,1,TRUE,15926,17186,905,20.9,TRUE,0,FALSE,15021,15817,-905,18
FALSE,TRUE,0,FALSE,16852,17417,348,21,FALSE,1,TRUE,16504,18421,-348,21.6
FALSE,TRUE,0,FALSE,16936,18023,-424,21.9,FALSE,2,TRUE,17360,18653,424,23
TRUE,TRUE,1,TRUE,17917,18904,3058,21.2,FALSE,1,FALSE,14859,17579,-3058,22.2
FALSE,TRUE,1,TRUE,17558,17445,-105,24.1,FALSE,1,FALSE,17663,18846,105,23.2
FALSE,FALSE,0,FALSE,15149,17143,-1876,20.5,TRUE,1,TRUE,17025,19802,1876,21.1
FALSE,FALSE,1,TRUE,16112,16747,-1031,21.5,TRUE,0,FALSE,17143,17507,1031,21.1
FALSE,TRUE,0,FALSE,15885,19056,125,20.7,FALSE,0,FALSE,15760,16998,-125,22.4
TRUE,TRUE,1,FALSE,17104,17075,-669,22.4,FALSE,1,TRUE,17773,17577,669,20.9
TRUE,FALSE,1,TRUE,17535,15420,1436,17.3,TRUE,0,FALSE,16099,16964,-1436,20.7
FALSE,TRUE,1,TRUE,17321,18683,-78,20.5,FALSE,1,FALSE,17399,18838,78,20.7
TRUE,TRUE,1,FALSE,16317,18679,-713,20.4,FALSE,1,TRUE,17030,18576,713,21.2
FALSE,FALSE,0,FALSE,15649,18614,-1975,23.4,TRUE,1,TRUE,17624,19729,1975,24.3
TRUE,TRUE,0,FALSE,17592,18664,1411,22,FALSE,1,TRUE,16181,17898,-1411,21.5
TRUE,TRUE,1,TRUE,15420,18204,661,23,FALSE,0,FALSE,14759,18065,-661,24.5
FALSE,FALSE,0,FALSE,15929,17529,-394,22.6,TRUE,1,FALSE,16323,19164,394,23.7
FALSE,TRUE,0,FALSE,15046,16504,-557,17.8,FALSE,0,FALSE,15603,17336,557,21.7
TRUE,FALSE,0,FALSE,16737,19857,1204,24.3,TRUE,1,TRUE,15533,17853,-1204,25
FALSE,TRUE,0,FALSE,15756,16210,-1966,20.4,FALSE,0,FALSE,17722,19399,1966,24.2
TRUE,FALSE,1,TRUE,15442,17518,-1090,23.8,TRUE,0,FALSE,16532,19017,1090,23.3
FALSE,TRUE,1,FALSE,16649,15616,-1152,16.6,FALSE,1,TRUE,17801,17809,1152,20.8
FALSE,FALSE,1,FALSE,16171,17902,-1682,20.2,TRUE,1,TRUE,17853,17973,1682,22.6
TRUE,TRUE,1,TRUE,17190,17783,1847,21,FALSE,1,FALSE,15343,16699,-1847,20
FALSE,TRUE,0,FALSE,17222,18157,808,22.7,FALSE,1,TRUE,16414,18393,-808,25
TRUE,FALSE,1,TRUE,15704,17114,-1332,19.9,TRUE,0,FALSE,17036,19118,1332,21.7
FALSE,FALSE,0,FALSE,16331,14886,-3966,16.2,TRUE,1,FALSE,20297,17885,3966,16.9
FALSE,FALSE,1,FALSE,19186,18375,1377,18.3,TRUE,1,TRUE,17809,17580,-1377,20.1
TRUE,TRUE,1,TRUE,17546,17209,1493,22.8,FALSE,1,FALSE,16053,16042,-1493,19.3
FALSE,FALSE,0,FALSE,15198,17177,-2876,21.9,TRUE,1,FALSE,18074,19892,2876,22.2
FALSE,FALSE,1,TRUE,17909,16512,1340,16.5,TRUE,0,FALSE,16569,16719,-1340,20.1
FALSE,FALSE,0,FALSE,15046,17140,-1208,20.8,TRUE,1,TRUE,16254,17754,1208,22.7
TRUE,FALSE,0,FALSE,16740,19237,218,23.8,TRUE,1,TRUE,16522,18152,-218,22.9
TRUE,TRUE,1,TRUE,20295,19531,6907,25.8,FALSE,0,FALSE,13388,15019,-6907,17.8
TRUE,FALSE,0,FALSE,15921,18190,-594,21.7,TRUE,2,TRUE,16515,18543,594,23.5
FALSE,FALSE,2,TRUE,17145,17904,-1464,19.2,TRUE,0,FALSE,18609,18358,1464,22.6
TRUE,FALSE,0,FALSE,15936,18030,554,20.5,TRUE,0,FALSE,15382,18732,-554,17.9
TRUE,TRUE,1,FALSE,16649,19322,1256,22.6,FALSE,1,TRUE,15393,19617,-1256,26.8
TRUE,TRUE,1,TRUE,17618,18556,4373,20.3,FALSE,0,FALSE,13245,14270,-4373,18.4
TRUE,TRUE,0,FALSE,15871,17106,-245,19.5,FALSE,1,TRUE,16116,17384,245,22.1
FALSE,TRUE,1,FALSE,17676,18151,393,20.6,FALSE,1,TRUE,17283,18366,-393,22.3
TRUE,TRUE,0,FALSE,17423,19973,2822,24.8,FALSE,1,TRUE,14601,17766,-2822,21.9
FALSE,FALSE,0,FALSE,13410,16059,-5025,21,TRUE,1,TRUE,18435,18669,5025,22.8
TRUE,FALSE,0,FALSE,16992,18385,-371,21.9,TRUE,1,TRUE,17363,18557,371,22.5
TRUE,TRUE,2,TRUE,18678,18538,3999,23.1,FALSE,0,FALSE,14679,16315,-3999,19.3
FALSE,FALSE,0,FALSE,16220,17906,-4157,22.2,TRUE,1,TRUE,20377,19630,4157,25.7
FALSE,FALSE,0,FALSE,14930,15593,-5298,16.9,TRUE,1,TRUE,20228,20263,5298,24.2
FALSE,FALSE,0,FALSE,16304,17825,-28,20.1,TRUE,0,FALSE,16332,17888,28,20.9
TRUE,FALSE,1,TRUE,17075,18159,462,23,TRUE,0,FALSE,16613,17580,-462,22.4
FALSE,FALSE,0,FALSE,15499,17516,-81,22.5,TRUE,1,TRUE,15580,17517,81,21.4
TRUE,TRUE,2,TRUE,16972,19577,752,21.8,FALSE,0,FALSE,16220,19233,-752,24.7
FALSE,FALSE,0,FALSE,15256,16464,-1555,18.9,TRUE,1,TRUE,16811,16821,1555,18.2
TRUE,FALSE,0,FALSE,16568,18645,1188,19.7,TRUE,2,TRUE,15380,16606,-1188,20.7
TRUE,TRUE,1,FALSE,17326,18459,1639,22.4,FALSE,1,TRUE,15687,18672,-1639,24.8
TRUE,FALSE,0,FALSE,16619,18958,1552,22.6,TRUE,0,FALSE,15067,17470,-1552,21.3
FALSE,FALSE,0,FALSE,16295,18278,41,26.1,TRUE,1,TRUE,16254,19214,-41,23.4
TRUE,TRUE,1,TRUE,15680,17099,-259,18.6,FALSE,0,FALSE,15939,18214,259,22.7
FALSE,TRUE,0,FALSE,16432,16967,367,19.1,FALSE,1,TRUE,16065,17992,-367,21.2
TRUE,FALSE,2,TRUE,19197,18449,2941,21.9,TRUE,0,FALSE,16256,16599,-2941,19.2
TRUE,TRUE,1,TRUE,18468,18822,1142,22.1,FALSE,0,FALSE,17326,18539,-1142,25.2
TRUE,TRUE,0,FALSE,18280,18115,4051,22.9,FALSE,1,TRUE,14229,16721,-4051,21.1
TRUE,FALSE,0,FALSE,16103,17019,-2419,19.3,TRUE,1,FALSE,18522,18456,2419,24.6
TRUE,TRUE,2,TRUE,16832,18675,1624,22.1,FALSE,0,FALSE,15208,17667,-1624,23.8
FALSE,FALSE,1,TRUE,15028,17228,-2254,23.2,TRUE,0,FALSE,17282,17607,2254,23.2
TRUE,TRUE,1,FALSE,17076,18945,834,19.4,FALSE,0,FALSE,16242,17092,-834,23.8
TRUE,TRUE,0,FALSE,16745,17283,2150,21,FALSE,0,FALSE,14595,16179,-2150,18.7
TRUE,FALSE,1,FALSE,15658,17351,-1624,22.2,TRUE,1,TRUE,17282,19370,1624,20.7
TRUE,TRUE,1,FALSE,15760,18719,-2072,16.7,FALSE,1,TRUE,17832,18307,2072,26.8
FALSE,FALSE,1,FALSE,14624,16881,-2089,21,TRUE,0,FALSE,16713,16344,2089,21.5
TRUE,FALSE,0,FALSE,15568,18302,542,24.5,TRUE,1,TRUE,15026,17090,-542,20.9
FALSE,FALSE,1,FALSE,16331,17920,-226,23.1,TRUE,0,FALSE,16557,18141,226,22.6
TRUE,TRUE,2,TRUE,17204,18986,316,24,FALSE,0,FALSE,16888,18976,-316,23.6
FALSE,TRUE,0,FALSE,14910,15466,-821,19.5,FALSE,1,TRUE,15731,18006,821,20.6
TRUE,TRUE,1,TRUE,19141,20647,4294,19.2,FALSE,0,FALSE,14847,16209,-4294,21
FALSE,FALSE,0,FALSE,14208,17036,-4891,19.4,TRUE,1,FALSE,19099,19371,4891,26.6
TRUE,FALSE,1,TRUE,17951,18031,3432,23.4,TRUE,0,FALSE,14519,15714,-3432,18.3
TRUE,TRUE,1,TRUE,16142,17610,-563,19.7,FALSE,0,FALSE,16705,18422,563,20.7
TRUE,FALSE,0,FALSE,16333,19527,60,23.7,TRUE,1,TRUE,16273,19868,-60,25.2
FALSE,TRUE,0,FALSE,17526,17824,2761,22.2,FALSE,1,TRUE,14765,17144,-2761,21.6
TRUE,TRUE,2,TRUE,17381,20017,1542,22.1,FALSE,0,FALSE,15839,17838,-1542,20.4
FALSE,FALSE,1,FALSE,17854,20383,2323,23,TRUE,0,FALSE,15531,18263,-2323,21.9
FALSE,TRUE,1,TRUE,15698,17468,-1143,20.6,FALSE,1,FALSE,16841,18327,1143,25.9
TRUE,FALSE,0,FALSE,16039,17942,-665,19.5,TRUE,1,TRUE,16704,18513,665,23.1
FALSE,FALSE,1,FALSE,14506,16989,-2520,20.6,TRUE,1,TRUE,17026,18921,2520,22.1
TRUE,FALSE,0,FALSE,16830,18944,708,22.6,TRUE,2,TRUE,16122,17736,-708,20.4
TRUE,FALSE,1,TRUE,14909,18031,410,24.5,TRUE,0,FALSE,14499,17311,-410,23.7
TRUE,FALSE,0,FALSE,12939,15958,-4578,20.1,TRUE,1,TRUE,17517,19631,4578,25.9
FALSE,FALSE,0,FALSE,16678,18875,1079,21.6,TRUE,1,TRUE,15599,17289,-1079,22
FALSE,FALSE,0,FALSE,15322,15807,-4024,21,TRUE,1,TRUE,19346,18180,4024,20.3
FALSE,TRUE,0,FALSE,16562,18781,44,21,FALSE,1,TRUE,16518,18611,-44,24.5
TRUE,TRUE,1,FALSE,16353,18367,-560,21.4,FALSE,1,TRUE,16913,18413,560,22.1
FALSE,FALSE,1,FALSE,16998,17282,-1343,20.7,TRUE,1,TRUE,18341,17873,1343,19.1
FALSE,FALSE,1,TRUE,15051,16743,60,18.8,TRUE,0,FALSE,14991,16420,-60,20.6
FALSE,FALSE,0,FALSE,14986,17222,-1501,20.8,TRUE,0,FALSE,16487,18700,1501,22
FALSE,TRUE,0,FALSE,17003,18007,1331,21.4,FALSE,0,FALSE,15672,16720,-1331,19
FALSE,FALSE,1,TRUE,15380,15984,-4864,22.6,TRUE,1,FALSE,20244,18802,4864,23.1
TRUE,TRUE,2,TRUE,18599,20735,3821,21.6,FALSE,0,FALSE,14778,16447,-3821,18.7
TRUE,FALSE,0,FALSE,15936,17755,-1477,19.2,TRUE,1,TRUE,17413,18773,1477,24.5
TRUE,TRUE,0,FALSE,15265,17859,446,22.4,FALSE,0,FALSE,14819,17596,-446,23.7
TRUE,TRUE,1,TRUE,18177,18965,3504,21.9,FALSE,0,FALSE,14673,17970,-3504,21.4
FALSE,FALSE,1,FALSE,16605,16894,2046,22,TRUE,1,TRUE,14559,16310,-2046,17.5
FALSE,TRUE,0,FALSE,14742,17515,-541,20.3,FALSE,2,TRUE,15283,18609,541,23
FALSE,FALSE,0,FALSE,14440,17275,-3132,19.4,TRUE,1,TRUE,17572,18905,3132,22
FALSE,FALSE,0,FALSE,12798,12111,-8472,18.7,TRUE,1,TRUE,21270,20353,8472,22.4
FALSE,FALSE,0,FALSE,15698,17663,-687,20.1,TRUE,1,TRUE,16385,18035,687,23
TRUE,TRUE,1,TRUE,17324,19349,3129,21.6,FALSE,0,FALSE,14195,16427,-3129,20.8
FALSE,FALSE,1,FALSE,14613,17026,-2539,23.3,TRUE,1,TRUE,17152,17969,2539,23.4
FALSE,TRUE,0,FALSE,14705,16663,-2167,19.6,FALSE,1,TRUE,16872,19170,2167,24
TRUE,FALSE,0,FALSE,17536,19665,910,24.7,TRUE,1,TRUE,16626,18396,-910,22.6
FALSE,FALSE,1,FALSE,15226,17298,-521,21.3,TRUE,1,TRUE,15747,18573,521,23.6
FALSE,TRUE,0,FALSE,16051,17771,523,19.7,FALSE,1,TRUE,15528,18831,-523,22.6
TRUE,FALSE,0,FALSE,15158,17197,-341,23.6,TRUE,2,TRUE,15499,19179,341,21.9
FALSE,TRUE,0,FALSE,16934,16045,247,19.3,FALSE,1,TRUE,16687,16820,-247,19.1
FALSE,TRUE,1,FALSE,15228,16963,-2236,19.8,FALSE,1,TRUE,17464,19033,2236,22.7
TRUE,TRUE,0,FALSE,17710,18758,3297,20.5,FALSE,1,TRUE,14413,15775,-3297,18.3
FALSE,FALSE,0,FALSE,14971,18121,-682,22.8,TRUE,1,TRUE,15653,18210,682,25.2
FALSE,FALSE,1,FALSE,17835,18036,1923,20.5,TRUE,0,FALSE,15912,17599,-1923,21.6
TRUE,FALSE,2,TRUE,17071,19347,1738,23.4,TRUE,0,FALSE,15333,16900,-1738,22.6
FALSE,FALSE,1,TRUE,16245,18044,-3451,20.8,TRUE,1,FALSE,19696,20264,3451,23.5
FALSE,TRUE,0,FALSE,16835,17368,2251,23.5,FALSE,2,TRUE,14584,17652,-2251,24.8
FALSE,TRUE,0,FALSE,17088,18768,-884,22.6,FALSE,2,TRUE,17972,17805,884,21.8
FALSE,FALSE,1,TRUE,16383,19209,864,22.3,TRUE,0,FALSE,15519,18311,-864,24.6
TRUE,TRUE,1,TRUE,16577,17637,1830,22,FALSE,1,FALSE,14747,18869,-1830,21.9
TRUE,TRUE,1,TRUE,19607,19804,3913,22.1,FALSE,0,FALSE,15694,16856,-3913,22
TRUE,TRUE,2,TRUE,15775,17200,-2675,14.9,FALSE,0,FALSE,18450,18525,2675,23.1
FALSE,TRUE,2,TRUE,14998,16127,-1430,18.5,FALSE,0,FALSE,16428,15980,1430,19.6
FALSE,TRUE,2,TRUE,16906,17910,226,20.7,FALSE,0,FALSE,16680,17689,-226,17.6
TRUE,TRUE,2,TRUE,18743,18381,4324,20.9,FALSE,0,FALSE,14419,16676,-4324,19.1
FALSE,FALSE,0,FALSE,16634,17892,-355,19.8,TRUE,0,FALSE,16989,17613,355,19.5
FALSE,FALSE,0,FALSE,13636,14432,-4529,17.7,TRUE,2,TRUE,18165,19097,4529,24.9
FALSE,TRUE,1,TRUE,13744,15449,-4663,16.7,FALSE,0,FALSE,18407,19073,4663,21.9
FALSE,TRUE,1,TRUE,15823,17501,-211,23,FALSE,0,FALSE,16034,19318,211,23.3
TRUE,TRUE,1,TRUE,16356,19371,38,21.9,FALSE,1,FALSE,16318,18130,-38,22.6
FALSE,FALSE,1,FALSE,19801,17196,3315,19.5,TRUE,1,TRUE,16486,16292,-3315,14.7
FALSE,TRUE,0,FALSE,18200,17815,1211,20.2,FALSE,1,TRUE,16989,18572,-1211,21.1
FALSE,FALSE,0,FALSE,15335,18648,-188,23,TRUE,1,TRUE,15523,18378,188,24.8
TRUE,TRUE,0,FALSE,16792,18901,1852,23.8,FALSE,0,FALSE,14940,16788,-1852,21.8
FALSE,TRUE,1,TRUE,20086,18345,3059,23.2,FALSE,1,FALSE,17027,16937,-3059,20.7
FALSE,FALSE,0,FALSE,13858,16054,-2552,23.2,TRUE,2,TRUE,16410,18322,2552,23.9
FALSE,TRUE,0,FALSE,16190,17505,-1566,22.2,FALSE,1,TRUE,17756,19357,1566,25.8
FALSE,TRUE,0,FALSE,16112,18155,-2967,20.2,FALSE,0,FALSE,19079,18913,2967,23.8
TRUE,FALSE,1,FALSE,17298,17146,-98,19.8,TRUE,1,TRUE,17396,17315,98,18.2
FALSE,FALSE,0,FALSE,14593,17874,-1972,24,TRUE,0,FALSE,16565,19051,1972,25.3
TRUE,TRUE,1,TRUE,17723,17913,557,20.1,FALSE,0,FALSE,17166,19296,-557,20.4
FALSE,TRUE,1,FALSE,16565,17417,1217,20.4,FALSE,0,FALSE,15348,17108,-1217,21.4
TRUE,FALSE,0,FALSE,16301,19215,-27,25.4,TRUE,1,TRUE,16328,18821,27,23.4
TRUE,TRUE,1,FALSE,16698,19972,865,23.8,FALSE,1,TRUE,15833,17287,-865,21.3
FALSE,FALSE,0,FALSE,14878,18414,-1653,23.5,TRUE,1,TRUE,16531,19703,1653,25.8
FALSE,FALSE,1,TRUE,16494,19149,1932,25.5,TRUE,0,FALSE,14562,17052,-1932,18.2
FALSE,TRUE,0,FALSE,15463,17005,-3386,20.6,FALSE,0,FALSE,18849,19734,3386,23.4
FALSE,FALSE,0,FALSE,15435,15816,-5097,16.1,TRUE,1,TRUE,20532,19298,5097,22.6
FALSE,TRUE,2,TRUE,16165,18233,1321,21.5,FALSE,0,FALSE,14844,16498,-1321,24.5
FALSE,TRUE,1,TRUE,16640,17949,-276,23.3,FALSE,0,FALSE,16916,19373,276,22
FALSE,TRUE,1,FALSE,16422,17507,-19,21.2,FALSE,0,FALSE,16441,18629,19,25.6
TRUE,TRUE,0,FALSE,17863,19086,2590,25.6,FALSE,0,FALSE,15273,17236,-2590,21.8
FALSE,TRUE,0,FALSE,16970,17201,510,22.6,FALSE,1,TRUE,16460,17802,-510,23
FALSE,FALSE,0,FALSE,14866,17470,103,19.1,TRUE,1,FALSE,14763,17058,-103,23.9
TRUE,TRUE,0,FALSE,17761,18196,-237,22.9,FALSE,1,TRUE,17998,18696,237,20
TRUE,FALSE,0,FALSE,16650,18854,-612,23.3,TRUE,2,TRUE,17262,18305,612,23.2
FALSE,TRUE,1,FALSE,18607,20228,4488,26.4,FALSE,1,TRUE,14119,17037,-4488,21
FALSE,FALSE,0,FALSE,16237,17830,335,20.9,TRUE,1,TRUE,15902,17155,-335,19.2
FALSE,FALSE,1,TRUE,14273,17164,-814,22,TRUE,1,FALSE,15087,17582,814,22.4
TRUE,TRUE,1,TRUE,15906,17700,-39,23.2,FALSE,0,FALSE,15945,17236,39,19.7
TRUE,TRUE,0,FALSE,16083,18268,80,26.4,FALSE,1,TRUE,16003,18877,-80,22.5
FALSE,FALSE,2,TRUE,15034,17176,-1975,20.4,TRUE,0,FALSE,17009,18064,1975,20.1
FALSE,TRUE,0,FALSE,16660,18967,1723,25.7,FALSE,2,TRUE,14937,17997,-1723,22.7
FALSE,TRUE,1,TRUE,13945,14302,-5763,15.5,FALSE,1,FALSE,19708,19033,5763,20.3
FALSE,FALSE,0,FALSE,14991,17279,-6050,20.7,TRUE,0,FALSE,21041,21360,6050,27.3
FALSE,TRUE,1,TRUE,16653,18507,1152,26.1,FALSE,0,FALSE,15501,18536,-1152,22.8
TRUE,TRUE,1,FALSE,17557,18193,3822,20.9,FALSE,0,FALSE,13735,15213,-3822,22.4
FALSE,FALSE,1,TRUE,14439,16198,-2975,19.6,TRUE,0,FALSE,17414,18222,2975,23.5
TRUE,TRUE,1,TRUE,18567,18176,1526,22.7,FALSE,0,FALSE,17041,17704,-1526,20.3
TRUE,TRUE,1,TRUE,17079,17962,3916,22.9,FALSE,0,FALSE,13163,15363,-3916,19.1
TRUE,TRUE,2,TRUE,21051,20745,8776,27.6,FALSE,0,FALSE,12275,12397,-8776,17.6
FALSE,FALSE,0,FALSE,15229,16071,-4493,21.3,TRUE,2,TRUE,19722,19901,4493,21.8
TRUE,TRUE,1,TRUE,16490,18411,1018,21.4,FALSE,1,FALSE,15472,19434,-1018,20.4
TRUE,TRUE,0,FALSE,17047,17601,-97,20,FALSE,1,TRUE,17144,17436,97,19.8
FALSE,FALSE,0,FALSE,14844,17089,-933,18.7,TRUE,1,FALSE,15777,17725,933,21.7
FALSE,FALSE,0,FALSE,16382,18090,-4322,20.6,TRUE,1,FALSE,20704,19678,4322,24.4
TRUE,FALSE,0,FALSE,18113,19187,1350,23.1,TRUE,0,FALSE,16763,18663,-1350,26.2
FALSE,FALSE,0,FALSE,13933,16583,-5490,19.4,TRUE,1,TRUE,19423,19059,5490,22.5
FALSE,FALSE,1,TRUE,16352,17749,-730,21.4,TRUE,0,FALSE,17082,17691,730,19.1
TRUE,TRUE,0,FALSE,15098,19226,-631,23.9,FALSE,1,TRUE,15729,18889,631,25.8
FALSE,TRUE,1,FALSE,16384,18938,-183,24.4,FALSE,1,TRUE,16567,18684,183,24.3
FALSE,TRUE,1,FALSE,17132,16777,-2250,19.8,FALSE,1,TRUE,19382,18368,2250,19.6
FALSE,TRUE,1,TRUE,16116,18086,493,24.9,FALSE,0,FALSE,15623,18785,-493,25
FALSE,TRUE,0,FALSE,17201,18871,-211,23,FALSE,1,TRUE,17412,19497,211,22.2
TRUE,FALSE,0,FALSE,15224,18728,-1611,22.8,TRUE,0,FALSE,16835,18631,1611,24.7
FALSE,FALSE,0,FALSE,15334,16172,-1343,20.3,TRUE,1,TRUE,16677,16940,1343,20.4
TRUE,TRUE,2,TRUE,21016,20144,5512,27.2,FALSE,0,FALSE,15504,16900,-5512,21.2
FALSE,FALSE,0,FALSE,15812,17646,-3590,18.6,TRUE,1,TRUE,19402,19329,3590,21.6
TRUE,TRUE,1,FALSE,15447,15691,-406,19.4,FALSE,0,FALSE,15853,17439,406,21.9
FALSE,TRUE,0,FALSE,15812,16319,-2150,20.9,FALSE,1,TRUE,17962,17534,2150,17.5
FALSE,FALSE,1,TRUE,14301,17056,-679,21.4,TRUE,0,FALSE,14980,18387,679,21.6
TRUE,FALSE,1,FALSE,14749,16489,-3114,20.4,TRUE,0,FALSE,17863,19058,3114,22.4
TRUE,FALSE,0,FALSE,17605,19964,1564,25.4,TRUE,1,TRUE,16041,19296,-1564,21.4
FALSE,FALSE,1,TRUE,15535,17403,-4205,20.7,TRUE,0,FALSE,19740,18943,4205,25.1
TRUE,TRUE,0,FALSE,18761,19378,4172,23,FALSE,0,FALSE,14589,17460,-4172,25.9
TRUE,TRUE,1,TRUE,16855,16841,-2672,21.6,FALSE,0,FALSE,19527,19652,2672,20.4
TRUE,TRUE,1,TRUE,21352,20771,4287,22.4,FALSE,0,FALSE,17065,16833,-4287,13.5
FALSE,TRUE,1,TRUE,15990,18712,811,22.1,FALSE,0,FALSE,15179,17831,-811,23.5
TRUE,TRUE,1,TRUE,15015,16819,-585,18.4,FALSE,1,FALSE,15600,17628,585,24.8
FALSE,FALSE,1,FALSE,15432,16542,-1042,22.3,TRUE,1,TRUE,16474,18572,1042,22.1
FALSE,FALSE,0,FALSE,15404,18235,163,23.6,TRUE,1,TRUE,15241,16745,-163,23.8
FALSE,TRUE,1,TRUE,16224,18401,1697,23.3,FALSE,0,FALSE,14527,17291,-1697,23.8
FALSE,TRUE,1,TRUE,17437,17146,1059,17.7,FALSE,1,FALSE,16378,16966,-1059,18.6
FALSE,TRUE,1,FALSE,17783,19374,1498,23.6,FALSE,1,TRUE,16285,19225,-1498,21.3
TRUE,FALSE,0,FALSE,17618,19023,457,22.7,TRUE,1,TRUE,17161,18331,-457,22.5
TRUE,FALSE,1,TRUE,18984,20083,4620,25.4,TRUE,0,FALSE,14364,17212,-4620,17.1
TRUE,TRUE,1,TRUE,18104,17404,1117,20.5,FALSE,0,FALSE,16987,18041,-1117,16.8
TRUE,TRUE,0,FALSE,17250,19462,929,25.1,FALSE,1,TRUE,16321,18110,-929,21.1
FALSE,FALSE,2,TRUE,16222,18814,459,24.3,TRUE,0,FALSE,15763,17505,-459,23.4
FALSE,FALSE,0,FALSE,15179,17994,-2537,23.8,TRUE,1,TRUE,17716,19597,2537,21.6
FALSE,TRUE,0,FALSE,13896,13354,-4882,19.7,FALSE,1,TRUE,18778,17859,4882,20.4
FALSE,FALSE,0,FALSE,17911,17981,1014,21.8,TRUE,1,FALSE,16897,17293,-1014,19.1
TRUE,FALSE,0,FALSE,18582,18818,3039,21.7,TRUE,0,FALSE,15543,16563,-3039,20.3
TRUE,TRUE,2,TRUE,19099,17642,650,20.7,FALSE,0,FALSE,18449,17131,-650,20.4
TRUE,TRUE,1,FALSE,15879,17163,-905,18.7,FALSE,1,TRUE,16784,17872,905,18.3
TRUE,FALSE,0,FALSE,17354,18013,966,23.9,TRUE,1,TRUE,16388,17044,-966,20.8
FALSE,TRUE,1,FALSE,16760,16615,-429,18.6,FALSE,0,FALSE,17189,18436,429,24.2
TRUE,TRUE,2,TRUE,16839,17206,1211,20.9,FALSE,0,FALSE,15628,16851,-1211,19.1
FALSE,TRUE,1,TRUE,16186,18472,53,22.5,FALSE,0,FALSE,16133,18586,-53,20.5
FALSE,TRUE,1,TRUE,16915,17888,649,19.8,FALSE,0,FALSE,16266,17991,-649,19.7
FALSE,FALSE,0,FALSE,17951,16342,-135,20.7,TRUE,1,TRUE,18086,17630,135,19
TRUE,TRUE,1,TRUE,17722,18555,1137,22.4,FALSE,1,FALSE,16585,19164,-1137,22.5
TRUE,TRUE,1,TRUE,18381,19201,3951,24.9,FALSE,0,FALSE,14430,16711,-3951,21.4
FALSE,FALSE,0,FALSE,16084,17317,-859,21.9,TRUE,1,TRUE,16943,19431,859,24.4
FALSE,FALSE,0,FALSE,15054,18364,-962,23.9,TRUE,1,TRUE,16016,17752,962,23.3
TRUE,TRUE,0,FALSE,17838,17217,2554,19.4,FALSE,0,FALSE,15284,15764,-2554,21.5
FALSE,TRUE,0,FALSE,17415,18304,1158,23.9,FALSE,1,TRUE,16257,18922,-1158,18.4
FALSE,FALSE,1,TRUE,15025,17533,-2963,23.4,TRUE,1,FALSE,17988,19163,2963,25.2
FALSE,FALSE,0,FALSE,15362,15828,-1894,20.6,TRUE,1,FALSE,17256,18012,1894,19.6
FALSE,FALSE,0,FALSE,15038,17152,-1535,23,TRUE,1,TRUE,16573,17868,1535,21.5
TRUE,FALSE,0,FALSE,17726,18294,1654,21.8,TRUE,0,FALSE,16072,17197,-1654,21.9
FALSE,FALSE,2,TRUE,15685,18609,-516,23.2,TRUE,0,FALSE,16201,18343,516,20.8
TRUE,TRUE,1,FALSE,17530,19895,2577,22.1,FALSE,1,TRUE,14953,17303,-2577,19.6
FALSE,TRUE,0,FALSE,16260,17516,-402,20.5,FALSE,1,FALSE,16662,18036,402,21.9
FALSE,FALSE,0,FALSE,15668,16531,-4404,18.3,TRUE,1,TRUE,20072,19696,4404,25.6
FALSE,FALSE,1,FALSE,16511,18667,-2922,20.9,TRUE,0,FALSE,19433,20091,2922,21.2
TRUE,TRUE,1,TRUE,16965,17225,-659,20,FALSE,0,FALSE,17624,17926,659,22
FALSE,TRUE,0,FALSE,18212,18286,1924,20.1,FALSE,0,FALSE,16288,16348,-1924,21.2
FALSE,FALSE,0,FALSE,15042,17849,-2075,20.7,TRUE,2,TRUE,17117,18587,2075,23.6
FALSE,TRUE,0,FALSE,15661,17735,-1055,23.5,FALSE,0,FALSE,16716,18971,1055,22.2
TRUE,TRUE,1,FALSE,17986,18856,3239,21.8,FALSE,0,FALSE,14747,16362,-3239,19.8
FALSE,FALSE,1,FALSE,13776,16664,-2765,21.8,TRUE,1,TRUE,16541,19341,2765,25.6
FALSE,FALSE,0,FALSE,15330,15016,-1183,18.6,TRUE,1,TRUE,16513,16441,1183,19.9
FALSE,TRUE,0,FALSE,14727,17726,-1012,19.7,FALSE,1,TRUE,15739,19254,1012,23.8
TRUE,TRUE,1,TRUE,17651,18454,3245,22.9,FALSE,0,FALSE,14406,18147,-3245,17.9
FALSE,TRUE,0,FALSE,15496,16654,-157,18.4,FALSE,1,TRUE,15653,16923,157,22.9
TRUE,TRUE,1,TRUE,18395,19262,2862,24.2,FALSE,0,FALSE,15533,17400,-2862,20
TRUE,TRUE,1,TRUE,16866,17217,789,22,FALSE,0,FALSE,16077,18429,-789,22.4
FALSE,FALSE,0,FALSE,16449,18091,-986,21.1,TRUE,1,TRUE,17435,18575,986,23.8
TRUE,FALSE,1,TRUE,16142,18926,-812,21.8,TRUE,0,FALSE,16954,19128,812,23.3
FALSE,TRUE,0,FALSE,15099,17573,-3196,20.5,FALSE,1,TRUE,18295,20790,3196,22.6
TRUE,TRUE,1,TRUE,18044,18900,738,20.7,FALSE,0,FALSE,17306,17611,-738,18.8
TRUE,TRUE,0,FALSE,16248,18554,1144,25.1,FALSE,0,FALSE,15104,18090,-1144,19.9
TRUE,FALSE,1,TRUE,15182,17949,246,20.5,TRUE,1,FALSE,14936,17190,-246,23
FALSE,FALSE,0,FALSE,15651,17769,-919,19.5,TRUE,1,TRUE,16570,18252,919,20.3
TRUE,TRUE,2,TRUE,15917,18370,805,21.1,FALSE,0,FALSE,15112,17679,-805,18.7
FALSE,FALSE,0,FALSE,13889,16733,-1656,19.3,TRUE,1,TRUE,15545,17186,1656,22.9
FALSE,TRUE,0,FALSE,16858,18305,1153,24.1,FALSE,1,TRUE,15705,17375,-1153,21.1
TRUE,TRUE,0,FALSE,18119,16050,740,20.4,FALSE,1,TRUE,17379,16742,-740,21
FALSE,TRUE,0,FALSE,17352,17199,2841,20.7,FALSE,1,TRUE,14511,16341,-2841,19.8
FALSE,FALSE,0,FALSE,17924,16556,449,21.9,TRUE,0,FALSE,17475,16816,-449,18.2
FALSE,TRUE,0,FALSE,14490,17534,-1759,22.6,FALSE,1,TRUE,16249,19553,1759,24.7
FALSE,FALSE,0,FALSE,16172,18147,-1257,18.9,TRUE,1,TRUE,17429,17814,1257,22.6
FALSE,FALSE,0,FALSE,14555,17217,-1824,23.9,TRUE,1,FALSE,16379,17830,1824,20.4
FALSE,FALSE,0,FALSE,15355,17702,-843,19.7,TRUE,1,TRUE,16198,17555,843,22.3
FALSE,TRUE,1,TRUE,14395,16209,-2618,17.5,FALSE,0,FALSE,17013,17776,2618,21.3
FALSE,TRUE,1,TRUE,16630,18540,253,22.5,FALSE,0,FALSE,16377,18993,-253,21.3
FALSE,FALSE,0,FALSE,16984,18842,1229,22.5,TRUE,0,FALSE,15755,16929,-1229,21.4
FALSE,FALSE,1,TRUE,16675,17477,-938,20.5,TRUE,0,FALSE,17613,18657,938,19.9
FALSE,FALSE,0,FALSE,16258,18355,-487,20.7,TRUE,1,FALSE,16745,17591,487,20.7
FALSE,FALSE,0,FALSE,15571,18029,-1431,21.2,TRUE,1,TRUE,17002,18677,1431,24.1
TRUE,TRUE,1,TRUE,19740,19505,4498,22.8,FALSE,0,FALSE,15242,15418,-4498,18.3
TRUE,FALSE,1,TRUE,13749,16076,-3574,20.8,TRUE,0,FALSE,17323,19247,3574,22.2
TRUE,TRUE,2,TRUE,16231,18511,693,27.1,FALSE,0,FALSE,15538,18715,-693,24.5
TRUE,FALSE,0,FALSE,15736,17285,-915,18.8,TRUE,1,TRUE,16651,17282,915,19.9
FALSE,FALSE,0,FALSE,17099,19019,1847,22.2,TRUE,2,TRUE,15252,17356,-1847,21
TRUE,TRUE,0,FALSE,17620,17878,2978,23.6,FALSE,0,FALSE,14642,18316,-2978,18
TRUE,FALSE,0,FALSE,16250,17489,1245,23.1,TRUE,0,FALSE,15005,16405,-1245,21.6
FALSE,FALSE,1,TRUE,17136,17495,-1632,20.7,TRUE,1,FALSE,18768,16933,1632,17.3
TRUE,TRUE,1,TRUE,22228,18219,8657,23.4,FALSE,0,FALSE,13571,10610,-8657,10.7
TRUE,TRUE,0,FALSE,18847,19097,2197,21.8,FALSE,1,TRUE,16650,18864,-2197,23.6
FALSE,FALSE,0,FALSE,13462,12212,-9152,13,TRUE,0,FALSE,22614,20502,9152,24.7
FALSE,FALSE,0,FALSE,16364,18941,687,23.9,TRUE,1,TRUE,15677,19232,-687,23.2
TRUE,FALSE,0,FALSE,17279,17886,220,23.3,TRUE,1,TRUE,17059,18626,-220,21.1
TRUE,TRUE,0,FALSE,14654,16892,-96,22.5,FALSE,0,FALSE,14750,17955,96,24
FALSE,FALSE,0,FALSE,15211,16421,-3746,18.7,TRUE,1,TRUE,18957,19435,3746,23
TRUE,TRUE,1,TRUE,17076,19064,629,22.3,FALSE,0,FALSE,16447,17568,-629,21.5
TRUE,FALSE,1,FALSE,14536,17837,-1476,21.4,TRUE,1,TRUE,16012,18183,1476,25.3
FALSE,FALSE,1,TRUE,17308,17903,-575,19.8,TRUE,0,FALSE,17883,19583,575,22.7
FALSE,TRUE,1,FALSE,16203,17228,-635,20.5,FALSE,1,TRUE,16838,18753,635,20.6
TRUE,TRUE,1,TRUE,16130,17004,149,23.5,FALSE,0,FALSE,15981,16557,-149,24.1
FALSE,TRUE,1,FALSE,15739,16738,657,22.3,FALSE,1,TRUE,15082,17879,-657,19.9
FALSE,FALSE,0,FALSE,17498,18569,-958,22.8,TRUE,1,TRUE,18456,18305,958,20
TRUE,FALSE,0,FALSE,14947,16859,-2922,16.5,TRUE,1,TRUE,17869,19024,2922,23.9
FALSE,FALSE,0,FALSE,14893,16350,-3410,21.7,TRUE,1,TRUE,18303,19484,3410,24
TRUE,FALSE,1,FALSE,18817,17845,311,19.2,TRUE,0,FALSE,18506,17286,-311,22.8
TRUE,TRUE,1,FALSE,17704,18715,1792,19.7,FALSE,1,TRUE,15912,17342,-1792,20.5
FALSE,FALSE,1,FALSE,15717,16927,-856,24.1,TRUE,1,TRUE,16573,19196,856,24.5
TRUE,TRUE,1,TRUE,17252,18227,1154,21.2,FALSE,0,FALSE,16098,17228,-1154,22
FALSE,FALSE,0,FALSE,14794,17179,-2124,18.5,TRUE,1,TRUE,16918,18288,2124,21.7
FALSE,FALSE,0,FALSE,14751,17562,-982,21.7,TRUE,1,TRUE,15733,17526,982,21
TRUE,TRUE,1,TRUE,15430,18761,467,24.6,FALSE,0,FALSE,14963,19059,-467,23.6
FALSE,FALSE,0,FALSE,14266,17850,-3389,22.2,TRUE,2,TRUE,17655,19705,3389,23.1
FALSE,TRUE,2,TRUE,16168,17184,-1003,20.4,FALSE,0,FALSE,17171,17675,1003,22
TRUE,TRUE,1,TRUE,17303,18417,572,22.4,FALSE,0,FALSE,16731,18000,-572,20.5
FALSE,FALSE,1,TRUE,16111,17170,-1556,20.4,TRUE,0,FALSE,17667,18978,1556,24.1
TRUE,FALSE,0,FALSE,18029,18791,2323,19.9,TRUE,0,FALSE,15706,17092,-2323,19.2
FALSE,TRUE,0,FALSE,16695,18868,1486,22.2,FALSE,1,TRUE,15209,17263,-1486,22.9
TRUE,TRUE,1,FALSE,17755,19720,3755,22.8,FALSE,0,FALSE,14000,17058,-3755,18.3
FALSE,FALSE,1,TRUE,17388,16792,1327,21.4,TRUE,0,FALSE,16061,17533,-1327,19
TRUE,TRUE,2,TRUE,16874,19010,2929,26,FALSE,0,FALSE,13945,16503,-2929,23.9
FALSE,TRUE,0,FALSE,15591,17801,536,23.9,FALSE,1,FALSE,15055,17819,-536,23.4
TRUE,TRUE,1,TRUE,17562,17702,3575,23.7,FALSE,1,FALSE,13987,16308,-3575,17.6
TRUE,TRUE,1,TRUE,19628,18889,4801,22.9,FALSE,0,FALSE,14827,16762,-4801,19.8
FALSE,FALSE,0,FALSE,15871,16751,-2201,20.2,TRUE,1,TRUE,18072,19095,2201,22.1
FALSE,TRUE,0,FALSE,17792,18238,2785,22.2,FALSE,1,TRUE,15007,16567,-2785,20.4
FALSE,TRUE,1,FALSE,16168,16435,-692,19.3,FALSE,0,FALSE,16860,17171,692,20.7
TRUE,FALSE,1,TRUE,15786,17495,-4406,21.7,TRUE,0,FALSE,20192,19999,4406,23.3
TRUE,FALSE,2,TRUE,17889,19337,1792,23.5,TRUE,0,FALSE,16097,18037,-1792,18
FALSE,FALSE,1,FALSE,13612,15504,-6717,18.1,TRUE,1,TRUE,20329,20271,6717,22.6
FALSE,TRUE,0,FALSE,16218,16863,-193,20.4,FALSE,2,TRUE,16411,17497,193,20.2
TRUE,FALSE,0,FALSE,18188,20313,1667,25.2,TRUE,1,TRUE,16521,16879,-1667,18.8
FALSE,TRUE,1,TRUE,15786,16737,-1860,21.9,FALSE,1,FALSE,17646,18931,1860,23.1
FALSE,TRUE,1,TRUE,14419,16385,-3324,23.5,FALSE,0,FALSE,17743,19524,3324,24.6
FALSE,TRUE,0,FALSE,16575,17151,-1655,19.4,FALSE,1,TRUE,18230,18895,1655,20.8
FALSE,FALSE,0,FALSE,15068,17487,-321,20.3,TRUE,2,TRUE,15389,17215,321,21.1
TRUE,TRUE,1,TRUE,19225,20071,4947,25.3,FALSE,1,FALSE,14278,18020,-4947,20
TRUE,TRUE,0,FALSE,18688,18613,3424,21.8,FALSE,0,FALSE,15264,15460,-3424,17
TRUE,TRUE,1,TRUE,18650,18563,3028,23.6,FALSE,0,FALSE,15622,16745,-3028,21.6
FALSE,TRUE,2,TRUE,15207,18559,-211,23.4,FALSE,0,FALSE,15418,17716,211,21.1
TRUE,TRUE,1,TRUE,17522,18787,2123,20.4,FALSE,0,FALSE,15399,17175,-2123,19.4
FALSE,FALSE,0,FALSE,18131,17297,1025,19.3,TRUE,1,TRUE,17106,16858,-1025,21.3
TRUE,FALSE,1,FALSE,18209,18851,2343,20.9,TRUE,1,TRUE,15866,15973,-2343,17
FALSE,FALSE,0,FALSE,16162,18589,-565,23,TRUE,0,FALSE,16727,17851,565,23.4
TRUE,TRUE,0,FALSE,16805,18285,-1785,22.9,FALSE,2,TRUE,18590,19416,1785,24.8
TRUE,FALSE,1,FALSE,15742,18244,-873,22,TRUE,0,FALSE,16615,20036,873,21.5
TRUE,TRUE,0,FALSE,18649,19509,1641,20.7,FALSE,0,FALSE,17008,18123,-1641,19.9
TRUE,FALSE,1,FALSE,16643,15836,-1111,20.2,TRUE,1,TRUE,17754,17021,1111,18.8
TRUE,FALSE,0,FALSE,16500,17896,-2390,23.8,TRUE,1,TRUE,18890,19692,2390,24
FALSE,TRUE,1,TRUE,16972,18412,1807,22.1,FALSE,1,FALSE,15165,17679,-1807,21.1
FALSE,TRUE,0,FALSE,14496,16377,-5003,21.5,FALSE,1,TRUE,19499,21059,5003,20.8
TRUE,TRUE,1,TRUE,16790,19460,651,24.1,FALSE,0,FALSE,16139,17716,-651,18.6
TRUE,FALSE,1,TRUE,15704,18700,928,24,TRUE,0,FALSE,14776,17745,-928,23.2
TRUE,TRUE,1,TRUE,18285,20035,4649,25.9,FALSE,0,FALSE,13636,16547,-4649,21.5
FALSE,FALSE,0,FALSE,14414,16744,-4743,17.3,TRUE,2,TRUE,19157,19394,4743,24.5
TRUE,TRUE,0,FALSE,16981,20082,1775,26.9,FALSE,2,TRUE,15206,18430,-1775,25.6
TRUE,TRUE,1,TRUE,18516,19255,2019,24,FALSE,0,FALSE,16497,18581,-2019,21.4
TRUE,FALSE,1,TRUE,15594,20342,1402,24.1,TRUE,0,FALSE,14192,17938,-1402,21.5
TRUE,TRUE,0,FALSE,17259,18116,240,21.4,FALSE,1,TRUE,17019,17717,-240,22.3
TRUE,TRUE,0,FALSE,17741,17857,2281,20.8,FALSE,1,TRUE,15460,17311,-2281,18.3
TRUE,TRUE,2,TRUE,17867,19316,764,22.6,FALSE,0,FALSE,17103,16826,-764,17.8
TRUE,TRUE,0,FALSE,21462,18193,7579,20.8,FALSE,0,FALSE,13883,13527,-7579,13.9
TRUE,FALSE,0,FALSE,15548,17592,-112,22.1,TRUE,2,TRUE,15660,17194,112,23.2
TRUE,FALSE,1,TRUE,17405,19297,1198,22.9,TRUE,0,FALSE,16207,19100,-1198,23.7
TRUE,FALSE,2,TRUE,17112,18205,2199,20.4,TRUE,0,FALSE,14913,16914,-2199,19.7
TRUE,TRUE,0,FALSE,17917,17609,2992,23.9,FALSE,0,FALSE,14925,17351,-2992,20.5
FALSE,TRUE,0,FALSE,15465,14469,-4292,16.9,FALSE,0,FALSE,19757,18602,4292,23
FALSE,TRUE,0,FALSE,16020,17044,-1407,24,FALSE,1,TRUE,17427,18349,1407,22.6
TRUE,TRUE,0,FALSE,16708,18529,1860,23,FALSE,0,FALSE,14848,17029,-1860,22.6
FALSE,FALSE,0,FALSE,14384,16893,-1554,20.6,TRUE,1,TRUE,15938,17597,1554,19.7
FALSE,FALSE,0,FALSE,18420,19093,-1004,22.5,TRUE,0,FALSE,19424,19608,1004,20.5
FALSE,TRUE,0,FALSE,14804,17782,258,22.3,FALSE,1,TRUE,14546,18080,-258,20
TRUE,TRUE,0,FALSE,16279,18977,190,23.4,FALSE,2,TRUE,16089,19034,-190,21.8
TRUE,TRUE,1,TRUE,21711,19183,7413,24.7,FALSE,0,FALSE,14298,14288,-7413,13.6
FALSE,TRUE,1,FALSE,17124,16900,1315,20.7,FALSE,0,FALSE,15809,16837,-1315,20.9
FALSE,TRUE,0,FALSE,15895,18881,688,22.9,FALSE,0,FALSE,15207,18009,-688,23.1
FALSE,TRUE,1,FALSE,15960,17046,664,18,FALSE,1,TRUE,15296,16861,-664,20.5
TRUE,TRUE,1,TRUE,17678,18832,1754,18.9,FALSE,0,FALSE,15924,18399,-1754,20.7
TRUE,TRUE,0,FALSE,18193,16895,1083,18.2,FALSE,1,TRUE,17110,16341,-1083,22.5
FALSE,FALSE,1,TRUE,14643,17019,-4728,23,TRUE,0,FALSE,19371,20687,4728,23.6
TRUE,TRUE,1,TRUE,16840,18289,1015,18.5,FALSE,1,FALSE,15825,16746,-1015,19.5
TRUE,FALSE,1,TRUE,14707,18199,-410,20.9,TRUE,0,FALSE,15117,18393,410,20.1
TRUE,TRUE,1,TRUE,14467,16468,-1663,22.2,FALSE,0,FALSE,16130,17642,1663,18.6
TRUE,TRUE,0,FALSE,17633,17885,3373,22.6,FALSE,0,FALSE,14260,15651,-3373,20.5
FALSE,TRUE,0,FALSE,14837,15974,-1044,20,FALSE,1,TRUE,15881,18734,1044,18.3
FALSE,FALSE,0,FALSE,15826,17438,-2803,23.5,TRUE,1,TRUE,18629,19147,2803,23.8
TRUE,TRUE,2,TRUE,18357,19718,3346,26.9,FALSE,0,FALSE,15011,16011,-3346,17.6
FALSE,TRUE,1,FALSE,16460,18260,1561,24.1,FALSE,1,TRUE,14899,18347,-1561,19.7
FALSE,TRUE,0,FALSE,16054,16044,-3304,17.6,FALSE,1,TRUE,19358,19245,3304,17
FALSE,FALSE,0,FALSE,13899,16444,-3238,20.2,TRUE,1,TRUE,17137,18909,3238,26.1
TRUE,FALSE,2,TRUE,15911,18170,-357,23.1,TRUE,0,FALSE,16268,17949,357,22.4
TRUE,TRUE,0,FALSE,15215,18360,-714,23.1,FALSE,1,TRUE,15929,18127,714,20.8
TRUE,TRUE,1,FALSE,18036,18597,2806,23.6,FALSE,1,TRUE,15230,17206,-2806,23.2
FALSE,TRUE,0,FALSE,16304,17328,205,21.2,FALSE,2,TRUE,16099,18634,-205,20.3
FALSE,FALSE,0,FALSE,15267,17987,-392,22.6,TRUE,1,TRUE,15659,18982,392,25.4
FALSE,TRUE,0,FALSE,16055,17241,-1176,25.2,FALSE,1,TRUE,17231,18697,1176,22.5
TRUE,FALSE,0,FALSE,17404,18717,-882,20.4,TRUE,1,TRUE,18286,19457,882,25.3
FALSE,FALSE,1,FALSE,13741,15605,-2955,17.9,TRUE,1,TRUE,16696,18381,2955,22
TRUE,FALSE,0,FALSE,16402,17710,194,22.3,TRUE,0,FALSE,16208,17930,-194,19.5
FALSE,FALSE,0,FALSE,14933,16470,-3251,22.5,TRUE,0,FALSE,18184,19678,3251,24.1
FALSE,FALSE,1,FALSE,14665,17020,-1761,19.2,TRUE,1,TRUE,16426,18226,1761,21.3
TRUE,TRUE,1,FALSE,19372,18802,1342,18,FALSE,0,FALSE,18030,18789,-1342,22.9
FALSE,TRUE,0,FALSE,16310,18578,690,23.5,FALSE,1,TRUE,15620,17580,-690,23
FALSE,FALSE,0,FALSE,14643,17028,-4073,15.4,TRUE,1,TRUE,18716,20066,4073,20.7
TRUE,TRUE,1,TRUE,16426,19543,2296,25.1,FALSE,0,FALSE,14130,17510,-2296,23.6
FALSE,FALSE,0,FALSE,16331,18513,-1081,22.9,TRUE,1,TRUE,17412,19466,1081,23.5
TRUE,FALSE,0,FALSE,15895,16900,-1664,22.2,TRUE,1,TRUE,17559,17502,1664,21.8
TRUE,TRUE,1,TRUE,18176,18682,2287,21.6,FALSE,0,FALSE,15889,18306,-2287,20.2
TRUE,TRUE,1,TRUE,17566,19634,2821,24.3,FALSE,0,FALSE,14745,16879,-2821,23.4
FALSE,FALSE,0,FALSE,13832,16157,-6240,20.3,TRUE,2,TRUE,20072,20472,6240,23.3
TRUE,TRUE,1,TRUE,17751,19165,1570,23.8,FALSE,0,FALSE,16181,18522,-1570,22.6
FALSE,FALSE,1,TRUE,15382,18298,39,23.9,TRUE,0,FALSE,15343,18060,-39,22.5
TRUE,TRUE,0,FALSE,17326,19014,1132,22.6,FALSE,1,TRUE,16194,18745,-1132,20.3
FALSE,TRUE,0,FALSE,16756,16405,-1429,19.2,FALSE,1,FALSE,18185,17926,1429,20.9
TRUE,TRUE,1,TRUE,16289,17304,-1764,22.3,FALSE,0,FALSE,18053,19301,1764,24.4
TRUE,TRUE,0,FALSE,16581,17538,-172,19.7,FALSE,1,TRUE,16753,17559,172,19.6
TRUE,FALSE,0,FALSE,16555,18712,201,20.4,TRUE,1,TRUE,16354,18409,-201,21
FALSE,TRUE,0,FALSE,15700,17393,-2185,25,FALSE,0,FALSE,17885,19837,2185,21.6
FALSE,FALSE,0,FALSE,13494,14660,-5020,21.3,TRUE,1,TRUE,18514,19452,5020,24.6
FALSE,TRUE,1,FALSE,13876,15218,-5694,18.3,FALSE,0,FALSE,19570,18675,5694,20.4
FALSE,TRUE,0,FALSE,16668,17267,-2781,19.3,FALSE,1,FALSE,19449,18371,2781,20.5
TRUE,FALSE,1,FALSE,16009,19116,565,20.6,TRUE,0,FALSE,15444,17043,-565,21.8
TRUE,FALSE,1,TRUE,16321,18950,508,25,TRUE,0,FALSE,15813,19133,-508,22.5
TRUE,TRUE,0,FALSE,16755,16362,2154,17.9,FALSE,0,FALSE,14601,14294,-2154,19.9
TRUE,TRUE,0,FALSE,16407,18954,1063,18.9,FALSE,0,FALSE,15344,17453,-1063,20.5
FALSE,TRUE,0,FALSE,15061,16082,-1805,20.3,FALSE,1,TRUE,16866,18385,1805,20.1
FALSE,FALSE,0,FALSE,16552,17597,-1026,21.5,TRUE,1,TRUE,17578,18579,1026,23.4
FALSE,FALSE,0,FALSE,16538,19266,1664,23.8,TRUE,1,TRUE,14874,17575,-1664,19
FALSE,FALSE,0,FALSE,15958,16741,-84,23.3,TRUE,0,FALSE,16042,16763,84,19
FALSE,TRUE,1,FALSE,16851,18450,936,22.1,FALSE,1,TRUE,15915,18064,-936,25.3
TRUE,FALSE,1,TRUE,16753,18695,2631,20.1,TRUE,1,FALSE,14122,16346,-2631,20.7
FALSE,TRUE,1,TRUE,14607,16424,-1183,22.2,FALSE,0,FALSE,15790,18915,1183,22.8
FALSE,FALSE,1,TRUE,17160,19481,-312,24.5,TRUE,0,FALSE,17472,19444,312,23.1
FALSE,FALSE,1,FALSE,16360,16891,-833,18.7,TRUE,1,TRUE,17193,17664,833,19.7
FALSE,FALSE,1,FALSE,15288,17567,-1308,19.2,TRUE,1,TRUE,16596,18131,1308,22.3
TRUE,FALSE,0,FALSE,18415,20355,2862,22.1,TRUE,0,FALSE,15553,17105,-2862,22.3
TRUE,FALSE,0,FALSE,15190,18530,-1449,23.1,TRUE,2,TRUE,16639,18217,1449,26.4
TRUE,TRUE,0,FALSE,17188,19483,2010,24.4,FALSE,0,FALSE,15178,18118,-2010,22.6
TRUE,TRUE,0,FALSE,16900,18173,-52,17,FALSE,1,TRUE,16952,17915,52,22.2
FALSE,TRUE,0,FALSE,16208,16287,-315,19,FALSE,1,TRUE,16523,18161,315,24.2
TRUE,FALSE,0,FALSE,15477,17532,-1579,22.3,TRUE,1,FALSE,17056,18187,1579,19.2
FALSE,FALSE,0,FALSE,15574,17489,-616,21.9,TRUE,1,TRUE,16190,18838,616,23.2
FALSE,FALSE,1,TRUE,15377,18315,-1262,21.5,TRUE,0,FALSE,16639,17701,1262,22.5
FALSE,FALSE,0,FALSE,13649,14620,-2564,18.9,TRUE,0,FALSE,16213,17540,2564,21.3
FALSE,TRUE,1,TRUE,19239,19698,2587,20.9,FALSE,0,FALSE,16652,17939,-2587,19.5
TRUE,TRUE,1,TRUE,20186,19725,5491,21.6,FALSE,0,FALSE,14695,14390,-5491,15.9
TRUE,FALSE,1,TRUE,19034,19369,4051,24,TRUE,0,FALSE,14983,15817,-4051,17.8
TRUE,TRUE,0,FALSE,20183,20925,5712,23.9,FALSE,0,FALSE,14471,16344,-5712,20.8
FALSE,FALSE,1,TRUE,15877,17848,-1232,23.4,TRUE,0,FALSE,17109,18507,1232,22.1
FALSE,FALSE,0,FALSE,16823,17411,-1071,21.9,TRUE,1,TRUE,17894,19078,1071,21
TRUE,FALSE,1,TRUE,16525,18498,1262,23,TRUE,0,FALSE,15263,18085,-1262,21.2
TRUE,FALSE,1,TRUE,15103,18559,-1761,24.6,TRUE,1,FALSE,16864,19440,1761,26.8
TRUE,FALSE,0,FALSE,14899,18183,-420,22.8,TRUE,2,TRUE,15319,18045,420,23.4
TRUE,TRUE,0,FALSE,16602,17918,888,21.1,FALSE,0,FALSE,15714,16913,-888,22.7
FALSE,FALSE,0,FALSE,14504,16897,-3926,19.1,TRUE,0,FALSE,18430,18284,3926,21.1
TRUE,FALSE,0,FALSE,17332,18045,1711,19.5,TRUE,0,FALSE,15621,16810,-1711,20.3
TRUE,TRUE,0,FALSE,16749,17223,-2320,22.6,FALSE,2,TRUE,19069,18427,2320,20.7
TRUE,FALSE,1,TRUE,16423,16900,-1900,20.4,TRUE,1,FALSE,18323,17952,1900,21.5
FALSE,TRUE,0,FALSE,15135,17280,-1634,24,FALSE,0,FALSE,16769,19196,1634,22
TRUE,TRUE,0,FALSE,16704,18000,1002,22.5,FALSE,2,TRUE,15702,18743,-1002,21.2
TRUE,FALSE,1,TRUE,17835,18791,1568,21.2,TRUE,0,FALSE,16267,17790,-1568,20.9
FALSE,FALSE,0,FALSE,15342,15988,-1758,22.1,TRUE,1,TRUE,17100,17998,1758,22.6
FALSE,FALSE,1,FALSE,16022,17899,-3063,20.6,TRUE,1,TRUE,19085,19575,3063,24
FALSE,FALSE,1,TRUE,15678,17592,-1859,18.1,TRUE,0,FALSE,17537,18932,1859,21.4
FALSE,FALSE,0,FALSE,16513,17530,-1696,19.7,TRUE,1,TRUE,18209,18717,1696,21.8
FALSE,FALSE,0,FALSE,16095,17497,-986,22.8,TRUE,0,FALSE,17081,18660,986,23.7
FALSE,TRUE,0,FALSE,15892,18043,822,21.6,FALSE,2,TRUE,15070,18018,-822,22.9
TRUE,TRUE,0,FALSE,16806,17623,-369,21.8,FALSE,1,TRUE,17175,18865,369,20
TRUE,FALSE,0,FALSE,16847,18705,1255,19.5,TRUE,0,FALSE,15592,15951,-1255,24.7
TRUE,FALSE,0,FALSE,16373,19296,317,24.7,TRUE,1,TRUE,16056,18657,-317,25.4
FALSE,FALSE,0,FALSE,13299,15911,-7285,18.9,TRUE,1,TRUE,20584,20290,7285,25.1
TRUE,TRUE,1,TRUE,18249,18327,1909,22.2,FALSE,0,FALSE,16340,18435,-1909,23.1
TRUE,FALSE,0,FALSE,16641,18364,1446,21.3,TRUE,1,TRUE,15195,17918,-1446,21.8
TRUE,TRUE,1,TRUE,16359,18199,917,21,FALSE,0,FALSE,15442,18289,-917,21.8
TRUE,TRUE,1,TRUE,16956,19127,1712,23.4,FALSE,1,FALSE,15244,17144,-1712,23.6
TRUE,TRUE,0,FALSE,16992,18716,1582,22.4,FALSE,1,TRUE,15410,17372,-1582,20.9
FALSE,FALSE,0,FALSE,16154,18081,-2129,21.6,TRUE,0,FALSE,18283,20336,2129,20.6
TRUE,TRUE,2,TRUE,19755,20163,5240,20.7,FALSE,0,FALSE,14515,14500,-5240,22
TRUE,TRUE,0,FALSE,16181,18426,873,26.1,FALSE,2,TRUE,15308,18478,-873,24.9
FALSE,TRUE,0,FALSE,15263,16941,-2548,20.3,FALSE,1,TRUE,17811,19847,2548,23.2
FALSE,TRUE,1,TRUE,18889,19825,3136,25.7,FALSE,0,FALSE,15753,17313,-3136,17.5
TRUE,TRUE,1,TRUE,19630,20181,5082,24.6,FALSE,0,FALSE,14548,17783,-5082,22.6
TRUE,FALSE,0,FALSE,16172,18087,-1867,21.9,TRUE,0,FALSE,18039,17532,1867,20.2
FALSE,TRUE,0,FALSE,17345,19182,179,22.6,FALSE,0,FALSE,17166,18229,-179,25.2
TRUE,FALSE,0,FALSE,17688,19492,1937,19.7,TRUE,0,FALSE,15751,16676,-1937,19.2
FALSE,TRUE,0,FALSE,14859,17412,-520,22.5,FALSE,1,TRUE,15379,18485,520,22.8
TRUE,TRUE,1,TRUE,18144,18210,1834,22.4,FALSE,0,FALSE,16310,17929,-1834,23.1
FALSE,FALSE,0,FALSE,16400,17409,492,22.2,TRUE,1,TRUE,15908,18918,-492,22
FALSE,TRUE,0,FALSE,14779,16944,-1024,21.4,FALSE,1,TRUE,15803,17515,1024,22.7
FALSE,TRUE,1,FALSE,16128,17286,822,22.6,FALSE,0,FALSE,15306,16923,-822,22.9
TRUE,TRUE,2,TRUE,21416,21031,7482,23.5,FALSE,0,FALSE,13934,14565,-7482,14.4
TRUE,FALSE,0,FALSE,14592,17915,-2168,21.7,TRUE,1,TRUE,16760,19271,2168,22.1
TRUE,TRUE,0,FALSE,17483,18392,1232,21.5,FALSE,0,FALSE,16251,18520,-1232,23.3
FALSE,FALSE,0,FALSE,16205,17509,-3102,23.4,TRUE,1,TRUE,19307,19534,3102,23.5
TRUE,FALSE,0,FALSE,18363,18592,321,22.4,TRUE,0,FALSE,18042,18224,-321,21.5
TRUE,TRUE,1,TRUE,18401,18207,506,23.7,FALSE,0,FALSE,17895,17587,-506,23.9
TRUE,FALSE,0,FALSE,16391,17693,709,22.2,TRUE,0,FALSE,15682,16747,-709,18.8
TRUE,FALSE,1,TRUE,16409,19634,1261,21.5,TRUE,0,FALSE,15148,17485,-1261,24.2
TRUE,TRUE,0,FALSE,16739,19178,1630,21.8,FALSE,0,FALSE,15109,18173,-1630,19.6
TRUE,TRUE,0,FALSE,15986,17620,-46,21.2,FALSE,1,TRUE,16032,18846,46,22.9
FALSE,FALSE,1,TRUE,14267,17033,-1190,18.6,TRUE,0,FALSE,15457,17795,1190,20.6
FALSE,TRUE,1,TRUE,14692,16959,-1488,22.6,FALSE,0,FALSE,16180,17531,1488,23.4
FALSE,TRUE,0,FALSE,17045,18787,848,24.5,FALSE,0,FALSE,16197,18658,-848,19.2
FALSE,FALSE,0,FALSE,13633,16221,-5800,20.2,TRUE,1,TRUE,19433,20181,5800,24.5
FALSE,FALSE,0,FALSE,18592,17780,981,21.3,TRUE,1,TRUE,17611,17738,-981,19.7
TRUE,FALSE,0,FALSE,15154,17363,-2642,17,TRUE,1,TRUE,17796,19271,2642,25.8
FALSE,TRUE,0,FALSE,16045,17984,-794,22.9,FALSE,0,FALSE,16839,19304,794,22.8
TRUE,FALSE,1,TRUE,17137,17147,-718,19.5,TRUE,0,FALSE,17855,18813,718,21.5
FALSE,FALSE,1,TRUE,14559,16634,-1833,20,TRUE,0,FALSE,16392,18805,1833,21.5
FALSE,FALSE,0,FALSE,14758,16974,-1369,23.7,TRUE,1,FALSE,16127,18782,1369,24.2
FALSE,TRUE,0,FALSE,18508,19340,2625,23.9,FALSE,1,FALSE,15883,18314,-2625,20.7
FALSE,FALSE,0,FALSE,15978,15862,-2818,19.2,TRUE,1,TRUE,18796,19572,2818,21.1
TRUE,TRUE,0,FALSE,17759,18407,2450,23.2,FALSE,1,TRUE,15309,18191,-2450,17.4
TRUE,TRUE,1,TRUE,18590,18032,3618,23.7,FALSE,0,FALSE,14972,16946,-3618,23.8
FALSE,TRUE,1,FALSE,16749,16518,-645,17.2,FALSE,1,TRUE,17394,19408,645,20.2
TRUE,TRUE,0,FALSE,17314,18785,3307,20.7,FALSE,2,TRUE,14007,17080,-3307,19.5
TRUE,FALSE,1,FALSE,18983,17893,2457,21.1,TRUE,1,TRUE,16526,17638,-2457,17.5
FALSE,TRUE,0,FALSE,16325,16171,-852,19.9,FALSE,1,TRUE,17177,19083,852,20.3
FALSE,FALSE,0,FALSE,14478,16879,-2153,20.5,TRUE,2,TRUE,16631,19260,2153,21.5
FALSE,FALSE,1,TRUE,14099,16884,-3938,20.1,TRUE,0,FALSE,18037,19651,3938,21.8
FALSE,FALSE,2,TRUE,16234,18544,-449,21.8,TRUE,0,FALSE,16683,18627,449,20.2
FALSE,FALSE,1,TRUE,17892,18922,273,20.5,TRUE,0,FALSE,17619,17494,-273,19.1
FALSE,FALSE,1,TRUE,16304,17968,0,23,TRUE,0,FALSE,16304,17123,0,23.4
TRUE,FALSE,1,FALSE,16688,17007,-1198,20.1,TRUE,1,TRUE,17886,17775,1198,20.9
TRUE,TRUE,2,TRUE,18894,17315,3536,20.1,FALSE,0,FALSE,15358,16071,-3536,18.7
FALSE,TRUE,0,FALSE,15761,16587,-1632,20,FALSE,0,FALSE,17393,18048,1632,21.2
FALSE,FALSE,0,FALSE,15028,17417,-3472,20.7,TRUE,1,TRUE,18500,19673,3472,23
TRUE,TRUE,1,TRUE,17239,19459,3497,23.2,FALSE,0,FALSE,13742,15916,-3497,22.3
FALSE,FALSE,0,FALSE,14181,17487,-2489,23.4,TRUE,0,FALSE,16670,18758,2489,25.3
FALSE,TRUE,0,FALSE,15557,16910,-4197,19,FALSE,1,TRUE,19754,19682,4197,22.8
FALSE,TRUE,1,TRUE,16067,16652,841,21.8,FALSE,0,FALSE,15226,18108,-841,24.6
FALSE,FALSE,1,TRUE,16386,17424,742,21.6,TRUE,0,FALSE,15644,18078,-742,25.5
FALSE,TRUE,0,FALSE,17997,20432,3087,21,FALSE,1,TRUE,14910,17889,-3087,22.5
FALSE,FALSE,0,FALSE,15961,16916,-2066,19.9,TRUE,1,TRUE,18027,16913,2066,20
FALSE,FALSE,0,FALSE,13395,16282,-3275,20.7,TRUE,0,FALSE,16670,19536,3275,25.7
FALSE,FALSE,1,FALSE,17048,18886,1337,24.9,TRUE,0,FALSE,15711,18001,-1337,19.9
TRUE,TRUE,1,TRUE,16924,17168,1258,19.4,FALSE,0,FALSE,15666,17292,-1258,22
FALSE,TRUE,1,TRUE,14902,17656,-1186,24.2,FALSE,0,FALSE,16088,18548,1186,21.5
FALSE,FALSE,0,FALSE,14341,16688,-5295,18.4,TRUE,1,TRUE,19636,20551,5295,26
FALSE,FALSE,0,FALSE,17984,18275,2086,22.9,TRUE,0,FALSE,15898,17073,-2086,18.9
FALSE,FALSE,0,FALSE,15893,17285,-3909,20.2,TRUE,1,FALSE,19802,19189,3909,22.8
TRUE,FALSE,1,TRUE,16138,16397,-732,20.8,TRUE,1,FALSE,16870,17210,732,21.8
FALSE,FALSE,2,TRUE,16260,17559,1481,22.4,TRUE,0,FALSE,14779,17031,-1481,19.5
FALSE,FALSE,2,TRUE,15931,17903,-1613,20.2,TRUE,0,FALSE,17544,18739,1613,21.7
TRUE,TRUE,2,TRUE,16693,16725,2123,18.7,FALSE,0,FALSE,14570,15506,-2123,17.2
TRUE,TRUE,2,TRUE,18200,19696,2756,24.7,FALSE,0,FALSE,15444,17668,-2756,20.8
FALSE,FALSE,0,FALSE,15771,16977,-1091,23.7,TRUE,0,FALSE,16862,18967,1091,22.6
TRUE,TRUE,1,TRUE,16682,17677,-970,19.7,FALSE,0,FALSE,17652,18159,970,22.7
TRUE,TRUE,0,FALSE,19074,17514,3941,19.1,FALSE,0,FALSE,15133,15314,-3941,19.9
TRUE,TRUE,1,TRUE,19052,19366,3754,22.6,FALSE,0,FALSE,15298,16724,-3754,21.5
TRUE,FALSE,0,FALSE,15220,16145,-3679,17.4,TRUE,0,FALSE,18899,19418,3679,26.6
TRUE,FALSE,1,TRUE,18604,20075,2998,21.4,TRUE,0,FALSE,15606,16967,-2998,20.3
TRUE,FALSE,1,TRUE,15131,17618,-735,22.3,TRUE,0,FALSE,15866,17572,735,22.1
FALSE,FALSE,0,FALSE,12789,15191,-6470,15.7,TRUE,1,TRUE,19259,20546,6470,25.6
FALSE,FALSE,1,TRUE,17586,18812,319,22.7,TRUE,0,FALSE,17267,17254,-319,23.2
TRUE,FALSE,0,FALSE,16072,16342,-1247,21.4,TRUE,1,TRUE,17319,17177,1247,22.9
TRUE,TRUE,1,FALSE,17473,18577,1179,22.8,FALSE,0,FALSE,16294,19313,-1179,22.5
FALSE,TRUE,0,FALSE,15693,17493,-1285,23,FALSE,2,TRUE,16978,19590,1285,23.6
TRUE,FALSE,0,FALSE,16079,18772,752,22.1,TRUE,1,TRUE,15327,17384,-752,22.3
TRUE,FALSE,0,FALSE,17109,18272,2006,24.7,TRUE,0,FALSE,15103,16016,-2006,20
TRUE,TRUE,0,FALSE,15890,16918,-902,17,FALSE,0,FALSE,16792,18000,902,22.7
TRUE,TRUE,2,TRUE,17410,18496,1590,23.9,FALSE,0,FALSE,15820,17525,-1590,21.6
TRUE,FALSE,1,TRUE,17491,19706,2599,21.6,TRUE,0,FALSE,14892,16385,-2599,18.9
TRUE,TRUE,1,FALSE,17887,19263,4590,22.1,FALSE,0,FALSE,13297,15582,-4590,21.3
FALSE,TRUE,1,TRUE,17030,19832,1207,25,FALSE,0,FALSE,15823,18194,-1207,23.4
FALSE,TRUE,1,TRUE,15762,19056,229,24,FALSE,0,FALSE,15533,18658,-229,23.9
FALSE,FALSE,1,TRUE,14444,16768,-1501,23.1,TRUE,0,FALSE,15945,17646,1501,21.5
TRUE,FALSE,0,FALSE,20294,17966,3903,21.6,TRUE,0,FALSE,16391,16727,-3903,17.1
TRUE,FALSE,0,FALSE,16592,19045,1709,22,TRUE,1,TRUE,14883,18165,-1709,20.3
FALSE,FALSE,1,TRUE,16291,17415,-699,21.1,TRUE,1,FALSE,16990,17995,699,21.8
FALSE,TRUE,0,FALSE,14639,16690,-2862,22.2,FALSE,1,TRUE,17501,19899,2862,23.7
TRUE,FALSE,0,FALSE,16447,19247,-1422,21.5,TRUE,1,TRUE,17869,18902,1422,24.4
TRUE,TRUE,1,TRUE,16147,17632,-666,20.1,FALSE,0,FALSE,16813,17922,666,21.7
TRUE,TRUE,0,FALSE,15751,18853,991,25.2,FALSE,0,FALSE,14760,17283,-991,22.2
FALSE,TRUE,0,FALSE,14742,16872,-2177,21.9,FALSE,2,TRUE,16919,19598,2177,19.7
TRUE,FALSE,1,TRUE,16618,17463,1354,19.2,TRUE,0,FALSE,15264,16137,-1354,20.3
FALSE,FALSE,0,FALSE,17492,19413,-1988,18.9,TRUE,2,TRUE,19480,20029,1988,20.4
TRUE,TRUE,1,TRUE,18208,19838,3199,21.9,FALSE,0,FALSE,15009,17209,-3199,20.9
TRUE,FALSE,1,TRUE,15584,17413,639,23,TRUE,1,FALSE,14945,17883,-639,21.5
TRUE,TRUE,2,TRUE,17094,17845,1509,20.2,FALSE,0,FALSE,15585,18388,-1509,22
FALSE,TRUE,1,TRUE,15307,15025,-660,17.5,FALSE,0,FALSE,15967,15947,660,17.1
FALSE,FALSE,0,FALSE,13880,15178,-3063,19.1,TRUE,1,TRUE,16943,17504,3063,18.7
TRUE,TRUE,0,FALSE,16059,18190,-1521,22.1,FALSE,1,TRUE,17580,20375,1521,24.6
FALSE,FALSE,1,TRUE,15471,18538,-814,22.8,TRUE,0,FALSE,16285,17339,814,22.5
TRUE,FALSE,1,TRUE,19198,17559,3024,19.9,TRUE,0,FALSE,16174,15334,-3024,17.6
TRUE,TRUE,1,TRUE,16576,17437,-1147,22.6,FALSE,0,FALSE,17723,18731,1147,21
TRUE,FALSE,1,FALSE,16076,18079,1113,23.8,TRUE,1,TRUE,14963,16687,-1113,18.5
TRUE,FALSE,0,FALSE,16041,18070,550,22.3,TRUE,1,TRUE,15491,17047,-550,21.4
FALSE,FALSE,1,TRUE,15714,17817,589,23,TRUE,1,FALSE,15125,17142,-589,19.9
FALSE,FALSE,1,FALSE,14608,15029,-7480,18.8,TRUE,1,TRUE,22088,19489,7480,21.8
FALSE,TRUE,0,FALSE,15001,17799,-685,21.8,FALSE,1,FALSE,15686,19670,685,21.4
FALSE,FALSE,0,FALSE,14459,14990,-2251,18.2,TRUE,1,TRUE,16710,17417,2251,19.8
FALSE,TRUE,1,FALSE,14783,16564,401,20.5,FALSE,1,TRUE,14382,16469,-401,20.9
FALSE,TRUE,0,FALSE,15211,18224,-834,23.4,FALSE,1,TRUE,16045,19557,834,21.7
FALSE,FALSE,0,FALSE,15589,16619,-1535,18.1,TRUE,1,FALSE,17124,18673,1535,21
FALSE,TRUE,1,TRUE,16223,17597,-2086,22.2,FALSE,0,FALSE,18309,19293,2086,22.8
TRUE,TRUE,1,TRUE,16375,18784,-270,21.7,FALSE,1,FALSE,16645,19879,270,20.9
TRUE,TRUE,1,TRUE,18190,20017,4069,22.5,FALSE,0,FALSE,14121,16063,-4069,22.4
FALSE,TRUE,1,FALSE,19120,19644,2171,24.8,FALSE,1,TRUE,16949,18269,-2171,21.7
FALSE,FALSE,1,FALSE,16532,18522,151,24.5,TRUE,1,TRUE,16381,17644,-151,21.5
FALSE,TRUE,1,FALSE,19224,20086,4674,22.5,FALSE,1,TRUE,14550,17867,-4674,18.9
FALSE,TRUE,0,FALSE,13993,16977,-961,21.3,FALSE,1,FALSE,14954,18057,961,23.5
TRUE,FALSE,0,FALSE,15235,17736,-1089,20.8,TRUE,1,TRUE,16324,17358,1089,20.8
TRUE,FALSE,0,FALSE,17839,18147,1278,15.8,TRUE,0,FALSE,16561,17331,-1278,20
TRUE,FALSE,0,FALSE,16932,19607,2545,24.3,TRUE,0,FALSE,14387,17685,-2545,24
TRUE,FALSE,1,TRUE,15990,16813,-1800,19.1,TRUE,0,FALSE,17790,17848,1800,21.7
FALSE,FALSE,1,TRUE,16501,15376,-383,19,TRUE,0,FALSE,16884,16043,383,22.9
TRUE,FALSE,1,TRUE,16193,19464,-420,22.5,TRUE,0,FALSE,16613,18249,420,20.7
FALSE,FALSE,0,FALSE,14696,14840,-1033,18.5,TRUE,0,FALSE,15729,16637,1033,21.7
FALSE,FALSE,1,TRUE,13980,16415,-1860,22.1,TRUE,0,FALSE,15840,18037,1860,21
FALSE,FALSE,0,FALSE,15132,17330,-1487,19.7,TRUE,0,FALSE,16619,17803,1487,23.5
FALSE,TRUE,1,FALSE,14927,16626,-3214,19.4,FALSE,1,TRUE,18141,18944,3214,23.9
FALSE,FALSE,0,FALSE,17394,18465,-14,21.3,TRUE,2,TRUE,17408,19241,14,21.5
FALSE,FALSE,0,FALSE,14961,18313,33,23,TRUE,1,TRUE,14928,17496,-33,19.1
FALSE,TRUE,1,TRUE,15256,16807,-1857,19.2,FALSE,0,FALSE,17113,19458,1857,20.9
FALSE,TRUE,1,FALSE,16235,18790,-1126,21.3,FALSE,1,TRUE,17361,19391,1126,23
FALSE,FALSE,0,FALSE,15536,15213,-4562,17.9,TRUE,2,TRUE,20098,18732,4562,22.6
TRUE,TRUE,1,TRUE,16805,18793,11,23,FALSE,0,FALSE,16794,18729,-11,22.3
FALSE,TRUE,0,FALSE,15684,17047,-2797,24,FALSE,1,TRUE,18481,19696,2797,22
FALSE,TRUE,0,FALSE,17207,17379,519,17.9,FALSE,0,FALSE,16688,18127,-519,18.8
TRUE,TRUE,0,FALSE,17106,17729,1192,20.6,FALSE,0,FALSE,15914,16950,-1192,21.7
TRUE,TRUE,1,TRUE,18002,19467,3761,25.4,FALSE,0,FALSE,14241,17375,-3761,24.8
FALSE,TRUE,0,FALSE,16725,18674,1279,22.8,FALSE,1,TRUE,15446,18290,-1279,25.1
FALSE,TRUE,0,FALSE,17045,17969,-883,21.4,FALSE,0,FALSE,17928,19464,883,25
FALSE,FALSE,1,TRUE,13902,16677,-4535,17.3,TRUE,0,FALSE,18437,19756,4535,24
TRUE,TRUE,1,TRUE,21986,20283,7242,26.3,FALSE,1,FALSE,14744,15288,-7242,16.8
FALSE,FALSE,0,FALSE,15673,18504,-546,23.4,TRUE,2,TRUE,16219,17744,546,23.7
FALSE,FALSE,0,FALSE,14958,15925,-4917,19.2,TRUE,0,FALSE,19875,20351,4917,24.1
TRUE,TRUE,0,FALSE,18408,19945,5041,24.3,FALSE,0,FALSE,13367,16312,-5041,20.2
TRUE,FALSE,1,TRUE,17247,19189,2152,24.9,TRUE,0,FALSE,15095,16614,-2152,17.8
TRUE,FALSE,1,TRUE,17590,18788,1783,20,TRUE,0,FALSE,15807,16722,-1783,18.3
TRUE,FALSE,1,FALSE,17657,19166,545,22.7,TRUE,1,TRUE,17112,18133,-545,19.8
FALSE,FALSE,0,FALSE,14094,15768,-5521,19.7,TRUE,1,TRUE,19615,19359,5521,25.8
TRUE,TRUE,0,FALSE,14629,17474,-1623,18.4,FALSE,2,TRUE,16252,18425,1623,24.3
FALSE,FALSE,0,FALSE,12791,16317,-4684,17.3,TRUE,1,TRUE,17475,19533,4684,23.9
FALSE,TRUE,0,FALSE,16879,19265,-29,20.3,FALSE,2,TRUE,16908,18251,29,24.9
TRUE,FALSE,0,FALSE,16005,17737,-1313,21.8,TRUE,0,FALSE,17318,19161,1313,23.9
TRUE,TRUE,0,FALSE,18876,18737,3210,21.8,FALSE,0,FALSE,15666,15146,-3210,18.4
TRUE,FALSE,0,FALSE,20319,18956,5774,21.6,TRUE,0,FALSE,14545,16087,-5774,21.8
FALSE,TRUE,2,TRUE,19975,20209,1843,21.3,FALSE,0,FALSE,18132,19691,-1843,18.3
FALSE,FALSE,0,FALSE,13761,16433,-1400,18.7,TRUE,1,TRUE,15161,18672,1400,24.7
TRUE,TRUE,1,TRUE,16940,18209,1995,23.8,FALSE,1,FALSE,14945,17864,-1995,19.3
FALSE,FALSE,0,FALSE,14585,16310,-1321,22.5,TRUE,2,TRUE,15906,16584,1321,18.5
FALSE,FALSE,1,FALSE,16806,17149,1904,21.7,TRUE,0,FALSE,14902,16257,-1904,20
FALSE,TRUE,1,TRUE,15371,16868,-612,22.4,FALSE,0,FALSE,15983,18168,612,19.4
TRUE,TRUE,0,FALSE,18086,17120,1030,19,FALSE,0,FALSE,17056,16415,-1030,17.4
FALSE,TRUE,0,FALSE,14246,16141,-5112,18.9,FALSE,1,TRUE,19358,18743,5112,20
FALSE,TRUE,0,FALSE,15220,16809,-2475,23.6,FALSE,0,FALSE,17695,19035,2475,24.7
TRUE,TRUE,1,TRUE,16448,19635,1619,24.5,FALSE,1,FALSE,14829,18165,-1619,20.9
TRUE,FALSE,0,FALSE,16947,18862,-538,18.4,TRUE,2,TRUE,17485,17185,538,19.8
TRUE,FALSE,1,TRUE,14516,17487,-1558,22.9,TRUE,0,FALSE,16074,18959,1558,25.5
FALSE,FALSE,1,FALSE,14933,16336,-2781,19,TRUE,1,TRUE,17714,19088,2781,20.4
TRUE,TRUE,0,FALSE,17795,18241,1642,22,FALSE,1,TRUE,16153,17363,-1642,21.6
TRUE,TRUE,1,FALSE,16137,17271,-80,21.9,FALSE,1,TRUE,16217,17426,80,20.5
FALSE,FALSE,1,TRUE,15390,17104,-1423,19.4,TRUE,0,FALSE,16813,18254,1423,21.8
FALSE,FALSE,0,FALSE,13998,16659,-4911,17.1,TRUE,1,TRUE,18909,19188,4911,23.6
FALSE,TRUE,1,FALSE,16203,16391,-2787,20.3,FALSE,1,TRUE,18990,17898,2787,20.9
TRUE,TRUE,1,TRUE,15081,17517,865,24,FALSE,0,FALSE,14216,18450,-865,25.2
TRUE,TRUE,0,FALSE,16161,17916,901,23,FALSE,1,TRUE,15260,19054,-901,24.6
FALSE,FALSE,1,FALSE,15664,17373,-2078,20.8,TRUE,1,TRUE,17742,17561,2078,21.4
FALSE,FALSE,0,FALSE,16896,17253,-1603,18.7,TRUE,1,TRUE,18499,19641,1603,25
TRUE,FALSE,1,TRUE,22296,21451,6535,25.1,TRUE,0,FALSE,15761,15719,-6535,17.7
FALSE,TRUE,1,FALSE,15285,15530,-2302,18.5,FALSE,1,TRUE,17587,17401,2302,16.5
FALSE,FALSE,0,FALSE,14584,16798,-2543,22,TRUE,1,TRUE,17127,18000,2543,25.8
FALSE,TRUE,0,FALSE,15206,17404,-1711,20.5,FALSE,1,TRUE,16917,18605,1711,21.7
FALSE,FALSE,0,FALSE,13745,16710,-3426,19.8,TRUE,1,TRUE,17171,17707,3426,21.2
TRUE,TRUE,0,FALSE,16210,19051,1169,26.1,FALSE,1,TRUE,15041,18487,-1169,23.2
TRUE,TRUE,1,TRUE,16498,18910,1857,23.3,FALSE,0,FALSE,14641,17525,-1857,20.4
TRUE,FALSE,0,FALSE,15778,17304,-1829,23.5,TRUE,1,TRUE,17607,18733,1829,24.4
FALSE,FALSE,0,FALSE,14347,15496,-3221,18.2,TRUE,1,TRUE,17568,18446,3221,19.2
TRUE,TRUE,0,FALSE,16663,17192,-1514,21.4,FALSE,1,TRUE,18177,18334,1514,21.7
FALSE,FALSE,0,FALSE,16580,20102,409,23.6,TRUE,0,FALSE,16171,18065,-409,21.1
TRUE,TRUE,1,TRUE,16036,17948,2083,20,FALSE,0,FALSE,13953,16666,-2083,22.1
FALSE,FALSE,0,FALSE,13298,16659,-3826,19.2,TRUE,1,TRUE,17124,19254,3826,25
TRUE,TRUE,0,FALSE,16959,19195,1788,19.9,FALSE,0,FALSE,15171,17273,-1788,18.7
TRUE,FALSE,0,FALSE,18173,18943,3036,21.8,TRUE,0,FALSE,15137,16994,-3036,20.3
TRUE,FALSE,2,TRUE,16122,19143,-221,23.6,TRUE,0,FALSE,16343,17869,221,22.5
TRUE,TRUE,1,FALSE,16582,18262,380,21.6,FALSE,1,TRUE,16202,18501,-380,24.6
FALSE,FALSE,0,FALSE,15126,16897,-4864,20.6,TRUE,0,FALSE,19990,19149,4864,21.7
TRUE,FALSE,1,FALSE,17666,19949,2405,21.8,TRUE,1,TRUE,15261,16698,-2405,20.4
TRUE,TRUE,0,FALSE,16172,15969,-1260,19.1,FALSE,1,TRUE,17432,18233,1260,20.7
TRUE,TRUE,0,FALSE,15609,16832,-2569,18.2,FALSE,0,FALSE,18178,19766,2569,21.2
FALSE,TRUE,1,TRUE,15897,17465,-503,21.6,FALSE,0,FALSE,16400,18361,503,22.5
TRUE,TRUE,0,FALSE,18810,19127,5189,26.1,FALSE,1,TRUE,13621,16605,-5189,19.4
FALSE,FALSE,1,FALSE,15759,17815,-183,24.5,TRUE,1,TRUE,15942,18594,183,23
TRUE,TRUE,0,FALSE,15411,17827,-43,21.5,FALSE,0,FALSE,15454,17979,43,22.4
TRUE,TRUE,1,TRUE,16526,18130,-2720,17.4,FALSE,0,FALSE,19246,20810,2720,23.9
FALSE,TRUE,1,FALSE,17781,19581,2359,22.5,FALSE,0,FALSE,15422,17753,-2359,21.5
TRUE,TRUE,1,TRUE,20028,18736,4887,21.3,FALSE,0,FALSE,15141,16636,-4887,20.7
TRUE,TRUE,1,TRUE,18725,19463,4073,24.8,FALSE,0,FALSE,14652,18066,-4073,22.5
FALSE,FALSE,0,FALSE,15365,18102,-1519,21.6,TRUE,0,FALSE,16884,19386,1519,24.5
FALSE,FALSE,0,FALSE,15727,17147,-4245,19.8,TRUE,0,FALSE,19972,20602,4245,22.7
FALSE,TRUE,0,FALSE,15541,18700,-376,23.6,FALSE,1,TRUE,15917,18771,376,22.6
FALSE,FALSE,0,FALSE,14183,17123,-4625,22.1,TRUE,1,TRUE,18808,18876,4625,24.8
TRUE,TRUE,1,TRUE,17135,19855,1247,21.6,FALSE,0,FALSE,15888,17501,-1247,19.6
TRUE,TRUE,0,FALSE,16637,18095,2712,25,FALSE,1,TRUE,13925,16934,-2712,21.5
TRUE,FALSE,1,FALSE,15536,16788,-1972,23.4,TRUE,1,TRUE,17508,17852,1972,22.3
FALSE,FALSE,0,FALSE,15755,16436,-4136,20.3,TRUE,1,TRUE,19891,19880,4136,22.2
FALSE,FALSE,1,FALSE,15795,18512,187,20.1,TRUE,0,FALSE,15608,17156,-187,20.4
FALSE,FALSE,1,TRUE,13590,15723,-3089,17,TRUE,0,FALSE,16679,17580,3089,21.5
FALSE,TRUE,1,FALSE,16260,18128,266,22.5,FALSE,1,TRUE,15994,18410,-266,22.4
FALSE,TRUE,0,FALSE,15859,16551,-947,20.9,FALSE,0,FALSE,16806,18594,947,21.8
TRUE,TRUE,1,FALSE,18137,18617,4177,20.7,FALSE,0,FALSE,13960,16002,-4177,20.5
TRUE,TRUE,1,TRUE,17451,17118,2470,21,FALSE,0,FALSE,14981,16060,-2470,21.9
TRUE,TRUE,0,FALSE,15679,16202,812,22.4,FALSE,0,FALSE,14867,15965,-812,22
FALSE,FALSE,1,FALSE,18502,19709,2010,21.2,TRUE,1,TRUE,16492,17597,-2010,19.4
TRUE,FALSE,1,TRUE,15120,16751,938,21.8,TRUE,0,FALSE,14182,14699,-938,17.8
FALSE,FALSE,1,FALSE,15539,16163,-1337,16.3,TRUE,0,FALSE,16876,17409,1337,19
FALSE,FALSE,1,TRUE,13879,16319,-2967,14.8,TRUE,0,FALSE,16846,19655,2967,22.3
FALSE,FALSE,0,FALSE,15640,17472,-1567,19.5,TRUE,1,TRUE,17207,17704,1567,21.6
TRUE,TRUE,0,FALSE,18738,18081,3660,24.6,FALSE,1,TRUE,15078,17504,-3660,19.6
FALSE,TRUE,0,FALSE,18509,18932,3602,27,FALSE,1,TRUE,14907,18658,-3602,21.7
TRUE,TRUE,0,FALSE,15441,18222,329,22.6,FALSE,2,TRUE,15112,17621,-329,20.3
TRUE,TRUE,0,FALSE,15887,16554,231,20.1,FALSE,0,FALSE,15656,17000,-231,21
TRUE,TRUE,1,FALSE,16242,17867,2156,21.8,FALSE,0,FALSE,14086,15766,-2156,21.2
FALSE,TRUE,1,FALSE,15714,17384,1378,21,FALSE,1,TRUE,14336,17528,-1378,25.9
FALSE,FALSE,0,FALSE,15087,17316,-523,25,TRUE,0,FALSE,15610,17540,523,20.3
FALSE,FALSE,1,FALSE,16680,17712,-72,19.6,TRUE,0,FALSE,16752,17830,72,22.3
TRUE,FALSE,0,FALSE,17639,16561,-887,19.4,TRUE,1,TRUE,18526,17062,887,19.8
TRUE,TRUE,0,FALSE,18000,18178,796,20.4,FALSE,0,FALSE,17204,17888,-796,18.7
FALSE,FALSE,0,FALSE,13443,15718,-3241,19.2,TRUE,2,TRUE,16684,18015,3241,21.7
FALSE,TRUE,0,FALSE,18121,19091,833,23,FALSE,2,TRUE,17288,19614,-833,21.7
TRUE,TRUE,1,TRUE,14765,16630,-2462,20,FALSE,0,FALSE,17227,17188,2462,20.5
TRUE,FALSE,2,TRUE,17474,18038,-2112,22.6,TRUE,0,FALSE,19586,18620,2112,22.3
TRUE,TRUE,2,TRUE,20176,18972,4634,21.8,FALSE,0,FALSE,15542,16618,-4634,21.7
TRUE,TRUE,0,FALSE,19574,20323,4279,23.7,FALSE,0,FALSE,15295,16915,-4279,23.4
FALSE,TRUE,0,FALSE,15866,16957,-635,22.2,FALSE,1,TRUE,16501,19256,635,21.5
TRUE,TRUE,0,FALSE,19313,21625,4185,23.7,FALSE,0,FALSE,15128,17767,-4185,18.2
FALSE,FALSE,0,FALSE,15125,17716,-1770,24.1,TRUE,0,FALSE,16895,18785,1770,25
FALSE,TRUE,0,FALSE,16485,18589,-750,22,FALSE,1,TRUE,17235,19495,750,24.2
FALSE,FALSE,1,FALSE,14815,18080,-931,23.3,TRUE,0,FALSE,15746,16696,931,20.9
TRUE,FALSE,0,FALSE,15176,17215,-676,22.7,TRUE,2,TRUE,15852,16856,676,22.5
FALSE,FALSE,1,FALSE,13589,16161,-5793,20.7,TRUE,1,TRUE,19382,20811,5793,25
TRUE,FALSE,0,FALSE,17012,17924,1595,22.6,TRUE,1,TRUE,15417,17987,-1595,23
TRUE,FALSE,1,TRUE,17126,17880,1936,24.8,TRUE,0,FALSE,15190,17432,-1936,23
FALSE,FALSE,0,FALSE,15102,17421,-2173,21.4,TRUE,1,TRUE,17275,19695,2173,21.2
TRUE,TRUE,1,TRUE,17338,18403,1554,21.4,FALSE,0,FALSE,15784,17676,-1554,23.9
TRUE,TRUE,1,FALSE,17402,19335,2067,24.6,FALSE,1,TRUE,15335,17237,-2067,23
FALSE,TRUE,1,TRUE,14514,17851,-1386,21.1,FALSE,0,FALSE,15900,18301,1386,24.2
TRUE,FALSE,1,TRUE,18442,18882,4401,25.6,TRUE,0,FALSE,14041,16474,-4401,19.3
FALSE,FALSE,0,FALSE,15231,18127,-13,26.2,TRUE,1,TRUE,15244,18505,13,23.2
FALSE,FALSE,0,FALSE,17328,20229,1336,24.5,TRUE,2,TRUE,15992,19058,-1336,22.4
FALSE,TRUE,0,FALSE,17767,18168,163,19.4,FALSE,0,FALSE,17604,18536,-163,21.1
FALSE,TRUE,0,FALSE,15389,17782,-1930,23.1,FALSE,2,TRUE,17319,19234,1930,27.6
FALSE,FALSE,0,FALSE,15298,17815,-960,22.3,TRUE,1,TRUE,16258,19389,960,24
FALSE,TRUE,0,FALSE,17659,18422,2021,22.5,FALSE,1,TRUE,15638,18696,-2021,19.6
TRUE,FALSE,0,FALSE,17201,19652,1820,23.9,TRUE,1,TRUE,15381,17759,-1820,21.9
FALSE,FALSE,0,FALSE,15656,17712,265,24,TRUE,2,TRUE,15391,17030,-265,20.1
FALSE,TRUE,0,FALSE,16889,17536,505,24,FALSE,1,TRUE,16384,17791,-505,23
TRUE,TRUE,1,TRUE,18520,18859,2413,20.4,FALSE,0,FALSE,16107,16678,-2413,20.6
FALSE,TRUE,0,FALSE,14564,16320,-1966,20.9,FALSE,1,TRUE,16530,18318,1966,22
FALSE,TRUE,2,TRUE,16635,18522,799,21.7,FALSE,0,FALSE,15836,18283,-799,24
FALSE,FALSE,1,TRUE,15230,17421,-2169,19.2,TRUE,0,FALSE,17399,19051,2169,21.8
TRUE,FALSE,1,TRUE,14906,17928,-2361,22.9,TRUE,1,FALSE,17267,19591,2361,23
TRUE,TRUE,2,TRUE,17706,17285,3588,22.1,FALSE,0,FALSE,14118,15996,-3588,19
TRUE,TRUE,1,TRUE,16238,18332,-348,23.4,FALSE,1,FALSE,16586,18343,348,23.6
FALSE,FALSE,1,TRUE,16221,18135,1457,24.1,TRUE,0,FALSE,14764,16196,-1457,20.5
TRUE,FALSE,1,TRUE,16564,17725,-850,22.2,TRUE,1,FALSE,17414,17981,850,20.1
FALSE,TRUE,0,FALSE,14712,15826,-4016,20.2,FALSE,1,TRUE,18728,19032,4016,25.3
TRUE,FALSE,0,FALSE,17042,20182,1264,18.9,TRUE,2,TRUE,15778,17377,-1264,22.5
TRUE,TRUE,0,FALSE,18104,19373,4142,20.1,FALSE,0,FALSE,13962,16439,-4142,17.6
FALSE,FALSE,0,FALSE,15128,18400,-279,21.5,TRUE,1,TRUE,15407,17823,279,24.4
TRUE,TRUE,1,TRUE,17773,18860,2521,26.2,FALSE,0,FALSE,15252,16620,-2521,19.7
TRUE,TRUE,1,TRUE,17263,19542,715,23.7,FALSE,0,FALSE,16548,19611,-715,23.1
TRUE,TRUE,1,TRUE,17325,19648,744,24.6,FALSE,1,FALSE,16581,17991,-744,21.6
TRUE,TRUE,0,FALSE,19195,19569,2818,20.5,FALSE,0,FALSE,16377,17894,-2818,20
TRUE,FALSE,1,FALSE,16246,19387,2679,25.3,TRUE,1,TRUE,13567,15702,-2679,16.9
TRUE,FALSE,1,TRUE,16570,18238,-1262,20.6,TRUE,0,FALSE,17832,19007,1262,23.1
TRUE,TRUE,1,TRUE,15790,18873,1074,21.6,FALSE,0,FALSE,14716,17869,-1074,21.1
FALSE,FALSE,0,FALSE,16598,17279,-1814,19.6,TRUE,1,TRUE,18412,18225,1814,23.1
TRUE,TRUE,1,FALSE,20018,20654,6489,22.6,FALSE,1,TRUE,13529,16442,-6489,17.2
TRUE,TRUE,1,TRUE,17797,19126,2094,22,FALSE,0,FALSE,15703,16338,-2094,20.3
TRUE,TRUE,0,FALSE,16160,17319,-106,20.6,FALSE,0,FALSE,16266,17381,106,22.9
FALSE,FALSE,0,FALSE,12926,14637,-7952,16.4,TRUE,2,TRUE,20878,20321,7952,25.4
TRUE,TRUE,1,TRUE,14922,18119,-1316,22.7,FALSE,0,FALSE,16238,19230,1316,24.7
TRUE,TRUE,0,FALSE,18702,18736,1713,23.4,FALSE,0,FALSE,16989,16945,-1713,17.9
FALSE,TRUE,2,TRUE,17111,17761,1318,23.1,FALSE,0,FALSE,15793,16997,-1318,22.6
TRUE,TRUE,1,FALSE,18762,18724,1378,20.2,FALSE,0,FALSE,17384,17537,-1378,21.2
FALSE,TRUE,0,FALSE,16386,18401,-610,20.7,FALSE,1,TRUE,16996,17887,610,21.1
TRUE,TRUE,0,FALSE,15887,17319,-560,17.1,FALSE,0,FALSE,16447,18762,560,20.9
FALSE,TRUE,0,FALSE,16363,18270,244,22.5,FALSE,2,TRUE,16119,18678,-244,19.7
TRUE,TRUE,0,FALSE,17356,18583,2028,20.6,FALSE,1,TRUE,15328,16739,-2028,22.7
TRUE,TRUE,0,FALSE,17677,17477,-44,18.4,FALSE,0,FALSE,17721,19722,44,22.4
TRUE,FALSE,2,TRUE,16101,18784,-2069,23,TRUE,0,FALSE,18170,19026,2069,23.9
TRUE,TRUE,0,FALSE,18257,18323,4340,20.9,FALSE,0,FALSE,13917,16482,-4340,19.4
FALSE,TRUE,1,TRUE,16801,19121,-209,19.8,FALSE,0,FALSE,17010,18704,209,22.9
FALSE,FALSE,0,FALSE,17352,17764,612,22,TRUE,1,TRUE,16740,17086,-612,22.3
FALSE,TRUE,0,FALSE,16594,16531,-712,21,FALSE,1,TRUE,17306,17068,712,17
FALSE,FALSE,0,FALSE,15796,17324,-2815,19.5,TRUE,1,TRUE,18611,19931,2815,24.3
FALSE,FALSE,0,FALSE,16372,18609,611,23.4,TRUE,1,TRUE,15761,17792,-611,22.2
TRUE,TRUE,2,TRUE,17088,19719,1358,22,FALSE,0,FALSE,15730,19078,-1358,21.1
FALSE,TRUE,0,FALSE,16086,17888,-756,19.9,FALSE,1,TRUE,16842,18719,756,23.5
TRUE,FALSE,1,FALSE,17323,18801,1248,24,TRUE,1,TRUE,16075,19044,-1248,22.2
TRUE,FALSE,0,FALSE,15205,17501,457,23.4,TRUE,1,TRUE,14748,16811,-457,25
TRUE,FALSE,0,FALSE,16009,17560,-1917,21.4,TRUE,1,TRUE,17926,16737,1917,19.8
TRUE,FALSE,1,FALSE,17531,19484,2351,24.1,TRUE,1,TRUE,15180,18167,-2351,22.3
TRUE,FALSE,1,TRUE,15310,18085,-354,22.8,TRUE,0,FALSE,15664,18093,354,23.9
FALSE,FALSE,0,FALSE,14882,17103,-5337,19.2,TRUE,2,TRUE,20219,19577,5337,24.9
FALSE,TRUE,1,FALSE,15628,16659,-2316,23.3,FALSE,0,FALSE,17944,18702,2316,24.3
FALSE,FALSE,0,FALSE,14208,14744,-4960,21.2,TRUE,2,TRUE,19168,18631,4960,23.5
TRUE,TRUE,2,TRUE,19629,21016,3865,23.2,FALSE,0,FALSE,15764,16984,-3865,22.5
TRUE,TRUE,1,TRUE,17782,19382,2506,22.5,FALSE,0,FALSE,15276,17589,-2506,22
FALSE,FALSE,0,FALSE,14790,18109,-1156,24,TRUE,1,TRUE,15946,17643,1156,24
FALSE,TRUE,1,FALSE,17381,18978,-119,21.8,FALSE,1,TRUE,17500,19744,119,23.5
FALSE,TRUE,0,FALSE,16450,17518,-577,21.2,FALSE,2,TRUE,17027,19471,577,23.9
FALSE,FALSE,0,FALSE,16456,17035,355,21.3,TRUE,2,TRUE,16101,17833,-355,22.3
FALSE,FALSE,0,FALSE,15201,16780,-2381,17.4,TRUE,1,TRUE,17582,17241,2381,20.8
TRUE,TRUE,2,TRUE,17523,18222,1928,24,FALSE,0,FALSE,15595,16417,-1928,20.9
FALSE,TRUE,0,FALSE,17072,17587,166,22.8,FALSE,2,TRUE,16906,18237,-166,22.3
FALSE,TRUE,0,FALSE,18878,18276,1212,22.2,FALSE,0,FALSE,17666,18533,-1212,21.2
FALSE,FALSE,0,FALSE,14782,16617,-1430,21.1,TRUE,2,TRUE,16212,19055,1430,23.6
FALSE,FALSE,1,TRUE,14017,16410,-4941,18.2,TRUE,0,FALSE,18958,19187,4941,22.7
FALSE,FALSE,0,FALSE,16670,17287,-508,22,TRUE,0,FALSE,17178,18672,508,21.7
FALSE,TRUE,0,FALSE,14681,17137,-2985,17.4,FALSE,1,TRUE,17666,20156,2985,21.3
TRUE,TRUE,0,FALSE,15268,15740,460,20.2,FALSE,1,TRUE,14808,16692,-460,20.9
FALSE,FALSE,0,FALSE,15748,17980,-326,20.3,TRUE,2,TRUE,16074,17147,326,20.4
TRUE,TRUE,1,TRUE,17284,18315,2670,23.8,FALSE,0,FALSE,14614,16726,-2670,20.8
FALSE,TRUE,0,FALSE,16806,17635,-210,20.5,FALSE,1,FALSE,17016,17765,210,23
TRUE,FALSE,0,FALSE,15334,17065,-2412,19.3,TRUE,0,FALSE,17746,19120,2412,24.3
FALSE,FALSE,0,FALSE,15333,18245,-3737,22,TRUE,2,TRUE,19070,19267,3737,26
TRUE,FALSE,0,FALSE,17491,19044,2026,25.1,TRUE,1,FALSE,15465,18584,-2026,18.9
TRUE,TRUE,1,TRUE,15698,18966,-544,21.4,FALSE,0,FALSE,16242,18295,544,23.8
TRUE,TRUE,2,TRUE,18223,18996,3399,23,FALSE,0,FALSE,14824,16634,-3399,20
TRUE,TRUE,2,TRUE,18360,19276,793,22.2,FALSE,0,FALSE,17567,18801,-793,21.5
TRUE,FALSE,1,FALSE,16178,19249,297,22.3,TRUE,0,FALSE,15881,17990,-297,22.5
TRUE,TRUE,1,TRUE,15048,17795,-394,22.3,FALSE,0,FALSE,15442,18969,394,25.3
TRUE,FALSE,0,FALSE,16865,17583,1897,21.1,TRUE,0,FALSE,14968,16569,-1897,18.2
FALSE,FALSE,0,FALSE,18072,18740,222,22.1,TRUE,1,TRUE,17850,17413,-222,20.2
FALSE,TRUE,0,FALSE,17500,18895,658,19.3,FALSE,0,FALSE,16842,18148,-658,19.3
FALSE,TRUE,0,FALSE,16688,17793,-214,21.3,FALSE,1,TRUE,16902,18127,214,20.1
FALSE,TRUE,0,FALSE,17384,18722,-898,22.7,FALSE,2,TRUE,18282,19661,898,22.5
FALSE,TRUE,1,FALSE,15126,18480,-3439,21.4,FALSE,1,TRUE,18565,19940,3439,25.1
TRUE,TRUE,0,FALSE,17214,18791,1892,24.1,FALSE,0,FALSE,15322,17530,-1892,21.4
FALSE,FALSE,0,FALSE,17389,17933,-1428,22.6,TRUE,1,TRUE,18817,18589,1428,23.7
FALSE,FALSE,0,FALSE,14564,17178,-1999,21.4,TRUE,1,TRUE,16563,17825,1999,23.8
FALSE,FALSE,0,FALSE,17670,19067,1191,25.3,TRUE,1,TRUE,16479,17791,-1191,16.6
TRUE,FALSE,0,FALSE,16296,18903,301,21.6,TRUE,1,TRUE,15995,18031,-301,22.9
FALSE,TRUE,0,FALSE,15738,16794,-1712,19.1,FALSE,1,TRUE,17450,19128,1712,22.2
FALSE,TRUE,0,FALSE,14118,17794,-2079,21.5,FALSE,0,FALSE,16197,18332,2079,24.4
FALSE,FALSE,0,FALSE,16343,16580,-1182,17.9,TRUE,1,FALSE,17525,17693,1182,20.4
FALSE,FALSE,0,FALSE,14579,15758,-4225,19.6,TRUE,0,FALSE,18804,18236,4225,23
TRUE,FALSE,0,FALSE,18485,18688,4318,23.2,TRUE,1,FALSE,14167,15867,-4318,19.7
FALSE,TRUE,0,FALSE,18982,18664,2741,23.4,FALSE,0,FALSE,16241,16249,-2741,20.5
TRUE,TRUE,1,TRUE,16688,17678,-405,22.3,FALSE,0,FALSE,17093,17241,405,20.5
TRUE,FALSE,1,TRUE,14836,18769,-425,26.1,TRUE,0,FALSE,15261,19085,425,25.5
FALSE,FALSE,0,FALSE,14573,17827,-2928,21.2,TRUE,2,TRUE,17501,19623,2928,23.9
FALSE,TRUE,0,FALSE,15704,16313,-3874,20.6,FALSE,1,TRUE,19578,18921,3874,23.8
FALSE,FALSE,1,FALSE,16578,18528,-597,20.6,TRUE,1,TRUE,17175,18253,597,24.2
FALSE,FALSE,0,FALSE,16045,17324,-215,20.8,TRUE,1,TRUE,16260,17489,215,21.6
FALSE,FALSE,0,FALSE,14076,16132,-3613,18.4,TRUE,2,TRUE,17689,18768,3613,23.4
TRUE,TRUE,2,TRUE,16518,19145,1630,20.8,FALSE,0,FALSE,14888,16815,-1630,21.8
FALSE,FALSE,0,FALSE,15373,16233,-2539,22.7,TRUE,1,TRUE,17912,17680,2539,17.4
FALSE,FALSE,0,FALSE,15519,18527,-1149,25.5,TRUE,0,FALSE,16668,18744,1149,23.8
TRUE,FALSE,1,FALSE,16795,19175,2011,20.3,TRUE,1,TRUE,14784,16179,-2011,20.2
FALSE,FALSE,1,FALSE,15941,17256,-1870,16.2,TRUE,1,TRUE,17811,18988,1870,24.5
TRUE,TRUE,1,TRUE,17676,20228,2296,23.3,FALSE,0,FALSE,15380,16766,-2296,21.2
TRUE,FALSE,1,TRUE,15056,18397,-278,22.5,TRUE,0,FALSE,15334,17826,278,20.8
TRUE,FALSE,0,FALSE,15282,17428,-1665,24.3,TRUE,2,TRUE,16947,19035,1665,24.8
FALSE,FALSE,0,FALSE,15189,18569,-1527,21.7,TRUE,1,TRUE,16716,19026,1527,22.4
TRUE,FALSE,0,FALSE,16285,17681,160,23,TRUE,0,FALSE,16125,18018,-160,20.4
TRUE,TRUE,1,TRUE,18382,19220,2498,22.4,FALSE,0,FALSE,15884,17733,-2498,21.7
TRUE,FALSE,1,TRUE,15746,17836,-1556,19.5,TRUE,0,FALSE,17302,17550,1556,23.7
FALSE,FALSE,0,FALSE,16141,19127,-3324,21.5,TRUE,1,TRUE,19465,20776,3324,23.6
TRUE,FALSE,1,FALSE,15558,17405,-209,22.1,TRUE,1,TRUE,15767,16605,209,18.5
TRUE,TRUE,0,FALSE,15486,18701,1386,25.1,FALSE,0,FALSE,14100,16871,-1386,23.4
TRUE,TRUE,0,FALSE,17335,17918,2094,19.3,FALSE,0,FALSE,15241,14981,-2094,17
FALSE,FALSE,0,FALSE,12598,14826,-7070,20.4,TRUE,0,FALSE,19668,19815,7070,22
TRUE,FALSE,2,TRUE,17385,18349,1133,21.6,TRUE,0,FALSE,16252,16516,-1133,17.8
TRUE,FALSE,1,TRUE,16452,17946,906,20.8,TRUE,0,FALSE,15546,16616,-906,18.5
TRUE,TRUE,0,FALSE,15996,15159,-2523,18.5,FALSE,1,FALSE,18519,18139,2523,23.1
TRUE,FALSE,0,FALSE,16370,16868,-129,23.1,TRUE,0,FALSE,16499,17594,129,18.2
FALSE,FALSE,1,FALSE,14264,18355,-1450,22,TRUE,1,TRUE,15714,18015,1450,25.9
TRUE,FALSE,1,TRUE,17061,20292,1217,24.9,TRUE,0,FALSE,15844,17358,-1217,21.8
FALSE,TRUE,1,TRUE,16738,16893,91,19.8,FALSE,0,FALSE,16647,18885,-91,22.4
TRUE,FALSE,0,FALSE,17999,19369,1128,22.7,TRUE,1,TRUE,16871,17649,-1128,21.2
FALSE,FALSE,0,FALSE,18496,17777,672,21.3,TRUE,1,TRUE,17824,19344,-672,21.6
TRUE,FALSE,0,FALSE,16414,17333,-33,20.5,TRUE,0,FALSE,16447,18010,33,22.3
FALSE,TRUE,0,FALSE,16563,17565,1149,22.6,FALSE,0,FALSE,15414,18095,-1149,20.5
TRUE,FALSE,1,TRUE,14314,17525,59,24.4,TRUE,0,FALSE,14255,17448,-59,22.4
TRUE,FALSE,0,FALSE,16556,18696,399,23.1,TRUE,2,TRUE,16157,18549,-399,23.9
FALSE,TRUE,1,TRUE,14604,16297,-4058,19,FALSE,1,FALSE,18662,19751,4058,25.7
FALSE,FALSE,0,FALSE,16195,18670,-339,24.1,TRUE,1,TRUE,16534,19538,339,25.9
FALSE,TRUE,1,TRUE,14668,16843,-3686,19.8,FALSE,1,FALSE,18354,19176,3686,23.2
TRUE,FALSE,0,FALSE,16557,17924,-2564,23.2,TRUE,1,TRUE,19121,17754,2564,21.9
TRUE,TRUE,1,TRUE,16863,17727,106,21.6,FALSE,0,FALSE,16757,18189,-106,18.4
TRUE,TRUE,2,TRUE,19694,19555,1910,21.5,FALSE,0,FALSE,17784,18419,-1910,21.2
TRUE,FALSE,1,TRUE,18523,19699,2400,22.9,TRUE,0,FALSE,16123,17099,-2400,19.1
TRUE,TRUE,1,TRUE,17618,18069,975,21.2,FALSE,0,FALSE,16643,16938,-975,19.6
FALSE,TRUE,0,FALSE,18751,20236,4671,24.9,FALSE,1,TRUE,14080,16043,-4671,17.7
FALSE,TRUE,1,TRUE,13932,15660,-5540,19.3,FALSE,0,FALSE,19472,19342,5540,24.5
FALSE,TRUE,1,TRUE,16394,17514,-2037,23.8,FALSE,1,FALSE,18431,19409,2037,22.9
TRUE,TRUE,1,TRUE,18276,17133,1281,20.2,FALSE,0,FALSE,16995,17138,-1281,21.4
TRUE,TRUE,1,TRUE,17722,18023,1672,21.5,FALSE,0,FALSE,16050,16682,-1672,20.5
FALSE,TRUE,2,TRUE,16517,19476,2123,24.6,FALSE,0,FALSE,14394,16807,-2123,22
FALSE,FALSE,0,FALSE,15337,16528,-646,19.8,TRUE,0,FALSE,15983,16676,646,19.7
TRUE,FALSE,0,FALSE,17569,18822,-72,23.9,TRUE,2,TRUE,17641,18293,72,20.9
TRUE,TRUE,1,TRUE,17585,18820,2268,24,FALSE,0,FALSE,15317,18185,-2268,21.9
FALSE,FALSE,0,FALSE,15950,18040,-2365,23.1,TRUE,1,TRUE,18315,20086,2365,23.3
TRUE,TRUE,0,FALSE,16531,17534,-136,21.8,FALSE,2,TRUE,16667,17824,136,24.3
FALSE,FALSE,1,TRUE,16599,16907,-2683,18.9,TRUE,1,FALSE,19282,18227,2683,20.9
FALSE,FALSE,1,TRUE,16086,18044,441,22.2,TRUE,0,FALSE,15645,17418,-441,23.5
FALSE,FALSE,0,FALSE,15065,17423,-950,25.2,TRUE,0,FALSE,16015,19208,950,23.8
FALSE,FALSE,0,FALSE,13946,16248,-2727,22.7,TRUE,1,TRUE,16673,18289,2727,22
FALSE,FALSE,0,FALSE,16526,19072,-64,21.7,TRUE,0,FALSE,16590,18833,64,21.4
FALSE,TRUE,0,FALSE,16495,17444,222,21.1,FALSE,1,TRUE,16273,17516,-222,20.5
TRUE,FALSE,1,FALSE,17009,18492,862,23.8,TRUE,1,TRUE,16147,17394,-862,25.2
FALSE,TRUE,0,FALSE,15419,17517,-2636,19.1,FALSE,0,FALSE,18055,18356,2636,22.5
TRUE,FALSE,1,TRUE,16460,17849,23,22,TRUE,0,FALSE,16437,18187,-23,22.2
FALSE,FALSE,0,FALSE,16364,16467,-1565,22.3,TRUE,2,TRUE,17929,18219,1565,17
TRUE,TRUE,0,FALSE,16434,18132,1545,21.6,FALSE,1,TRUE,14889,16308,-1545,23.3
FALSE,TRUE,0,FALSE,17685,17947,2260,22.4,FALSE,0,FALSE,15425,17699,-2260,22.6
TRUE,FALSE,0,FALSE,16506,16828,-2535,21.6,TRUE,1,TRUE,19041,19482,2535,22.8
TRUE,FALSE,0,FALSE,17174,18060,1514,21.2,TRUE,1,FALSE,15660,16639,-1514,18.7
TRUE,FALSE,0,FALSE,14771,17825,-1426,22.7,TRUE,2,TRUE,16197,17851,1426,21.8
TRUE,TRUE,1,TRUE,16359,15794,-2414,18.2,FALSE,0,FALSE,18773,18881,2414,22.5
TRUE,FALSE,1,TRUE,15871,18125,1007,21.9,TRUE,1,FALSE,14864,17020,-1007,16.4
TRUE,TRUE,1,TRUE,18215,18418,4749,25.6,FALSE,0,FALSE,13466,14838,-4749,20.7
TRUE,TRUE,0,FALSE,15747,17856,-1358,21.4,FALSE,0,FALSE,17105,18919,1358,21.9
TRUE,FALSE,0,FALSE,16464,18030,1474,20.9,TRUE,0,FALSE,14990,17067,-1474,22.5
TRUE,TRUE,0,FALSE,16424,17611,2588,19.6,FALSE,1,FALSE,13836,16068,-2588,18.5
FALSE,FALSE,1,TRUE,17494,17832,14,20.1,TRUE,0,FALSE,17480,17630,-14,24.3
TRUE,TRUE,1,FALSE,18691,20672,5359,22.8,FALSE,1,TRUE,13332,15682,-5359,20.8
FALSE,FALSE,1,FALSE,16446,18130,-3620,21.8,TRUE,0,FALSE,20066,18412,3620,22.9
FALSE,TRUE,0,FALSE,16259,16527,-2295,18.4,FALSE,0,FALSE,18554,19043,2295,22.8
FALSE,TRUE,1,TRUE,16231,18316,-2932,21.1,FALSE,0,FALSE,19163,20451,2932,21.5
FALSE,TRUE,1,TRUE,16146,16204,2037,19.6,FALSE,0,FALSE,14109,16485,-2037,17.2
TRUE,TRUE,1,TRUE,17344,17484,992,19.1,FALSE,0,FALSE,16352,18093,-992,20.6
TRUE,FALSE,0,FALSE,17327,18655,1568,20.3,TRUE,0,FALSE,15759,18044,-1568,21.2
FALSE,TRUE,1,FALSE,16568,18066,-727,21.5,FALSE,1,TRUE,17295,17744,727,21.1
FALSE,TRUE,0,FALSE,15732,18040,-185,24.1,FALSE,1,TRUE,15917,17995,185,23.8
TRUE,TRUE,0,FALSE,16812,19678,1322,22.8,FALSE,1,TRUE,15490,17402,-1322,21.5
TRUE,TRUE,0,FALSE,16452,19307,1068,27.3,FALSE,0,FALSE,15384,18689,-1068,25.3
TRUE,TRUE,1,TRUE,17427,19221,1975,24.9,FALSE,0,FALSE,15452,17788,-1975,23.4
TRUE,FALSE,1,TRUE,16892,18221,2391,20.7,TRUE,0,FALSE,14501,16495,-2391,19
TRUE,FALSE,0,FALSE,17003,18752,570,25.2,TRUE,0,FALSE,16433,18384,-570,23.5
FALSE,TRUE,1,TRUE,16836,18457,1138,20.5,FALSE,0,FALSE,15698,16699,-1138,22.3
FALSE,FALSE,1,TRUE,14434,16488,-6972,18.1,TRUE,1,FALSE,21406,20444,6972,24
TRUE,FALSE,0,FALSE,16696,17704,-422,20.2,TRUE,2,TRUE,17118,17747,422,18.9
TRUE,TRUE,1,TRUE,16974,18550,2906,18.2,FALSE,0,FALSE,14068,16190,-2906,20.1
FALSE,FALSE,1,TRUE,13653,17299,-4566,17.8,TRUE,1,FALSE,18219,19331,4566,26
FALSE,FALSE,1,TRUE,13934,17303,-1571,22.2,TRUE,0,FALSE,15505,17996,1571,19.1
FALSE,FALSE,0,FALSE,13405,15825,-3556,21.4,TRUE,0,FALSE,16961,18775,3556,23.7
TRUE,TRUE,2,TRUE,18747,19584,3015,22.5,FALSE,0,FALSE,15732,16517,-3015,18.4
TRUE,FALSE,1,FALSE,15156,18116,-324,21.7,TRUE,1,TRUE,15480,16465,324,22
TRUE,FALSE,1,TRUE,19241,18942,1350,19.8,TRUE,0,FALSE,17891,18365,-1350,24.7
TRUE,FALSE,1,TRUE,15866,17452,394,17.6,TRUE,0,FALSE,15472,17507,-394,21.6
TRUE,FALSE,1,TRUE,14247,16806,-1597,22.6,TRUE,1,FALSE,15844,17521,1597,21.8
FALSE,FALSE,0,FALSE,13493,14240,-5355,16.7,TRUE,1,TRUE,18848,20129,5355,23.4
TRUE,TRUE,1,TRUE,15855,18078,145,23.8,FALSE,0,FALSE,15710,17106,-145,22.4
TRUE,TRUE,1,FALSE,15186,17891,1120,23.1,FALSE,1,TRUE,14066,17414,-1120,19.6
TRUE,TRUE,1,TRUE,17176,17299,99,18.8,FALSE,0,FALSE,17077,17022,-99,20.3
TRUE,FALSE,2,TRUE,16947,18756,980,22.6,TRUE,0,FALSE,15967,18353,-980,24.3
TRUE,TRUE,1,TRUE,19528,19357,5351,23.4,FALSE,0,FALSE,14177,15808,-5351,21.1
FALSE,FALSE,0,FALSE,13775,17108,-2490,20.6,TRUE,1,TRUE,16265,18218,2490,23.7
TRUE,TRUE,2,TRUE,18418,18311,3750,24.7,FALSE,0,FALSE,14668,15569,-3750,19.4
TRUE,TRUE,0,FALSE,14815,16774,-755,18.9,FALSE,1,TRUE,15570,18364,755,21
TRUE,TRUE,1,FALSE,21728,20117,4161,24.2,FALSE,0,FALSE,17567,17526,-4161,21.4
FALSE,TRUE,1,TRUE,16348,18350,1476,24.3,FALSE,0,FALSE,14872,17201,-1476,23.3
FALSE,FALSE,2,TRUE,16302,18772,336,23.1,TRUE,0,FALSE,15966,17836,-336,22.3
FALSE,TRUE,1,FALSE,15410,17797,-234,21.6,FALSE,1,TRUE,15644,18203,234,23.6
FALSE,TRUE,0,FALSE,15119,16105,-1901,21.6,FALSE,1,TRUE,17020,19216,1901,21.6
FALSE,TRUE,0,FALSE,16561,17480,-519,20.1,FALSE,2,TRUE,17080,18123,519,22.8
FALSE,FALSE,0,FALSE,13736,15897,-2301,18,TRUE,2,TRUE,16037,18556,2301,22.6
FALSE,TRUE,1,FALSE,15481,17390,481,22.2,FALSE,1,TRUE,15000,16413,-481,19.9
FALSE,FALSE,0,FALSE,15967,18406,-1413,22.7,TRUE,2,TRUE,17380,19708,1413,25.6
TRUE,FALSE,0,FALSE,16627,18363,-135,22.3,TRUE,1,TRUE,16762,19360,135,23.6
TRUE,FALSE,0,FALSE,17087,17623,442,19,TRUE,1,FALSE,16645,17768,-442,18.6
TRUE,FALSE,1,TRUE,17612,19905,2356,24.6,TRUE,0,FALSE,15256,17474,-2356,21.3
FALSE,TRUE,0,FALSE,16731,16329,266,20.5,FALSE,1,TRUE,16465,17241,-266,21.8
TRUE,FALSE,1,TRUE,18360,17412,525,20.2,TRUE,0,FALSE,17835,16936,-525,21.8
TRUE,TRUE,1,FALSE,18075,19469,2859,23.7,FALSE,0,FALSE,15216,16525,-2859,22.4
FALSE,TRUE,0,FALSE,19636,19567,4253,24.7,FALSE,2,TRUE,15383,16836,-4253,20.9
TRUE,TRUE,1,FALSE,16897,18652,1923,23.4,FALSE,1,TRUE,14974,17352,-1923,24
FALSE,TRUE,0,FALSE,14538,16373,-3278,21.1,FALSE,1,FALSE,17816,18246,3278,25.5
TRUE,FALSE,0,FALSE,14868,17584,-1146,22.4,TRUE,0,FALSE,16014,18025,1146,16.2
TRUE,TRUE,1,TRUE,20979,20534,4091,25,FALSE,0,FALSE,16888,17142,-4091,21.5
TRUE,FALSE,0,FALSE,16513,18383,-379,24.9,TRUE,1,TRUE,16892,17658,379,24
TRUE,FALSE,1,TRUE,16180,18032,476,21,TRUE,1,FALSE,15704,17932,-476,23.2
TRUE,TRUE,0,FALSE,16050,17867,2041,19.5,FALSE,0,FALSE,14009,16578,-2041,20.2
FALSE,FALSE,0,FALSE,14428,16758,-1552,21,TRUE,0,FALSE,15980,18264,1552,22.3
FALSE,FALSE,0,FALSE,16150,16419,-2243,19.4,TRUE,0,FALSE,18393,18443,2243,18.6
FALSE,TRUE,0,FALSE,17576,18867,2237,22.7,FALSE,0,FALSE,15339,17019,-2237,20.9
TRUE,FALSE,1,TRUE,14990,17315,-1395,18.7,TRUE,0,FALSE,16385,18026,1395,24.8
TRUE,FALSE,1,TRUE,17664,19310,257,22,TRUE,1,FALSE,17407,17645,-257,22.5
FALSE,TRUE,1,TRUE,16114,17563,1323,23.5,FALSE,0,FALSE,14791,17538,-1323,20.3
FALSE,TRUE,1,TRUE,15299,17076,-874,23,FALSE,0,FALSE,16173,18352,874,23.1
TRUE,TRUE,2,TRUE,18912,17839,4565,25.7,FALSE,0,FALSE,14347,15760,-4565,19.7
TRUE,TRUE,1,FALSE,19915,18674,5286,24.6,FALSE,1,TRUE,14629,15091,-5286,15.4
TRUE,TRUE,1,FALSE,18273,17500,2544,20.7,FALSE,1,TRUE,15729,16638,-2544,18.5
FALSE,FALSE,1,TRUE,15158,17680,-1529,21.9,TRUE,0,FALSE,16687,18857,1529,21.3
TRUE,TRUE,1,TRUE,16086,17616,842,22.2,FALSE,0,FALSE,15244,18279,-842,20.1
FALSE,TRUE,0,FALSE,18626,18656,2318,22.6,FALSE,1,FALSE,16308,18317,-2318,23.9
FALSE,FALSE,1,TRUE,17048,17097,-1773,19.3,TRUE,0,FALSE,18821,19060,1773,21.5
FALSE,TRUE,0,FALSE,14819,17986,-930,22.3,FALSE,2,TRUE,15749,18580,930,21
FALSE,FALSE,0,FALSE,15082,16399,-1851,19.9,TRUE,1,FALSE,16933,18438,1851,25.8
FALSE,FALSE,1,FALSE,14605,17830,-280,24.4,TRUE,1,TRUE,14885,16927,280,21.7
FALSE,FALSE,1,TRUE,17063,18195,-1220,20,TRUE,0,FALSE,18283,18398,1220,21.7
FALSE,FALSE,0,FALSE,13881,16482,-4851,22.5,TRUE,1,TRUE,18732,20059,4851,24.3
TRUE,TRUE,0,FALSE,17180,19599,1748,25.8,FALSE,1,TRUE,15432,18103,-1748,23.6
TRUE,TRUE,0,FALSE,16978,17957,-1589,22.9,FALSE,1,FALSE,18567,20864,1589,19.3
TRUE,FALSE,0,FALSE,17827,18481,1756,20.8,TRUE,1,TRUE,16071,17353,-1756,18.8
TRUE,TRUE,1,TRUE,16168,17052,-1149,17.6,FALSE,1,FALSE,17317,18379,1149,26.3
FALSE,TRUE,0,FALSE,15544,18015,-961,23.8,FALSE,1,TRUE,16505,19425,961,23.9
TRUE,FALSE,1,FALSE,17566,18896,-528,18.3,TRUE,1,TRUE,18094,19192,528,22.8
TRUE,FALSE,1,TRUE,15293,16208,-1555,20.2,TRUE,0,FALSE,16848,17442,1555,21
TRUE,TRUE,2,TRUE,17303,18705,2871,21.9,FALSE,0,FALSE,14432,16551,-2871,21.7
TRUE,TRUE,1,TRUE,17201,18839,1070,23.4,FALSE,1,FALSE,16131,17680,-1070,21.5
TRUE,TRUE,2,TRUE,18742,20148,3725,25.2,FALSE,0,FALSE,15017,17245,-3725,20.8
TRUE,FALSE,0,FALSE,16519,19018,-180,21,TRUE,2,TRUE,16699,16719,180,19.2
FALSE,FALSE,1,TRUE,13727,16509,-5000,20.7,TRUE,0,FALSE,18727,21331,5000,25.4
FALSE,FALSE,1,TRUE,17617,18094,685,21.7,TRUE,0,FALSE,16932,16645,-685,18
TRUE,TRUE,0,FALSE,19432,19227,3857,22.8,FALSE,1,TRUE,15575,16567,-3857,21
FALSE,TRUE,0,FALSE,15280,16650,-770,20.2,FALSE,1,TRUE,16050,18525,770,21.7
TRUE,FALSE,0,FALSE,15496,17876,-1406,21.4,TRUE,2,TRUE,16902,19204,1406,23.4
FALSE,TRUE,0,FALSE,15263,15892,-2711,17.6,FALSE,1,TRUE,17974,16174,2711,18.6
TRUE,TRUE,0,FALSE,17012,19091,324,22.5,FALSE,1,TRUE,16688,18985,-324,22.9
TRUE,FALSE,0,FALSE,14168,16884,-3344,21.7,TRUE,2,TRUE,17512,19555,3344,22.5
TRUE,TRUE,1,TRUE,17060,17673,143,20.7,FALSE,0,FALSE,16917,16828,-143,21.2
TRUE,TRUE,0,FALSE,17053,17515,1126,21.9,FALSE,2,TRUE,15927,17444,-1126,21.7
TRUE,TRUE,0,FALSE,17185,16416,-2557,20,FALSE,2,TRUE,19742,18645,2557,21
FALSE,FALSE,0,FALSE,16690,17992,-1060,24.8,TRUE,2,TRUE,17750,18578,1060,21.4
TRUE,TRUE,1,TRUE,18246,18509,2914,22.9,FALSE,0,FALSE,15332,16457,-2914,20.9
TRUE,FALSE,0,FALSE,16310,17712,464,21.9,TRUE,1,TRUE,15846,17286,-464,21.2
TRUE,TRUE,1,TRUE,16766,18841,1399,23.2,FALSE,0,FALSE,15367,18287,-1399,24
FALSE,TRUE,0,FALSE,19460,19643,778,22.3,FALSE,0,FALSE,18682,18200,-778,23.4
TRUE,TRUE,1,FALSE,15307,16772,-1618,20.5,FALSE,0,FALSE,16925,17996,1618,24.3
FALSE,FALSE,0,FALSE,15908,18133,-1345,21.8,TRUE,1,TRUE,17253,17964,1345,22
TRUE,TRUE,1,TRUE,16966,19311,138,23.1,FALSE,1,FALSE,16828,18226,-138,21.4
TRUE,FALSE,1,TRUE,16995,19978,-418,24.1,TRUE,0,FALSE,17413,19793,418,23.7
FALSE,TRUE,2,TRUE,18292,18884,789,21.6,FALSE,0,FALSE,17503,17565,-789,22
TRUE,TRUE,1,FALSE,16481,18642,760,22.9,FALSE,1,TRUE,15721,18597,-760,23.2
FALSE,FALSE,0,FALSE,14907,17149,-2342,22.6,TRUE,0,FALSE,17249,19131,2342,26.2
TRUE,TRUE,1,TRUE,15108,16485,-2302,19.1,FALSE,0,FALSE,17410,18717,2302,24.6
FALSE,TRUE,1,TRUE,14779,15595,-2932,13.7,FALSE,1,FALSE,17711,18165,2932,21.9
FALSE,FALSE,0,FALSE,15739,18231,154,19.3,TRUE,1,TRUE,15585,18072,-154,21.1
FALSE,TRUE,0,FALSE,16660,17061,99,21,FALSE,1,TRUE,16561,18670,-99,21.4
FALSE,FALSE,0,FALSE,13561,16632,-2876,22.2,TRUE,1,TRUE,16437,18730,2876,23.3
FALSE,TRUE,0,FALSE,17761,20143,2501,24.7,FALSE,0,FALSE,15260,17845,-2501,25.1
FALSE,FALSE,0,FALSE,14910,17888,-1557,24.5,TRUE,1,TRUE,16467,18927,1557,22.5
TRUE,TRUE,1,TRUE,17410,18627,1578,19,FALSE,0,FALSE,15832,18132,-1578,19.5
FALSE,FALSE,0,FALSE,15518,18114,-1630,24.1,TRUE,1,TRUE,17148,18645,1630,24.3
TRUE,FALSE,1,TRUE,18261,18602,1753,24.8,TRUE,0,FALSE,16508,17667,-1753,21.8
FALSE,TRUE,0,FALSE,15574,17216,14,23.6,FALSE,2,TRUE,15560,17525,-14,22.4
FALSE,FALSE,0,FALSE,16565,17659,-245,22,TRUE,0,FALSE,16810,18867,245,24.4
FALSE,TRUE,0,FALSE,16163,18437,1074,24.2,FALSE,1,FALSE,15089,17895,-1074,22.4
FALSE,FALSE,0,FALSE,14724,16015,-3541,21.8,TRUE,1,TRUE,18265,18449,3541,24.4
TRUE,TRUE,1,TRUE,17953,18275,2915,21.3,FALSE,0,FALSE,15038,16190,-2915,20
FALSE,FALSE,1,TRUE,14819,16721,-4413,16.4,TRUE,0,FALSE,19232,20258,4413,24.2
FALSE,TRUE,0,FALSE,15025,16369,-1517,21.2,FALSE,0,FALSE,16542,17856,1517,22.1
TRUE,TRUE,0,FALSE,18302,17304,2178,23.5,FALSE,0,FALSE,16124,17273,-2178,19.2
FALSE,TRUE,0,FALSE,18197,18621,1470,20.5,FALSE,1,TRUE,16727,17381,-1470,20.6
TRUE,TRUE,1,TRUE,18363,20337,4507,23.3,FALSE,0,FALSE,13856,16258,-4507,19.4
TRUE,TRUE,1,TRUE,17543,19535,4387,25.4,FALSE,0,FALSE,13156,16124,-4387,18.8
FALSE,FALSE,0,FALSE,16973,18421,929,20.4,TRUE,0,FALSE,16044,16621,-929,20.3
FALSE,FALSE,1,TRUE,16586,17047,-787,22.6,TRUE,0,FALSE,17373,18968,787,20.7
TRUE,TRUE,0,FALSE,18106,17783,2695,19.1,FALSE,1,TRUE,15411,15996,-2695,18.7
FALSE,TRUE,0,FALSE,16300,13423,-3173,14.1,FALSE,1,TRUE,19473,17773,3173,20.7
FALSE,FALSE,0,FALSE,16397,18004,-1253,18.3,TRUE,0,FALSE,17650,17071,1253,19.9
TRUE,TRUE,1,TRUE,16948,18641,2711,24.1,FALSE,0,FALSE,14237,16820,-2711,22.3
FALSE,TRUE,1,TRUE,14992,17756,-471,21.3,FALSE,0,FALSE,15463,18777,471,24
FALSE,FALSE,1,TRUE,16560,18049,1319,22,TRUE,1,FALSE,15241,17938,-1319,19
FALSE,TRUE,1,FALSE,15759,17563,338,21.9,FALSE,0,FALSE,15421,18625,-338,22
TRUE,FALSE,0,FALSE,14711,15177,-2263,15.4,TRUE,1,TRUE,16974,17332,2263,19.6
TRUE,TRUE,1,FALSE,16940,17896,2038,24.4,FALSE,0,FALSE,14902,17539,-2038,19.8
FALSE,FALSE,0,FALSE,15218,19074,-1911,20.3,TRUE,2,TRUE,17129,20285,1911,25
FALSE,TRUE,1,TRUE,15466,17220,488,22.8,FALSE,0,FALSE,14978,16747,-488,18.2
TRUE,TRUE,1,TRUE,15278,18693,734,22.7,FALSE,0,FALSE,14544,18338,-734,20.3
TRUE,TRUE,1,TRUE,19651,18318,5195,20,FALSE,0,FALSE,14456,16029,-5195,17.9
FALSE,TRUE,2,TRUE,18233,21650,3319,24.4,FALSE,0,FALSE,14914,16366,-3319,17.7
TRUE,TRUE,1,TRUE,17470,18062,2335,20.6,FALSE,0,FALSE,15135,17083,-2335,21.5
FALSE,FALSE,0,FALSE,16768,19368,-268,22.5,TRUE,1,TRUE,17036,19523,268,22.1
FALSE,TRUE,0,FALSE,14509,17194,-1110,20.1,FALSE,0,FALSE,15619,18342,1110,24.1
TRUE,TRUE,1,FALSE,16178,18656,381,21.6,FALSE,1,TRUE,15797,18453,-381,25.3
FALSE,TRUE,0,FALSE,14333,16812,-1636,22.3,FALSE,1,TRUE,15969,18208,1636,22.3
TRUE,FALSE,2,TRUE,17732,19451,-532,19.4,TRUE,0,FALSE,18264,19153,532,20.8
FALSE,FALSE,0,FALSE,14695,18090,-2467,20.7,TRUE,1,TRUE,17162,18010,2467,18.7
TRUE,FALSE,0,FALSE,17800,19085,2460,22.3,TRUE,1,TRUE,15340,17151,-2460,20.5
TRUE,TRUE,0,FALSE,16048,19032,1454,25.5,FALSE,0,FALSE,14594,17621,-1454,23.4
TRUE,TRUE,0,FALSE,14163,17413,450,24.6,FALSE,1,TRUE,13713,16489,-450,21.1
TRUE,FALSE,2,TRUE,15695,18493,-300,23.8,TRUE,0,FALSE,15995,18042,300,20.3
FALSE,FALSE,1,TRUE,14844,17179,-2343,21.8,TRUE,0,FALSE,17187,19367,2343,25.6
FALSE,TRUE,0,FALSE,15974,16903,-1008,17.5,FALSE,1,TRUE,16982,18419,1008,18.4
TRUE,TRUE,0,FALSE,14995,17661,-2442,24,FALSE,1,TRUE,17437,18911,2442,26.4
FALSE,FALSE,0,FALSE,14799,15917,-4740,21.8,TRUE,2,TRUE,19539,18998,4740,23.1
FALSE,FALSE,0,FALSE,17056,17190,-1603,16.7,TRUE,2,TRUE,18659,18596,1603,22.9
FALSE,FALSE,1,TRUE,16243,17548,-555,19.2,TRUE,1,FALSE,16798,19010,555,23.2
FALSE,FALSE,1,TRUE,17892,16641,-1361,15.7,TRUE,1,FALSE,19253,17672,1361,23.9
TRUE,TRUE,1,TRUE,16508,17714,2024,24.3,FALSE,1,FALSE,14484,15735,-2024,21.3
TRUE,FALSE,0,FALSE,16568,18658,1840,24.2,TRUE,0,FALSE,14728,16788,-1840,24
TRUE,FALSE,0,FALSE,16503,18765,690,23.1,TRUE,1,TRUE,15813,18400,-690,23.2
FALSE,TRUE,1,TRUE,17459,18018,-98,18.5,FALSE,0,FALSE,17557,19154,98,21.9
TRUE,TRUE,0,FALSE,17024,19375,197,22.2,FALSE,2,TRUE,16827,17492,-197,19.8
TRUE,TRUE,0,FALSE,16660,18272,1574,25.2,FALSE,0,FALSE,15086,17205,-1574,19.7
FALSE,FALSE,0,FALSE,14244,16850,-3553,20.7,TRUE,1,TRUE,17797,18580,3553,22
FALSE,TRUE,0,FALSE,14041,15172,-5162,22.6,FALSE,0,FALSE,19203,18782,5162,19.6
TRUE,TRUE,1,TRUE,16752,19777,2210,23.2,FALSE,0,FALSE,14542,17366,-2210,21.4
TRUE,TRUE,1,FALSE,17563,18032,3410,20.3,FALSE,1,TRUE,14153,15974,-3410,21.3
TRUE,TRUE,1,TRUE,17262,19094,251,23.1,FALSE,0,FALSE,17011,19168,-251,23.6
TRUE,TRUE,0,FALSE,17438,18257,3018,18.6,FALSE,0,FALSE,14420,16262,-3018,22.2
FALSE,FALSE,0,FALSE,14275,15474,-3414,18,TRUE,2,TRUE,17689,19221,3414,22.8
TRUE,TRUE,1,TRUE,16753,17461,2015,22,FALSE,1,FALSE,14738,16604,-2015,17.1
TRUE,TRUE,1,TRUE,17163,19382,1422,22.4,FALSE,0,FALSE,15741,18607,-1422,21.8
FALSE,FALSE,0,FALSE,15750,17334,-1727,21.4,TRUE,0,FALSE,17477,17953,1727,22.3
TRUE,TRUE,0,FALSE,15954,16128,654,21.1,FALSE,1,FALSE,15300,15305,-654,19
TRUE,TRUE,2,TRUE,18293,19981,3691,24,FALSE,0,FALSE,14602,17176,-3691,18.6
FALSE,TRUE,0,FALSE,19336,19116,4627,21.2,FALSE,0,FALSE,14709,14332,-4627,17.5
FALSE,TRUE,1,FALSE,14014,16219,-3443,20.5,FALSE,0,FALSE,17457,18503,3443,23
FALSE,FALSE,2,TRUE,16207,17381,-819,21.1,TRUE,0,FALSE,17026,19210,819,22.3
TRUE,FALSE,0,FALSE,16654,19392,1856,25.5,TRUE,2,TRUE,14798,17862,-1856,24.4
TRUE,FALSE,0,FALSE,16711,19807,1759,23.3,TRUE,1,TRUE,14952,17283,-1759,20.3
FALSE,TRUE,1,TRUE,16578,18139,1159,20,FALSE,0,FALSE,15419,16629,-1159,25
TRUE,FALSE,1,TRUE,16220,17447,-444,22.7,TRUE,0,FALSE,16664,17631,444,21.2
FALSE,FALSE,0,FALSE,15096,15415,-120,19.9,TRUE,1,TRUE,15216,17035,120,19.3
TRUE,TRUE,1,FALSE,18426,18454,1493,19.2,FALSE,0,FALSE,16933,18252,-1493,18.5
TRUE,TRUE,1,TRUE,18758,18710,4335,21.2,FALSE,0,FALSE,14423,16386,-4335,21.5
FALSE,TRUE,0,FALSE,15928,18170,-935,20.4,FALSE,1,TRUE,16863,18174,935,23.3
TRUE,TRUE,1,TRUE,16233,18524,1081,21.5,FALSE,0,FALSE,15152,18325,-1081,22
TRUE,TRUE,1,TRUE,16493,17450,-862,17.5,FALSE,1,FALSE,17355,19184,862,22.3
FALSE,FALSE,1,FALSE,15633,17605,-2770,21,TRUE,1,TRUE,18403,19952,2770,21.8
TRUE,FALSE,2,TRUE,17750,20138,3673,23.7,TRUE,0,FALSE,14077,17382,-3673,20.4
FALSE,FALSE,0,FALSE,16251,16548,-4859,21.3,TRUE,1,FALSE,21110,19504,4859,22.6
TRUE,TRUE,0,FALSE,17627,18282,428,24.4,FALSE,1,TRUE,17199,18247,-428,24.7
FALSE,TRUE,1,TRUE,17315,19378,-733,25.3,FALSE,0,FALSE,18048,20947,733,21.6
FALSE,FALSE,0,FALSE,15663,18122,936,23.7,TRUE,1,TRUE,14727,16745,-936,19.1
FALSE,FALSE,0,FALSE,14865,18385,-1179,23.3,TRUE,2,TRUE,16044,17739,1179,22.6
TRUE,TRUE,0,FALSE,16230,18489,932,23.5,FALSE,0,FALSE,15298,17947,-932,24.7
TRUE,FALSE,0,FALSE,16065,20238,544,24.7,TRUE,0,FALSE,15521,18175,-544,22.2
FALSE,FALSE,1,TRUE,17049,20151,-105,22.3,TRUE,0,FALSE,17154,18270,105,23.1
FALSE,FALSE,1,TRUE,15412,18001,-287,21.2,TRUE,0,FALSE,15699,19046,287,24.3
TRUE,TRUE,0,FALSE,17949,19069,1052,20,FALSE,1,TRUE,16897,18729,-1052,22.3
TRUE,TRUE,0,FALSE,16938,17614,2145,22,FALSE,0,FALSE,14793,17930,-2145,19.7
FALSE,TRUE,0,FALSE,14627,16086,-3960,19.3,FALSE,1,TRUE,18587,20091,3960,24.7
FALSE,FALSE,0,FALSE,16485,18759,1097,22.2,TRUE,1,TRUE,15388,18048,-1097,24
FALSE,TRUE,0,FALSE,15246,17687,-671,21.7,FALSE,1,TRUE,15917,18425,671,22.7
FALSE,FALSE,1,TRUE,17583,17639,-236,20.1,TRUE,0,FALSE,17819,18717,236,22.5
TRUE,TRUE,1,TRUE,18655,19797,3212,25.4,FALSE,0,FALSE,15443,16552,-3212,17
TRUE,TRUE,1,TRUE,16875,18112,-795,21.9,FALSE,0,FALSE,17670,17876,795,22.1
TRUE,TRUE,1,FALSE,17872,19324,3544,24.7,FALSE,1,TRUE,14328,17241,-3544,21.9
TRUE,TRUE,2,TRUE,16574,17377,969,19.7,FALSE,0,FALSE,15605,17419,-969,19.4
FALSE,TRUE,0,FALSE,17651,18199,2348,22.2,FALSE,1,TRUE,15303,17066,-2348,19.5
FALSE,TRUE,0,FALSE,15035,16650,-3584,18.3,FALSE,1,TRUE,18619,19898,3584,23.8
TRUE,TRUE,2,TRUE,16399,17698,330,23.6,FALSE,0,FALSE,16069,18173,-330,23.5
FALSE,FALSE,1,FALSE,18236,18690,1112,22.1,TRUE,0,FALSE,17124,18487,-1112,19.8
TRUE,TRUE,0,FALSE,15782,18450,279,21.9,FALSE,1,TRUE,15503,18058,-279,24.6
FALSE,TRUE,1,TRUE,16938,18699,1516,22.6,FALSE,0,FALSE,15422,18273,-1516,21
FALSE,FALSE,0,FALSE,14740,15556,-4229,15.6,TRUE,1,TRUE,18969,19740,4229,22
FALSE,FALSE,0,FALSE,15299,17019,-3111,16.9,TRUE,0,FALSE,18410,19305,3111,17.8
TRUE,TRUE,0,FALSE,17615,18307,3686,20.6,FALSE,0,FALSE,13929,16836,-3686,15.3
TRUE,TRUE,1,TRUE,20955,19806,5136,22.5,FALSE,0,FALSE,15819,17021,-5136,21.3
TRUE,TRUE,0,FALSE,16636,19834,1394,24.5,FALSE,0,FALSE,15242,18466,-1394,22.5
FALSE,FALSE,1,FALSE,13805,17253,-2009,22.1,TRUE,1,TRUE,15814,19649,2009,24.3
FALSE,TRUE,0,FALSE,18453,18299,466,20.4,FALSE,0,FALSE,17987,18615,-466,18.6
FALSE,FALSE,0,FALSE,14642,15033,-4958,17.1,TRUE,1,TRUE,19600,17421,4958,23.1
FALSE,FALSE,0,FALSE,14503,16807,-2825,20.7,TRUE,2,TRUE,17328,19304,2825,22.1
FALSE,FALSE,1,TRUE,15335,17368,-1716,23.4,TRUE,0,FALSE,17051,18969,1716,26.2
FALSE,TRUE,0,FALSE,15629,16806,-1537,17.6,FALSE,0,FALSE,17166,17732,1537,18.6
FALSE,FALSE,0,FALSE,15782,16172,-2707,19.5,TRUE,1,TRUE,18489,18308,2707,23.3
TRUE,TRUE,1,TRUE,18685,18421,2857,23.4,FALSE,0,FALSE,15828,17015,-2857,21.4
TRUE,FALSE,1,TRUE,14901,16696,-3206,21.4,TRUE,0,FALSE,18107,18865,3206,23.8
FALSE,FALSE,0,FALSE,14012,17304,-2670,23,TRUE,1,TRUE,16682,18699,2670,21.8
FALSE,TRUE,0,FALSE,15913,16454,-960,19.3,FALSE,0,FALSE,16873,18956,960,19
FALSE,FALSE,1,TRUE,14969,16860,-1579,20,TRUE,0,FALSE,16548,18039,1579,22.6
FALSE,TRUE,0,FALSE,14863,18643,321,23,FALSE,0,FALSE,14542,18903,-321,23
FALSE,TRUE,0,FALSE,15985,18011,-12,21.4,FALSE,0,FALSE,15997,19172,12,19.4
FALSE,FALSE,0,FALSE,17407,18451,222,21.4,TRUE,0,FALSE,17185,16735,-222,20.5
FALSE,TRUE,0,FALSE,15829,17771,968,23.7,FALSE,1,TRUE,14861,17056,-968,22.4
FALSE,TRUE,0,FALSE,14953,17141,-3042,18.3,FALSE,1,TRUE,17995,20782,3042,22.4
TRUE,TRUE,1,TRUE,20389,20574,6512,23.5,FALSE,0,FALSE,13877,16593,-6512,18.5
TRUE,FALSE,0,FALSE,16789,18276,904,23.3,TRUE,1,TRUE,15885,18112,-904,23.4
TRUE,TRUE,2,TRUE,20403,20886,5365,23.8,FALSE,0,FALSE,15038,15985,-5365,17.8
TRUE,TRUE,0,FALSE,15318,17867,-1145,21.9,FALSE,1,FALSE,16463,19967,1145,26.1
TRUE,TRUE,1,FALSE,15180,18148,-986,22.5,FALSE,1,TRUE,16166,19656,986,23.5
TRUE,TRUE,1,TRUE,18200,19337,3719,21.8,FALSE,0,FALSE,14481,17524,-3719,21.4
FALSE,TRUE,0,FALSE,15646,16889,-201,18.6,FALSE,2,TRUE,15847,18591,201,24.7
FALSE,TRUE,0,FALSE,15747,17503,-1123,19.2,FALSE,1,TRUE,16870,18733,1123,22.7
FALSE,FALSE,0,FALSE,14668,16196,-2440,19.7,TRUE,1,TRUE,17108,18435,2440,23
TRUE,TRUE,1,FALSE,19318,21508,4787,25.7,FALSE,1,TRUE,14531,16807,-4787,23
TRUE,TRUE,1,TRUE,18302,19223,851,23.7,FALSE,0,FALSE,17451,18514,-851,25.1
FALSE,FALSE,1,TRUE,15167,17584,-1315,20,TRUE,0,FALSE,16482,18633,1315,22.2
FALSE,FALSE,0,FALSE,15330,16378,-3277,20.5,TRUE,2,TRUE,18607,18058,3277,22
FALSE,FALSE,1,TRUE,14579,17772,-1684,21.8,TRUE,0,FALSE,16263,18544,1684,22.6
FALSE,FALSE,0,FALSE,15828,16976,-2330,19.5,TRUE,1,TRUE,18158,18165,2330,21.5
FALSE,TRUE,1,TRUE,18001,18571,1510,21.6,FALSE,0,FALSE,16491,18420,-1510,23.1
FALSE,TRUE,0,FALSE,17305,18581,2319,24.6,FALSE,1,TRUE,14986,18446,-2319,21.7
TRUE,TRUE,1,FALSE,18706,19465,3787,24.3,FALSE,0,FALSE,14919,16609,-3787,20.2
FALSE,FALSE,0,FALSE,16939,17715,-398,22.3,TRUE,1,TRUE,17337,19692,398,20.2
TRUE,TRUE,2,TRUE,17645,18081,2864,22.4,FALSE,0,FALSE,14781,16899,-2864,20.7
FALSE,FALSE,0,FALSE,15985,17976,-2993,17.6,TRUE,2,TRUE,18978,20474,2993,21.8
FALSE,FALSE,1,FALSE,18325,19498,793,19,TRUE,1,TRUE,17532,17886,-793,20.8
TRUE,FALSE,2,TRUE,18050,18264,284,23.8,TRUE,0,FALSE,17766,17583,-284,20.7
TRUE,FALSE,1,TRUE,18585,19498,1139,22.1,TRUE,0,FALSE,17446,18328,-1139,21.8
FALSE,TRUE,0,FALSE,14367,16705,-2901,20.3,FALSE,1,FALSE,17268,19371,2901,22.9
FALSE,FALSE,1,TRUE,16743,18562,1323,21.5,TRUE,0,FALSE,15420,18105,-1323,20.9
TRUE,FALSE,0,FALSE,18388,18350,535,18.5,TRUE,0,FALSE,17853,17574,-535,19.8
FALSE,TRUE,0,FALSE,15710,17789,-682,24.2,FALSE,1,TRUE,16392,18112,682,22.7
FALSE,TRUE,0,FALSE,17275,19289,1702,24.1,FALSE,1,TRUE,15573,17937,-1702,23.4
FALSE,FALSE,1,FALSE,16623,17503,-389,20.6,TRUE,1,TRUE,17012,17174,389,22.5
TRUE,FALSE,1,TRUE,17402,19869,3250,26.2,TRUE,0,FALSE,14152,16796,-3250,23.2
TRUE,FALSE,2,TRUE,17555,20887,2678,24.8,TRUE,0,FALSE,14877,17737,-2678,20
TRUE,TRUE,0,FALSE,14952,17963,-2262,26.4,FALSE,0,FALSE,17214,18631,2262,24.4
FALSE,TRUE,0,FALSE,15487,14798,-1796,18.7,FALSE,0,FALSE,17283,17020,1796,21.3
TRUE,TRUE,0,FALSE,18351,19217,3827,22.2,FALSE,1,TRUE,14524,16056,-3827,20.1
FALSE,FALSE,0,FALSE,13797,15622,-5533,17.3,TRUE,2,TRUE,19330,20573,5533,25.6
TRUE,TRUE,0,FALSE,16241,18124,-602,23.8,FALSE,0,FALSE,16843,19029,602,23.2
TRUE,FALSE,0,FALSE,17065,19124,1525,25.7,TRUE,2,TRUE,15540,18251,-1525,18.9
TRUE,TRUE,0,FALSE,18609,19904,5109,24.4,FALSE,1,TRUE,13500,16895,-5109,21.6
TRUE,FALSE,1,TRUE,16259,16785,656,17.1,TRUE,1,FALSE,15603,17503,-656,23
FALSE,TRUE,1,TRUE,17858,18694,1886,26.7,FALSE,0,FALSE,15972,18234,-1886,21.9
TRUE,TRUE,0,FALSE,19055,18944,982,22.5,FALSE,2,TRUE,18073,17291,-982,18.8
TRUE,FALSE,2,TRUE,17217,18214,-414,18.5,TRUE,0,FALSE,17631,18261,414,19.8
FALSE,FALSE,0,FALSE,16091,18518,356,23.8,TRUE,1,TRUE,15735,18396,-356,21.7
FALSE,FALSE,1,TRUE,17174,17921,-516,24.4,TRUE,0,FALSE,17690,17925,516,18.3
FALSE,TRUE,1,TRUE,14961,16723,-2212,22,FALSE,0,FALSE,17173,19448,2212,23.5
TRUE,TRUE,0,FALSE,16076,16620,-923,18.7,FALSE,1,TRUE,16999,17423,923,19.7
FALSE,FALSE,0,FALSE,15905,17772,-1798,20.3,TRUE,1,TRUE,17703,19576,1798,21.8
FALSE,TRUE,1,FALSE,15075,16260,-3996,17.9,FALSE,1,TRUE,19071,19391,3996,21
TRUE,FALSE,0,FALSE,16711,17570,259,20.7,TRUE,0,FALSE,16452,18097,-259,22.1
FALSE,TRUE,0,FALSE,17371,17488,3058,20.9,FALSE,0,FALSE,14313,16392,-3058,23
FALSE,FALSE,0,FALSE,15537,18851,-937,23.1,TRUE,1,TRUE,16474,18940,937,25.1
FALSE,TRUE,0,FALSE,13751,15189,-5551,18.3,FALSE,1,TRUE,19302,17901,5551,20.1
TRUE,TRUE,0,FALSE,18888,18408,4662,23.2,FALSE,0,FALSE,14226,16389,-4662,20.7
FALSE,FALSE,0,FALSE,13962,15298,-5812,19.2,TRUE,2,TRUE,19774,20307,5812,22.5
TRUE,FALSE,0,FALSE,16697,18216,-63,21.4,TRUE,1,TRUE,16760,18995,63,21.9
FALSE,TRUE,2,TRUE,15815,18069,-1110,24.5,FALSE,0,FALSE,16925,18460,1110,22.9
TRUE,FALSE,0,FALSE,17047,19108,1604,26,TRUE,1,TRUE,15443,17509,-1604,20.9
FALSE,FALSE,0,FALSE,15118,16774,-3673,21.4,TRUE,2,TRUE,18791,20377,3673,20.6
FALSE,TRUE,0,FALSE,16035,17041,-2257,19.6,FALSE,1,TRUE,18292,19935,2257,23
TRUE,TRUE,1,TRUE,16225,17748,195,17.9,FALSE,0,FALSE,16030,17320,-195,23.9
FALSE,FALSE,1,TRUE,15033,18279,6,21.1,TRUE,0,FALSE,15027,18074,-6,22.1
FALSE,TRUE,1,FALSE,17064,16813,-574,18.5,FALSE,1,TRUE,17638,18226,574,21.7
FALSE,FALSE,1,TRUE,18043,17743,468,18.6,TRUE,0,FALSE,17575,17441,-468,21.9
FALSE,FALSE,1,FALSE,15710,18847,-152,23.9,TRUE,1,TRUE,15862,18134,152,21.8
FALSE,TRUE,0,FALSE,17476,19471,3460,22.6,FALSE,1,TRUE,14016,17196,-3460,24.2
TRUE,TRUE,0,FALSE,14745,17469,-2556,23.6,FALSE,0,FALSE,17301,17794,2556,23.8
FALSE,TRUE,1,TRUE,16052,17653,-1558,22.1,FALSE,0,FALSE,17610,18153,1558,21.2
TRUE,TRUE,1,TRUE,18888,18447,4780,24.2,FALSE,0,FALSE,14108,15699,-4780,20.3
FALSE,FALSE,0,FALSE,15423,18610,-2523,24.1,TRUE,1,TRUE,17946,19342,2523,24.8
FALSE,TRUE,1,TRUE,15927,15756,-2390,19.2,FALSE,0,FALSE,18317,18727,2390,21.9
FALSE,FALSE,0,FALSE,15967,16964,-1578,22.3,TRUE,2,TRUE,17545,17562,1578,20.6
TRUE,TRUE,1,TRUE,19929,20672,2558,22.4,FALSE,0,FALSE,17371,18323,-2558,20.8
FALSE,TRUE,0,FALSE,16110,18673,-146,22.2,FALSE,0,FALSE,16256,18116,146,21.7
TRUE,FALSE,0,FALSE,17631,18106,1564,21.4,TRUE,0,FALSE,16067,18020,-1564,19.3
TRUE,FALSE,2,TRUE,16337,18992,1260,25.1,TRUE,0,FALSE,15077,17505,-1260,20.4
TRUE,TRUE,1,TRUE,16693,18416,1722,24,FALSE,0,FALSE,14971,16559,-1722,19.3
TRUE,TRUE,2,TRUE,18334,19247,1111,23.1,FALSE,0,FALSE,17223,19221,-1111,24
TRUE,FALSE,1,FALSE,14641,16376,-3174,17.1,TRUE,1,TRUE,17815,18302,3174,19.4
FALSE,TRUE,0,FALSE,14524,17686,-1333,21.4,FALSE,0,FALSE,15857,19518,1333,26
FALSE,FALSE,0,FALSE,16111,16723,1039,21.9,TRUE,1,TRUE,15072,16802,-1039,21.3
FALSE,FALSE,1,FALSE,15284,17637,-3712,20.7,TRUE,1,TRUE,18996,21012,3712,24.6
TRUE,FALSE,1,TRUE,14107,17015,-1699,18,TRUE,0,FALSE,15806,17379,1699,22
TRUE,FALSE,0,FALSE,17152,18219,629,22.3,TRUE,1,TRUE,16523,17466,-629,21.2
TRUE,TRUE,0,FALSE,16025,16142,-2344,19.7,FALSE,1,FALSE,18369,17734,2344,21.1
TRUE,TRUE,2,TRUE,15130,18930,-27,23.4,FALSE,0,FALSE,15157,18649,27,25
FALSE,FALSE,0,FALSE,16230,16813,-30,18.1,TRUE,0,FALSE,16260,17778,30,23.1
FALSE,FALSE,0,FALSE,16113,17158,-211,20.5,TRUE,1,TRUE,16324,16838,211,19.1
FALSE,TRUE,1,TRUE,17394,18046,-614,19.5,FALSE,0,FALSE,18008,18892,614,18.7
FALSE,TRUE,1,TRUE,13803,16366,-4410,20.3,FALSE,1,FALSE,18213,20529,4410,23.6
FALSE,TRUE,0,FALSE,13893,15277,-4054,17.1,FALSE,2,TRUE,17947,19083,4054,21.8
FALSE,TRUE,0,FALSE,16312,18684,-77,23.9,FALSE,1,TRUE,16389,18424,77,23
TRUE,TRUE,1,TRUE,18205,18119,2002,20.7,FALSE,0,FALSE,16203,16328,-2002,20.8
TRUE,FALSE,1,TRUE,16484,17799,-94,24.2,TRUE,0,FALSE,16578,18643,94,20.1
FALSE,TRUE,0,FALSE,16661,18206,171,23.3,FALSE,0,FALSE,16490,17399,-171,22.9
FALSE,FALSE,0,FALSE,15381,16749,-2099,20.2,TRUE,1,TRUE,17480,18254,2099,20.6
FALSE,TRUE,2,TRUE,19234,17699,3274,17.9,FALSE,0,FALSE,15960,16096,-3274,20.6
TRUE,FALSE,0,FALSE,19350,19830,4553,23.4,TRUE,0,FALSE,14797,16830,-4553,20.8
FALSE,TRUE,1,FALSE,17389,19074,760,22.4,FALSE,1,TRUE,16629,18954,-760,23.5
FALSE,TRUE,1,TRUE,16138,16973,611,19.5,FALSE,0,FALSE,15527,17112,-611,21.5
TRUE,TRUE,0,FALSE,15271,18182,356,19.9,FALSE,0,FALSE,14915,18124,-356,23.2
TRUE,TRUE,0,FALSE,17584,16118,316,15.9,FALSE,0,FALSE,17268,17679,-316,20.2
FALSE,TRUE,0,FALSE,17297,18369,1961,21.1,FALSE,1,TRUE,15336,17805,-1961,21.1
TRUE,FALSE,1,TRUE,17693,17892,4282,20.1,TRUE,0,FALSE,13411,15899,-4282,14.9
TRUE,TRUE,0,FALSE,14703,16749,-1323,23.2,FALSE,0,FALSE,16026,17340,1323,19.1
TRUE,TRUE,0,FALSE,17394,18668,285,23.3,FALSE,0,FALSE,17109,19020,-285,22.8
FALSE,FALSE,0,FALSE,16563,17202,-1292,18.2,TRUE,2,TRUE,17855,18628,1292,23.7
FALSE,TRUE,0,FALSE,15270,17913,-375,22.5,FALSE,1,TRUE,15645,19196,375,20.7
FALSE,FALSE,0,FALSE,14906,16779,-1198,19.5,TRUE,0,FALSE,16104,17378,1198,25
TRUE,TRUE,1,TRUE,19085,19432,4784,22.6,FALSE,0,FALSE,14301,16097,-4784,17.8
TRUE,TRUE,2,TRUE,15290,17983,-9,25.3,FALSE,0,FALSE,15299,18290,9,24.3
FALSE,TRUE,0,FALSE,15557,17145,-2101,21.2,FALSE,2,TRUE,17658,19154,2101,24.9
TRUE,FALSE,1,TRUE,17318,19714,2789,24.4,TRUE,0,FALSE,14529,16491,-2789,20.3
FALSE,TRUE,0,FALSE,16359,17684,117,21.9,FALSE,1,TRUE,16242,17797,-117,22.9
FALSE,FALSE,0,FALSE,14722,16433,-3784,21.8,TRUE,1,TRUE,18506,19484,3784,23.9
FALSE,FALSE,0,FALSE,15035,15909,-2930,20.2,TRUE,1,TRUE,17965,18209,2930,23.8
FALSE,FALSE,0,FALSE,14663,15958,-3148,22.8,TRUE,1,TRUE,17811,18814,3148,21.5
FALSE,FALSE,0,FALSE,15504,17911,-1471,22.2,TRUE,1,TRUE,16975,19115,1471,21.4
FALSE,TRUE,0,FALSE,16463,18904,801,24.7,FALSE,1,TRUE,15662,17814,-801,19.7
TRUE,FALSE,0,FALSE,17009,19047,45,24.1,TRUE,0,FALSE,16964,17848,-45,21.1
TRUE,TRUE,1,FALSE,16866,17542,69,21.8,FALSE,1,TRUE,16797,18094,-69,24.7
FALSE,TRUE,0,FALSE,16982,18435,1277,24.2,FALSE,1,TRUE,15705,18138,-1277,21.8
FALSE,FALSE,0,FALSE,15051,17568,-4401,21.1,TRUE,0,FALSE,19452,20603,4401,23.9
FALSE,TRUE,0,FALSE,18719,19257,3523,23.6,FALSE,1,TRUE,15196,17500,-3523,22
FALSE,FALSE,0,FALSE,15541,15120,-3711,18,TRUE,0,FALSE,19252,18107,3711,20.7
TRUE,FALSE,1,TRUE,20114,19069,2397,22,TRUE,0,FALSE,17717,15777,-2397,14.4
TRUE,TRUE,1,FALSE,20173,20931,6281,24.8,FALSE,1,TRUE,13892,16380,-6281,20.4
FALSE,TRUE,0,FALSE,17058,16359,-1004,17.4,FALSE,0,FALSE,18062,18367,1004,21.3
FALSE,TRUE,1,TRUE,19900,17323,4027,20,FALSE,0,FALSE,15873,16622,-4027,19.7
TRUE,TRUE,1,TRUE,15536,17751,-833,17.9,FALSE,1,FALSE,16369,18772,833,24
FALSE,TRUE,0,FALSE,15946,16743,-2267,20.8,FALSE,1,TRUE,18213,18753,2267,22.7
TRUE,TRUE,0,FALSE,22449,19137,4624,20.9,FALSE,0,FALSE,17825,16626,-4624,18
FALSE,FALSE,0,FALSE,15087,17017,-3782,17.7,TRUE,1,TRUE,18869,20077,3782,24.5
TRUE,TRUE,0,FALSE,14632,16037,-1134,19.8,FALSE,1,FALSE,15766,16943,1134,22.3
TRUE,TRUE,1,TRUE,16883,18957,955,21.5,FALSE,0,FALSE,15928,18315,-955,20.6
FALSE,FALSE,0,FALSE,15463,16063,-3882,20.8,TRUE,2,TRUE,19345,18316,3882,21.3
FALSE,TRUE,0,FALSE,16158,19418,-811,17.5,FALSE,2,TRUE,16969,18394,811,23.2
TRUE,FALSE,0,FALSE,15295,16951,-1755,22.5,TRUE,0,FALSE,17050,17965,1755,21.8
TRUE,TRUE,1,FALSE,17540,19850,1499,23.2,FALSE,0,FALSE,16041,17417,-1499,18.7
TRUE,TRUE,0,FALSE,17066,20061,3215,23.9,FALSE,1,FALSE,13851,17411,-3215,22
FALSE,FALSE,0,FALSE,16110,17732,-1519,24.5,TRUE,1,TRUE,17629,19220,1519,22.8
TRUE,FALSE,0,FALSE,17707,18993,2488,20.5,TRUE,0,FALSE,15219,16080,-2488,19
TRUE,FALSE,1,FALSE,16461,18295,-667,17.3,TRUE,0,FALSE,17128,17052,667,22.4
FALSE,FALSE,0,FALSE,16429,18899,-172,24.2,TRUE,0,FALSE,16601,17645,172,21.9
FALSE,TRUE,1,TRUE,15495,17827,-1972,22.6,FALSE,0,FALSE,17467,19440,1972,23.3
FALSE,TRUE,1,TRUE,15875,17873,-396,23.5,FALSE,0,FALSE,16271,18964,396,21
FALSE,TRUE,0,FALSE,16521,17150,413,22.3,FALSE,0,FALSE,16108,18007,-413,19.7
TRUE,TRUE,0,FALSE,16781,18289,439,19.5,FALSE,2,TRUE,16342,17538,-439,20.3
FALSE,FALSE,0,FALSE,17748,19278,2329,17.5,TRUE,1,FALSE,15419,16862,-2329,21.8
FALSE,FALSE,0,FALSE,16145,17749,-2746,22.1,TRUE,1,TRUE,18891,19688,2746,22.9
FALSE,FALSE,0,FALSE,15049,17845,-964,20,TRUE,2,TRUE,16013,18116,964,19.6
TRUE,TRUE,1,TRUE,16712,17797,2357,19.4,FALSE,0,FALSE,14355,16361,-2357,16.2
FALSE,TRUE,1,FALSE,17662,19112,1016,21.9,FALSE,1,TRUE,16646,18802,-1016,23.1
FALSE,FALSE,0,FALSE,15197,17692,-3960,22.3,TRUE,2,TRUE,19157,19138,3960,21.6
TRUE,TRUE,1,TRUE,17604,20758,2547,24.8,FALSE,0,FALSE,15057,17962,-2547,19.5
FALSE,FALSE,0,FALSE,17431,17722,-1294,20.2,TRUE,0,FALSE,18725,17989,1294,19.5
FALSE,FALSE,0,FALSE,14346,15676,-3886,20,TRUE,1,TRUE,18232,19129,3886,22
FALSE,TRUE,1,TRUE,17623,17787,3100,22.9,FALSE,0,FALSE,14523,16781,-3100,20.9
FALSE,FALSE,1,FALSE,18683,19031,1874,21.8,TRUE,1,TRUE,16809,17623,-1874,21.5
TRUE,FALSE,1,TRUE,15561,17448,246,22.6,TRUE,0,FALSE,15315,17997,-246,22.8
FALSE,TRUE,1,TRUE,18172,18893,-347,21.8,FALSE,0,FALSE,18519,18500,347,21.9
TRUE,FALSE,1,FALSE,16753,17350,1936,19,TRUE,1,TRUE,14817,15551,-1936,19
FALSE,FALSE,0,FALSE,15800,17954,-966,20.3,TRUE,0,FALSE,16766,17843,966,22
FALSE,FALSE,0,FALSE,13525,15625,-5423,21,TRUE,1,TRUE,18948,19744,5423,20.6
TRUE,FALSE,0,FALSE,16418,19182,1234,24.2,TRUE,2,TRUE,15184,18220,-1234,21.5
FALSE,FALSE,0,FALSE,14867,18057,-822,22.2,TRUE,0,FALSE,15689,18649,822,20.9
FALSE,FALSE,0,FALSE,14288,15711,-3358,23.7,TRUE,1,TRUE,17646,18548,3358,24
TRUE,FALSE,1,FALSE,16106,18229,-443,21.6,TRUE,1,TRUE,16549,17833,443,24
FALSE,TRUE,0,FALSE,16068,17309,-466,19.3,FALSE,0,FALSE,16534,16701,466,22.4
TRUE,FALSE,0,FALSE,16559,18024,-1192,20.8,TRUE,1,TRUE,17751,19920,1192,24.2
TRUE,FALSE,1,TRUE,16388,18495,178,25.6,TRUE,1,FALSE,16210,17613,-178,21.6
TRUE,TRUE,1,TRUE,15077,17523,-2035,20.8,FALSE,0,FALSE,17112,18760,2035,23.1
FALSE,FALSE,0,FALSE,15106,17144,-4579,23.7,TRUE,2,TRUE,19685,20505,4579,24.6
FALSE,FALSE,0,FALSE,16569,18534,77,22.8,TRUE,1,TRUE,16492,19409,-77,24.6
TRUE,FALSE,1,TRUE,16863,18740,296,22.7,TRUE,0,FALSE,16567,17370,-296,22.2
FALSE,TRUE,0,FALSE,16171,16252,-2171,16.6,FALSE,1,TRUE,18342,19149,2171,22
TRUE,TRUE,1,TRUE,17149,19250,3370,21.6,FALSE,0,FALSE,13779,16355,-3370,20.9
TRUE,TRUE,2,TRUE,16071,17618,1723,22.4,FALSE,0,FALSE,14348,16528,-1723,21
TRUE,TRUE,0,FALSE,18498,18641,2759,23.2,FALSE,1,TRUE,15739,17661,-2759,21.5
FALSE,TRUE,0,FALSE,14936,16574,-1703,22.5,FALSE,0,FALSE,16639,19124,1703,22.1
TRUE,TRUE,1,TRUE,18901,17651,2699,21,FALSE,0,FALSE,16202,16636,-2699,20.3
TRUE,TRUE,0,FALSE,16372,17187,2201,19.1,FALSE,0,FALSE,14171,16813,-2201,18.7
TRUE,TRUE,1,TRUE,17959,19184,3136,22.2,FALSE,0,FALSE,14823,17627,-3136,22.1
FALSE,FALSE,0,FALSE,13550,16368,-4982,19.4,TRUE,2,TRUE,18532,19736,4982,25.8
TRUE,FALSE,1,FALSE,15767,17903,-953,23.3,TRUE,0,FALSE,16720,18580,953,22.6
TRUE,TRUE,2,TRUE,17156,19115,777,23.5,FALSE,0,FALSE,16379,18138,-777,25.4
FALSE,FALSE,0,FALSE,13802,17008,-5571,20.2,TRUE,2,TRUE,19373,19147,5571,24.7
FALSE,TRUE,0,FALSE,15184,15748,-2098,19.9,FALSE,2,TRUE,17282,17212,2098,22
TRUE,TRUE,1,TRUE,15923,18062,1916,24.8,FALSE,1,FALSE,14007,16658,-1916,19.3
TRUE,TRUE,1,FALSE,15222,18238,712,22.8,FALSE,1,TRUE,14510,16605,-712,19.8
FALSE,FALSE,0,FALSE,14856,18155,-1129,24,TRUE,1,TRUE,15985,19503,1129,22.5
FALSE,FALSE,1,TRUE,15336,16676,-2735,18.7,TRUE,1,FALSE,18071,18812,2735,22.6
TRUE,FALSE,1,TRUE,18488,19504,3096,22.4,TRUE,0,FALSE,15392,17100,-3096,21
TRUE,FALSE,1,TRUE,15681,16896,-1058,20.5,TRUE,0,FALSE,16739,18300,1058,22.4
FALSE,TRUE,1,FALSE,17159,18318,1075,25,FALSE,1,TRUE,16084,17793,-1075,22.5
TRUE,FALSE,0,FALSE,15221,17841,-531,21.8,TRUE,1,TRUE,15752,17813,531,24
FALSE,TRUE,0,FALSE,16746,17772,409,18.8,FALSE,1,TRUE,16337,18064,-409,21.6
FALSE,TRUE,0,FALSE,18235,17856,517,22.9,FALSE,1,FALSE,17718,18007,-517,21.3
TRUE,TRUE,0,FALSE,16514,18012,-17,24.4,FALSE,1,TRUE,16531,18526,17,20.9
FALSE,TRUE,0,FALSE,17346,16570,1399,19.1,FALSE,0,FALSE,15947,15277,-1399,19.3
FALSE,TRUE,1,FALSE,14838,16485,-1278,20.8,FALSE,0,FALSE,16116,17872,1278,22.1
FALSE,FALSE,0,FALSE,14471,17643,-3385,20.8,TRUE,1,TRUE,17856,20424,3385,22.3
TRUE,TRUE,1,TRUE,16214,18849,136,22.5,FALSE,1,FALSE,16078,18484,-136,23.6
FALSE,FALSE,2,TRUE,17839,18405,1339,21.7,TRUE,0,FALSE,16500,17229,-1339,21.2
TRUE,TRUE,1,FALSE,17674,19752,2521,22.5,FALSE,0,FALSE,15153,16656,-2521,21.7
TRUE,TRUE,0,FALSE,19008,18920,4255,20.6,FALSE,0,FALSE,14753,16533,-4255,20.2
TRUE,FALSE,0,FALSE,15800,19395,-302,23.1,TRUE,0,FALSE,16102,18631,302,23.6
FALSE,FALSE,0,FALSE,16225,17831,-2741,20.3,TRUE,1,TRUE,18966,18256,2741,22
TRUE,TRUE,2,TRUE,18237,18102,3675,23,FALSE,0,FALSE,14562,15713,-3675,17
FALSE,FALSE,1,TRUE,16512,17751,46,22.5,TRUE,0,FALSE,16466,19050,-46,23.2
TRUE,TRUE,1,TRUE,17478,18671,1071,25.7,FALSE,1,FALSE,16407,18564,-1071,27.4
TRUE,FALSE,2,TRUE,15804,18768,-427,22.2,TRUE,0,FALSE,16231,17293,427,21.7
FALSE,FALSE,2,TRUE,16158,17789,1184,22.4,TRUE,0,FALSE,14974,15982,-1184,17.7
FALSE,FALSE,0,FALSE,15799,17703,56,22.5,TRUE,1,TRUE,15743,18397,-56,20.8
TRUE,FALSE,0,FALSE,18876,18843,2201,23.5,TRUE,1,TRUE,16675,18228,-2201,19.6
FALSE,TRUE,0,FALSE,15193,17619,-610,25.2,FALSE,1,TRUE,15803,18775,610,21.5
TRUE,TRUE,2,TRUE,19528,19755,3974,25.7,FALSE,0,FALSE,15554,16970,-3974,22
FALSE,FALSE,1,TRUE,17597,18452,118,24.4,TRUE,0,FALSE,17479,18153,-118,22.4
FALSE,FALSE,0,FALSE,16495,18518,955,23,TRUE,0,FALSE,15540,17770,-955,16.4
FALSE,TRUE,0,FALSE,16042,18424,-686,23.8,FALSE,2,TRUE,16728,19317,686,21.6
TRUE,FALSE,1,TRUE,15636,17293,-1086,22,TRUE,1,FALSE,16722,17930,1086,21.6
TRUE,TRUE,1,FALSE,19063,19391,2411,23.7,FALSE,1,TRUE,16652,18516,-2411,22.1
TRUE,TRUE,0,FALSE,18963,19079,5337,23.9,FALSE,1,TRUE,13626,15745,-5337,17.9
TRUE,TRUE,0,FALSE,18391,17080,2040,18.3,FALSE,1,FALSE,16351,16355,-2040,20.3
FALSE,FALSE,1,FALSE,15492,17768,-2139,24.5,TRUE,1,TRUE,17631,16900,2139,19.5
FALSE,TRUE,2,TRUE,16142,16958,-1231,23,FALSE,0,FALSE,17373,17846,1231,22.1
TRUE,FALSE,1,FALSE,16926,19020,1947,22.9,TRUE,1,TRUE,14979,17343,-1947,23
FALSE,TRUE,0,FALSE,15517,16917,653,23.1,FALSE,1,TRUE,14864,17473,-653,22.6
TRUE,TRUE,0,FALSE,16929,17547,-1149,22.8,FALSE,0,FALSE,18078,19435,1149,23.2
FALSE,FALSE,1,TRUE,15094,16864,-911,23.7,TRUE,0,FALSE,16005,17734,911,20.4
FALSE,FALSE,1,TRUE,14604,15280,-4752,14.6,TRUE,0,FALSE,19356,17731,4752,21
TRUE,TRUE,1,FALSE,15268,18685,296,26.9,FALSE,1,TRUE,14972,18245,-296,25.1
TRUE,FALSE,0,FALSE,16317,16936,1163,21,TRUE,1,TRUE,15154,17475,-1163,24.1
FALSE,FALSE,0,FALSE,15426,18766,-1672,21.2,TRUE,1,TRUE,17098,19236,1672,25.9
FALSE,FALSE,0,FALSE,14052,16542,-2502,22.9,TRUE,0,FALSE,16554,19725,2502,24.9
TRUE,FALSE,0,FALSE,15369,17402,-1833,20,TRUE,1,TRUE,17202,18319,1833,24.5
FALSE,TRUE,0,FALSE,16961,17237,531,19.1,FALSE,1,TRUE,16430,18118,-531,19.8
TRUE,TRUE,1,TRUE,18177,19922,3710,25.6,FALSE,0,FALSE,14467,17596,-3710,22.6
TRUE,FALSE,0,FALSE,17329,17577,675,22.3,TRUE,2,TRUE,16654,16886,-675,22.7
TRUE,TRUE,1,TRUE,19161,18599,2783,23.2,FALSE,0,FALSE,16378,16231,-2783,19.5
FALSE,FALSE,0,FALSE,14649,15693,-1945,20,TRUE,1,TRUE,16594,18189,1945,21.6
TRUE,FALSE,0,FALSE,15367,18723,183,23.8,TRUE,2,TRUE,15184,18954,-183,23.3
FALSE,TRUE,1,TRUE,16229,18834,960,24.7,FALSE,0,FALSE,15269,18021,-960,20.1
FALSE,TRUE,2,TRUE,17258,18225,1191,23.9,FALSE,0,FALSE,16067,18536,-1191,21.3
TRUE,TRUE,1,TRUE,22177,21202,8450,23,FALSE,1,FALSE,13727,15104,-8450,20.1
FALSE,FALSE,0,FALSE,18004,20025,-305,25.1,TRUE,1,TRUE,18309,19340,305,24.9
TRUE,TRUE,2,TRUE,20567,19536,6487,22.1,FALSE,0,FALSE,14080,15518,-6487,19.7
FALSE,FALSE,0,FALSE,16650,17869,-1213,21.2,TRUE,1,TRUE,17863,18968,1213,22.9
FALSE,FALSE,0,FALSE,14710,17302,-3673,23.1,TRUE,2,TRUE,18383,19801,3673,22.5
FALSE,FALSE,0,FALSE,15442,17224,-2109,23.7,TRUE,1,TRUE,17551,18699,2109,23.3
FALSE,FALSE,0,FALSE,18923,20387,1219,24.1,TRUE,1,TRUE,17704,19031,-1219,20.7
FALSE,TRUE,0,FALSE,14783,15957,-1905,20.6,FALSE,1,TRUE,16688,18180,1905,22.4
TRUE,FALSE,0,FALSE,18074,16950,2170,21.1,TRUE,1,TRUE,15904,15743,-2170,18.8
TRUE,FALSE,1,TRUE,17684,19834,620,22.4,TRUE,1,FALSE,17064,19688,-620,19.7
FALSE,FALSE,0,FALSE,15476,16908,-1972,18.4,TRUE,2,TRUE,17448,18529,1972,21.3
FALSE,TRUE,2,TRUE,17622,19988,1530,25.2,FALSE,0,FALSE,16092,17768,-1530,23.9
TRUE,TRUE,1,TRUE,16385,16580,1163,20.8,FALSE,1,FALSE,15222,17756,-1163,19.4
FALSE,FALSE,0,FALSE,14425,16191,-2619,19.8,TRUE,1,TRUE,17044,17697,2619,21.2
TRUE,TRUE,0,FALSE,16059,18356,584,21.2,FALSE,0,FALSE,15475,17333,-584,20.7
TRUE,TRUE,0,FALSE,18633,18698,2910,24.6,FALSE,1,TRUE,15723,17842,-2910,22.6
FALSE,FALSE,0,FALSE,15731,17150,-1057,25.1,TRUE,1,TRUE,16788,18948,1057,22
TRUE,TRUE,0,FALSE,17371,18243,-50,22.7,FALSE,1,TRUE,17421,17680,50,22.2
FALSE,TRUE,0,FALSE,15631,15075,-2084,19.9,FALSE,2,TRUE,17715,17100,2084,16.5
TRUE,FALSE,0,FALSE,16935,18740,469,21,TRUE,0,FALSE,16466,17412,-469,21.2
TRUE,FALSE,0,FALSE,16639,18068,-293,21.4,TRUE,1,TRUE,16932,18886,293,23.2
TRUE,FALSE,0,FALSE,16738,19318,1031,21.9,TRUE,1,TRUE,15707,17409,-1031,21.8
FALSE,TRUE,0,FALSE,15419,18138,-726,25.1,FALSE,2,TRUE,16145,19306,726,23.6
TRUE,FALSE,2,TRUE,14752,16831,-2511,20.9,TRUE,0,FALSE,17263,18925,2511,24.2
FALSE,TRUE,0,FALSE,16508,18227,489,20.4,FALSE,1,FALSE,16019,19390,-489,23.5
FALSE,FALSE,0,FALSE,16544,16885,-999,22.3,TRUE,1,TRUE,17543,17840,999,22.1
TRUE,FALSE,0,FALSE,15597,18695,-1366,23.8,TRUE,1,TRUE,16963,18937,1366,26.6
FALSE,TRUE,1,TRUE,18022,18610,2958,24.2,FALSE,0,FALSE,15064,17627,-2958,22.6
FALSE,TRUE,1,TRUE,15714,17362,-3095,20.8,FALSE,0,FALSE,18809,19562,3095,24.4
FALSE,FALSE,0,FALSE,16219,17966,709,19.7,TRUE,1,TRUE,15510,16517,-709,19.9
FALSE,FALSE,0,FALSE,16956,17632,-540,21.9,TRUE,0,FALSE,17496,17394,540,20.5
TRUE,TRUE,1,TRUE,19280,20813,5041,25.2,FALSE,0,FALSE,14239,16817,-5041,21.5
TRUE,FALSE,0,FALSE,19540,18969,1714,24.7,TRUE,1,FALSE,17826,17482,-1714,21.1
TRUE,FALSE,0,FALSE,16038,19227,-844,22.8,TRUE,1,TRUE,16882,19088,844,22.6
TRUE,TRUE,1,TRUE,16594,20008,1737,22.7,FALSE,0,FALSE,14857,18443,-1737,21.7
TRUE,FALSE,0,FALSE,16040,17545,109,21.4,TRUE,1,TRUE,15931,17479,-109,22.1
TRUE,TRUE,1,TRUE,16282,16565,686,21.1,FALSE,1,FALSE,15596,16654,-686,18
FALSE,FALSE,0,FALSE,15527,17554,-1537,20.2,TRUE,2,TRUE,17064,17461,1537,21.6
FALSE,FALSE,0,FALSE,15933,16916,-1790,22.1,TRUE,1,TRUE,17723,18896,1790,22.3
FALSE,FALSE,0,FALSE,17070,17907,1044,20.8,TRUE,0,FALSE,16026,17245,-1044,20.8
FALSE,FALSE,0,FALSE,15084,19173,-1302,22.4,TRUE,1,TRUE,16386,18165,1302,22.6
FALSE,FALSE,0,FALSE,16600,18932,1627,19.2,TRUE,1,TRUE,14973,17209,-1627,19.4
TRUE,FALSE,0,FALSE,15982,18257,-2221,18.6,TRUE,0,FALSE,18203,18622,2221,21.9
TRUE,FALSE,0,FALSE,16355,17606,-1874,22.1,TRUE,1,FALSE,18229,18608,1874,20.5
TRUE,TRUE,0,FALSE,17040,17805,-545,21.5,FALSE,1,TRUE,17585,18907,545,21.4
TRUE,TRUE,1,TRUE,16737,17593,2423,24.3,FALSE,1,FALSE,14314,17298,-2423,23.2
FALSE,FALSE,1,TRUE,17090,18662,-2001,22.2,TRUE,0,FALSE,19091,19799,2001,21.7
FALSE,TRUE,0,FALSE,14689,14871,-7206,16.8,FALSE,1,TRUE,21895,20917,7206,27.9
TRUE,TRUE,0,FALSE,16135,17313,494,19.6,FALSE,0,FALSE,15641,18651,-494,21.4
FALSE,FALSE,1,FALSE,16500,18497,496,20.2,TRUE,1,TRUE,16004,16967,-496,22.2
FALSE,TRUE,0,FALSE,17318,18742,568,23.7,FALSE,2,TRUE,16750,18947,-568,20.2
TRUE,TRUE,0,FALSE,18202,18332,3424,23.2,FALSE,1,TRUE,14778,16708,-3424,22.8
FALSE,FALSE,1,TRUE,17208,19055,549,26,TRUE,0,FALSE,16659,18626,-549,25.8
FALSE,FALSE,1,TRUE,16496,18200,1506,25.1,TRUE,1,FALSE,14990,18369,-1506,22.4
TRUE,TRUE,0,FALSE,17915,19494,2833,22.2,FALSE,0,FALSE,15082,16319,-2833,20.6
FALSE,FALSE,0,FALSE,18917,18476,773,21,TRUE,1,TRUE,18144,17351,-773,20.7
FALSE,FALSE,1,TRUE,16484,16372,-2146,17.6,TRUE,0,FALSE,18630,19617,2146,20.4
FALSE,TRUE,1,TRUE,19402,18727,2399,21.3,FALSE,0,FALSE,17003,17008,-2399,21.2
FALSE,TRUE,2,TRUE,15869,18711,453,24.9,FALSE,0,FALSE,15416,18635,-453,26.5
TRUE,TRUE,1,FALSE,17338,19907,2533,25.6,FALSE,0,FALSE,14805,18339,-2533,24.2
TRUE,TRUE,0,FALSE,18849,19281,5077,23.1,FALSE,0,FALSE,13772,16030,-5077,22.4
FALSE,FALSE,0,FALSE,15250,15780,-4699,18.3,TRUE,1,TRUE,19949,20360,4699,23.7
FALSE,FALSE,0,FALSE,15210,16010,-2161,20.7,TRUE,2,TRUE,17371,19232,2161,21.4
TRUE,FALSE,0,FALSE,16692,17643,-795,18.1,TRUE,0,FALSE,17487,17760,795,22.2
TRUE,TRUE,0,FALSE,16621,18305,875,25.5,FALSE,0,FALSE,15746,18696,-875,23.8
FALSE,FALSE,1,TRUE,15698,18184,-1556,22.6,TRUE,0,FALSE,17254,19071,1556,23.7
FALSE,FALSE,1,FALSE,14593,16673,-4019,19.9,TRUE,1,TRUE,18612,18681,4019,23.2
TRUE,TRUE,0,FALSE,16712,16923,-609,22.1,FALSE,1,TRUE,17321,18037,609,22.9
FALSE,FALSE,0,FALSE,16837,17911,-2152,19.1,TRUE,2,TRUE,18989,19952,2152,23.7
FALSE,FALSE,1,TRUE,15514,18547,-1509,20,TRUE,0,FALSE,17023,18905,1509,25.9
TRUE,TRUE,0,FALSE,17236,19937,-308,23.5,FALSE,1,TRUE,17544,18198,308,22
FALSE,FALSE,0,FALSE,16204,17704,-4473,18.2,TRUE,1,TRUE,20677,20744,4473,23.7
TRUE,TRUE,0,FALSE,18422,18184,2991,21.9,FALSE,0,FALSE,15431,16827,-2991,20
FALSE,FALSE,0,FALSE,15356,16700,-2416,20.7,TRUE,0,FALSE,17772,19917,2416,23.9
FALSE,TRUE,0,FALSE,14848,17467,-132,20.5,FALSE,1,TRUE,14980,17348,132,21.3
TRUE,FALSE,0,FALSE,15688,18341,91,23.7,TRUE,0,FALSE,15597,17750,-91,23.9
TRUE,TRUE,0,FALSE,14926,19450,-842,20.3,FALSE,1,FALSE,15768,17418,842,24.3
FALSE,FALSE,0,FALSE,16190,16496,-2302,20.7,TRUE,0,FALSE,18492,17493,2302,17.3
TRUE,TRUE,1,TRUE,16318,18426,2463,22.6,FALSE,0,FALSE,13855,17036,-2463,20
FALSE,FALSE,0,FALSE,15376,16758,-4264,19.6,TRUE,2,TRUE,19640,20690,4264,26.2
FALSE,FALSE,0,FALSE,14666,16186,-3480,23.3,TRUE,1,TRUE,18146,17554,3480,19.3
TRUE,FALSE,1,TRUE,16301,18968,-1207,23.5,TRUE,0,FALSE,17508,18362,1207,23
FALSE,FALSE,0,FALSE,15124,17488,-4664,21.3,TRUE,2,TRUE,19788,20195,4664,24.9
TRUE,TRUE,2,TRUE,19031,20293,4888,21.2,FALSE,0,FALSE,14143,16540,-4888,18.2
TRUE,TRUE,0,FALSE,18581,19012,1433,23.9,FALSE,1,TRUE,17148,18504,-1433,21.8
FALSE,FALSE,2,TRUE,17144,18638,1713,23,TRUE,0,FALSE,15431,16965,-1713,21.6
FALSE,FALSE,2,TRUE,18368,19062,-328,20.4,TRUE,0,FALSE,18696,18925,328,23
TRUE,FALSE,1,TRUE,16844,18805,2726,24.3,TRUE,0,FALSE,14118,16815,-2726,21
FALSE,FALSE,0,FALSE,16707,16612,-648,20.4,TRUE,1,TRUE,17355,18034,648,19.3
TRUE,FALSE,2,TRUE,17868,17858,-286,17.7,TRUE,0,FALSE,18154,18774,286,24.7
TRUE,TRUE,0,FALSE,20043,21800,5300,26.4,FALSE,1,FALSE,14743,16987,-5300,23
FALSE,TRUE,0,FALSE,14852,16246,-4835,19.4,FALSE,1,TRUE,19687,19901,4835,19.5
FALSE,TRUE,0,FALSE,16302,15434,-592,18.3,FALSE,0,FALSE,16894,17872,592,21.6
TRUE,TRUE,0,FALSE,23359,20348,7776,23.7,FALSE,0,FALSE,15583,13645,-7776,13.4
TRUE,FALSE,1,TRUE,18352,18953,1909,24.2,TRUE,0,FALSE,16443,17854,-1909,22.5
TRUE,TRUE,1,FALSE,16873,17662,1942,24,FALSE,0,FALSE,14931,17212,-1942,16.8
FALSE,FALSE,0,FALSE,16949,18440,16,23.6,TRUE,2,TRUE,16933,17880,-16,23.2
TRUE,FALSE,0,FALSE,16344,19207,-860,23,TRUE,1,TRUE,17204,18258,860,20.2
FALSE,FALSE,0,FALSE,15268,17072,-2308,21.1,TRUE,1,TRUE,17576,19018,2308,26.3
TRUE,FALSE,1,FALSE,16463,16544,-460,18.6,TRUE,0,FALSE,16923,17733,460,23.8
TRUE,FALSE,0,FALSE,17049,17357,799,22.1,TRUE,1,FALSE,16250,16917,-799,21.5
TRUE,TRUE,1,TRUE,15811,18673,886,24.2,FALSE,0,FALSE,14925,18318,-886,23.6
FALSE,FALSE,0,FALSE,14109,16353,-3300,20.5,TRUE,0,FALSE,17409,19671,3300,23.1
FALSE,FALSE,0,FALSE,12292,13648,-9341,15.2,TRUE,1,FALSE,21633,19965,9341,23.9
TRUE,TRUE,1,TRUE,18487,18183,3851,21.1,FALSE,0,FALSE,14636,16609,-3851,21.1
FALSE,FALSE,1,TRUE,16860,18713,-147,19.8,TRUE,0,FALSE,17007,18692,147,25.7
TRUE,TRUE,1,FALSE,17798,19047,1698,22.2,FALSE,0,FALSE,16100,17876,-1698,24.1
FALSE,FALSE,0,FALSE,15789,17312,-966,23,TRUE,1,TRUE,16755,18213,966,23.1
FALSE,FALSE,1,TRUE,19609,17551,3454,20.7,TRUE,0,FALSE,16155,17376,-3454,20.1
FALSE,FALSE,1,FALSE,14853,16170,-2673,17.4,TRUE,1,TRUE,17526,18037,2673,24.6
FALSE,FALSE,0,FALSE,15369,17785,-482,22.1,TRUE,1,TRUE,15851,18134,482,25.7
TRUE,TRUE,0,FALSE,17053,18362,-298,21.9,FALSE,1,TRUE,17351,18362,298,21.3
TRUE,TRUE,1,TRUE,17307,16527,-224,16.1,FALSE,0,FALSE,17531,17292,224,21
FALSE,TRUE,0,FALSE,14881,15603,-1683,19.5,FALSE,1,TRUE,16564,15980,1683,18.5
TRUE,FALSE,0,FALSE,17928,20419,2514,25,TRUE,0,FALSE,15414,17495,-2514,18
FALSE,FALSE,1,TRUE,14876,17630,81,22.1,TRUE,1,FALSE,14795,17180,-81,21.8
TRUE,FALSE,1,TRUE,15356,18787,420,21.2,TRUE,0,FALSE,14936,18266,-420,23
TRUE,FALSE,1,FALSE,16122,18226,-1167,16.8,TRUE,0,FALSE,17289,17967,1167,21
TRUE,FALSE,1,FALSE,15426,17981,-99,21.1,TRUE,1,TRUE,15525,17830,99,23
TRUE,TRUE,0,FALSE,16448,19097,387,21.6,FALSE,0,FALSE,16061,17316,-387,21
FALSE,FALSE,0,FALSE,14182,16753,-1700,22,TRUE,0,FALSE,15882,17806,1700,22.3
TRUE,FALSE,1,FALSE,15891,19024,-820,20,TRUE,1,TRUE,16711,19322,820,21.4
TRUE,FALSE,1,FALSE,15858,16120,-3945,21.9,TRUE,1,TRUE,19803,17878,3945,19.6
FALSE,FALSE,1,FALSE,14949,16818,-3238,18,TRUE,1,TRUE,18187,17948,3238,25.9
FALSE,TRUE,1,TRUE,14377,17055,-2511,21,FALSE,0,FALSE,16888,19402,2511,24.9
FALSE,TRUE,1,TRUE,15946,18587,1433,22.3,FALSE,0,FALSE,14513,17309,-1433,18.3
FALSE,TRUE,0,FALSE,15584,17939,-1037,23.4,FALSE,0,FALSE,16621,18996,1037,22.2
TRUE,FALSE,1,TRUE,15800,18316,1344,24.4,TRUE,0,FALSE,14456,16688,-1344,21
FALSE,FALSE,2,TRUE,16210,18620,-245,23.1,TRUE,0,FALSE,16455,18290,245,22
TRUE,TRUE,1,TRUE,20587,19713,5920,22.9,FALSE,0,FALSE,14667,17010,-5920,16.8
TRUE,TRUE,1,TRUE,15735,18331,539,23.3,FALSE,0,FALSE,15196,17557,-539,22
FALSE,TRUE,0,FALSE,17378,18525,708,24.2,FALSE,0,FALSE,16670,18223,-708,23.5
FALSE,FALSE,0,FALSE,17993,16834,2876,22.2,TRUE,0,FALSE,15117,14029,-2876,18
TRUE,TRUE,0,FALSE,16072,16945,-184,23.6,FALSE,0,FALSE,16256,16537,184,19.5
FALSE,FALSE,1,TRUE,15557,18380,-101,25.1,TRUE,0,FALSE,15658,18760,101,21
FALSE,FALSE,0,FALSE,14467,16331,-5563,20.9,TRUE,2,TRUE,20030,21029,5563,23.5
TRUE,TRUE,1,TRUE,16096,15907,-447,19.7,FALSE,0,FALSE,16543,18034,447,19.3
TRUE,TRUE,1,TRUE,16351,17063,1487,17.1,FALSE,0,FALSE,14864,15920,-1487,22.4
TRUE,FALSE,1,TRUE,16538,18735,1126,22.7,TRUE,1,FALSE,15412,17857,-1126,22.5
TRUE,FALSE,0,FALSE,16337,19371,1795,25.9,TRUE,0,FALSE,14542,17438,-1795,23.8
TRUE,TRUE,1,TRUE,17519,17753,4216,20.9,FALSE,0,FALSE,13303,15612,-4216,19.7
FALSE,TRUE,1,TRUE,14305,17323,-1517,21.4,FALSE,1,FALSE,15822,18295,1517,22.5
FALSE,FALSE,0,FALSE,18279,18909,1236,17.4,TRUE,2,TRUE,17043,18760,-1236,22.4
TRUE,TRUE,2,TRUE,17808,18545,2489,24.6,FALSE,0,FALSE,15319,17072,-2489,19.1
FALSE,TRUE,1,FALSE,17360,19151,1259,25,FALSE,1,TRUE,16101,17870,-1259,20.1
TRUE,TRUE,1,FALSE,18849,19086,3281,22,FALSE,1,TRUE,15568,17339,-3281,20.2
FALSE,FALSE,0,FALSE,15641,17857,-1136,24.4,TRUE,1,TRUE,16777,19092,1136,23.4
FALSE,FALSE,0,FALSE,13408,15571,-5838,18.5,TRUE,1,TRUE,19246,19672,5838,25.5
TRUE,TRUE,0,FALSE,19366,18628,1973,22.9,FALSE,1,TRUE,17393,17167,-1973,16.4
FALSE,TRUE,1,TRUE,16646,16213,592,20.4,FALSE,0,FALSE,16054,17088,-592,20.4
FALSE,TRUE,1,TRUE,15009,17067,-2492,20.7,FALSE,0,FALSE,17501,18593,2492,20.4
FALSE,TRUE,1,TRUE,15921,17353,-1490,21,FALSE,0,FALSE,17411,18977,1490,21.5
TRUE,TRUE,1,TRUE,18012,16748,2957,21,FALSE,0,FALSE,15055,14199,-2957,17.7
FALSE,FALSE,1,TRUE,15224,16423,-4927,20.3,TRUE,0,FALSE,20151,21639,4927,23.1
FALSE,FALSE,0,FALSE,15484,16418,-4879,16.5,TRUE,1,TRUE,20363,19883,4879,25
TRUE,TRUE,2,TRUE,15550,18425,-424,24.9,FALSE,0,FALSE,15974,19500,424,24.5
FALSE,TRUE,0,FALSE,15895,17705,-1018,22.5,FALSE,1,TRUE,16913,19236,1018,23.2
TRUE,TRUE,1,FALSE,16776,18113,907,20.7,FALSE,1,TRUE,15869,18199,-907,22.8
FALSE,FALSE,0,FALSE,13444,16544,-3445,19.7,TRUE,0,FALSE,16889,18559,3445,24.6
TRUE,FALSE,0,FALSE,17971,18271,152,16.2,TRUE,0,FALSE,17819,18757,-152,19.2
FALSE,FALSE,0,FALSE,12959,15381,-4456,17.2,TRUE,0,FALSE,17415,17717,4456,19.6
TRUE,TRUE,0,FALSE,17225,17613,69,21.7,FALSE,0,FALSE,17156,17845,-69,21
FALSE,TRUE,0,FALSE,17848,19890,868,21.2,FALSE,1,TRUE,16980,18162,-868,21.6
FALSE,FALSE,1,FALSE,15448,18033,209,21.5,TRUE,0,FALSE,15239,17010,-209,22.4
FALSE,TRUE,1,TRUE,15425,17540,-1611,20.8,FALSE,0,FALSE,17036,19471,1611,24.6
TRUE,TRUE,1,TRUE,15717,17819,385,21.1,FALSE,0,FALSE,15332,17890,-385,23.1
FALSE,FALSE,0,FALSE,14589,15373,-3750,19.5,TRUE,1,TRUE,18339,20334,3750,22.9
TRUE,TRUE,0,FALSE,15463,18378,25,21.5,FALSE,0,FALSE,15438,18051,-25,21.5
FALSE,FALSE,1,TRUE,16019,16667,-388,17.4,TRUE,0,FALSE,16407,17286,388,20.7
TRUE,TRUE,0,FALSE,17634,17330,1930,21.9,FALSE,0,FALSE,15704,16905,-1930,22.6
FALSE,TRUE,0,FALSE,16017,15395,517,15.7,FALSE,0,FALSE,15500,15988,-517,17
TRUE,TRUE,2,TRUE,17259,19074,-214,23.6,FALSE,0,FALSE,17473,18070,214,22.5
TRUE,FALSE,1,TRUE,16226,18917,2229,25,TRUE,0,FALSE,13997,16066,-2229,19.7
FALSE,TRUE,2,TRUE,17816,18684,1953,20.2,FALSE,0,FALSE,15863,17190,-1953,22.4
FALSE,FALSE,0,FALSE,15532,18026,-781,21,TRUE,2,TRUE,16313,19322,781,22
TRUE,FALSE,0,FALSE,16946,17971,380,21.7,TRUE,2,TRUE,16566,16221,-380,23
FALSE,FALSE,0,FALSE,16019,18530,-758,22.2,TRUE,0,FALSE,16777,17797,758,21.5
TRUE,FALSE,0,FALSE,17938,18237,3072,23.2,TRUE,1,TRUE,14866,16648,-3072,20.7
TRUE,FALSE,1,FALSE,17512,18140,2549,18.6,TRUE,1,TRUE,14963,16871,-2549,17.4
TRUE,TRUE,2,TRUE,16712,17310,2427,20.8,FALSE,0,FALSE,14285,15007,-2427,17.2
FALSE,FALSE,1,FALSE,15913,17592,-844,20.2,TRUE,1,TRUE,16757,18281,844,24.7
FALSE,TRUE,1,TRUE,17108,17877,-1394,21.1,FALSE,0,FALSE,18502,20135,1394,21
TRUE,TRUE,2,TRUE,23349,21214,7128,22.3,FALSE,0,FALSE,16221,15097,-7128,14
FALSE,TRUE,2,TRUE,15548,18820,-826,22.9,FALSE,0,FALSE,16374,18782,826,22.5
FALSE,FALSE,1,TRUE,15950,18633,1233,24.7,TRUE,0,FALSE,14717,18382,-1233,20.4
TRUE,TRUE,1,FALSE,16014,18969,476,22.5,FALSE,0,FALSE,15538,18502,-476,25.7
FALSE,FALSE,1,TRUE,17419,17316,-2587,17.8,TRUE,0,FALSE,20006,18786,2587,21.4
FALSE,TRUE,0,FALSE,19979,18500,3763,20.7,FALSE,0,FALSE,16216,17626,-3763,19.4
FALSE,FALSE,1,TRUE,14122,15708,-2968,18.8,TRUE,0,FALSE,17090,17867,2968,18.2
TRUE,TRUE,0,FALSE,17447,16191,-384,17.3,FALSE,0,FALSE,17831,17849,384,20.8
FALSE,FALSE,0,FALSE,16122,17858,-1673,19.6,TRUE,0,FALSE,17795,18185,1673,23.1
FALSE,TRUE,0,FALSE,18336,17626,-466,17.9,FALSE,0,FALSE,18802,17652,466,21.1
FALSE,FALSE,0,FALSE,12002,13961,-8461,15.1,TRUE,0,FALSE,20463,21301,8461,23.8
FALSE,TRUE,0,FALSE,14378,16230,-3682,20.9,FALSE,2,TRUE,18060,19829,3682,24.5
FALSE,TRUE,0,FALSE,17691,18548,3544,22.2,FALSE,0,FALSE,14147,16149,-3544,18.4
TRUE,TRUE,0,FALSE,19402,18717,2008,19.5,FALSE,0,FALSE,17394,16151,-2008,18
TRUE,TRUE,0,FALSE,16468,18574,3100,24.9,FALSE,0,FALSE,13368,16921,-3100,19.2
FALSE,FALSE,0,FALSE,14486,15896,-3576,20.7,TRUE,1,FALSE,18062,19412,3576,20.5
TRUE,FALSE,0,FALSE,17652,18869,775,22.5,TRUE,1,FALSE,16877,17167,-775,21
TRUE,TRUE,1,TRUE,15494,15724,1515,16.5,FALSE,0,FALSE,13979,14867,-1515,18.6
FALSE,TRUE,0,FALSE,16270,17661,-82,20,FALSE,1,TRUE,16352,17544,82,22.1
FALSE,TRUE,0,FALSE,15899,17722,-903,23.2,FALSE,1,TRUE,16802,19306,903,24.9
FALSE,FALSE,0,FALSE,14277,17550,-5802,20.1,TRUE,1,TRUE,20079,21109,5802,24
TRUE,FALSE,0,FALSE,17350,18857,1492,20.2,TRUE,1,TRUE,15858,17250,-1492,19.1
TRUE,TRUE,0,FALSE,18315,18534,246,20.9,FALSE,1,TRUE,18069,17268,-246,20.8
TRUE,TRUE,0,FALSE,19570,21203,4826,25.9,FALSE,1,TRUE,14744,16731,-4826,22.9
TRUE,TRUE,0,FALSE,16529,16649,1085,19.8,FALSE,1,TRUE,15444,15874,-1085,17.9
TRUE,TRUE,1,TRUE,18324,18016,2158,20.5,FALSE,0,FALSE,16166,17376,-2158,21.9
TRUE,TRUE,0,FALSE,17263,19913,3181,23.4,FALSE,2,TRUE,14082,16615,-3181,15.9
TRUE,TRUE,1,TRUE,15282,17848,1629,21.1,FALSE,0,FALSE,13653,17171,-1629,24.6
FALSE,FALSE,0,FALSE,15960,18478,782,23.2,TRUE,1,TRUE,15178,16575,-782,21.1
FALSE,TRUE,1,TRUE,15103,17162,-1328,19.8,FALSE,1,FALSE,16431,17479,1328,22.7
TRUE,FALSE,0,FALSE,16060,18431,794,22.8,TRUE,0,FALSE,15266,17854,-794,21.3
FALSE,FALSE,0,FALSE,15463,17772,-2809,16.2,TRUE,1,TRUE,18272,19445,2809,21.9
FALSE,FALSE,0,FALSE,17225,16572,-833,21,TRUE,1,FALSE,18058,18358,833,22
FALSE,FALSE,0,FALSE,14861,16993,-3337,22.5,TRUE,0,FALSE,18198,18694,3337,22.3
TRUE,FALSE,1,TRUE,15966,18955,1532,22.9,TRUE,0,FALSE,14434,17502,-1532,22.9
FALSE,TRUE,0,FALSE,15172,18276,-1066,20.5,FALSE,1,TRUE,16238,18266,1066,24.1
TRUE,FALSE,0,FALSE,15953,17960,-477,26,TRUE,0,FALSE,16430,18473,477,23.4
TRUE,FALSE,0,FALSE,17959,20494,1696,23.9,TRUE,1,TRUE,16263,18228,-1696,22.5
TRUE,TRUE,2,TRUE,17176,18575,2889,20,FALSE,0,FALSE,14287,17360,-2889,21.7
TRUE,TRUE,1,FALSE,17328,18867,2156,23.4,FALSE,0,FALSE,15172,15710,-2156,22.5
FALSE,FALSE,0,FALSE,15144,17995,-1281,23.6,TRUE,0,FALSE,16425,18597,1281,21.9
FALSE,FALSE,1,FALSE,16533,18187,85,21.7,TRUE,0,FALSE,16448,17422,-85,21.4
FALSE,TRUE,0,FALSE,18475,19732,1761,19.6,FALSE,1,TRUE,16714,17837,-1761,19.6
FALSE,FALSE,1,TRUE,15252,18024,-1293,22.4,TRUE,0,FALSE,16545,18404,1293,21.9
TRUE,FALSE,0,FALSE,14621,17862,-3644,17.9,TRUE,1,TRUE,18265,19139,3644,24.3
FALSE,FALSE,0,FALSE,15953,17372,-1095,22.1,TRUE,1,TRUE,17048,17621,1095,21.8
TRUE,TRUE,2,TRUE,16627,18676,2359,22.3,FALSE,0,FALSE,14268,16995,-2359,22.1
TRUE,TRUE,0,FALSE,17240,18845,699,24.8,FALSE,1,TRUE,16541,17901,-699,17.9
FALSE,FALSE,0,FALSE,15796,18152,453,22.1,TRUE,1,TRUE,15343,16726,-453,25.6
TRUE,TRUE,0,FALSE,18330,19257,1769,23.2,FALSE,2,TRUE,16561,18938,-1769,25.1
FALSE,TRUE,1,TRUE,15684,17219,-3240,20.2,FALSE,1,FALSE,18924,19615,3240,25.7
TRUE,TRUE,1,TRUE,17120,18300,1936,23.3,FALSE,0,FALSE,15184,17202,-1936,20.6
TRUE,TRUE,1,TRUE,15261,17058,-393,23.3,FALSE,0,FALSE,15654,18562,393,20.8
FALSE,FALSE,1,FALSE,18053,17357,620,18.9,TRUE,0,FALSE,17433,17018,-620,19.6
FALSE,TRUE,1,FALSE,15417,16990,-691,22.4,FALSE,1,TRUE,16108,17656,691,21.3
TRUE,TRUE,1,TRUE,16523,18718,1357,19.3,FALSE,0,FALSE,15166,18104,-1357,20.8
FALSE,TRUE,1,TRUE,16809,18470,-12,21,FALSE,0,FALSE,16821,18621,12,22.1
FALSE,TRUE,0,FALSE,15627,17457,-2690,19.9,FALSE,2,TRUE,18317,20702,2690,23
FALSE,FALSE,1,FALSE,13793,17022,-2240,22.3,TRUE,1,TRUE,16033,18645,2240,24.7
TRUE,TRUE,0,FALSE,14481,15768,-2765,21.4,FALSE,2,TRUE,17246,18042,2765,22.6
FALSE,TRUE,1,TRUE,16357,17543,-82,19.6,FALSE,0,FALSE,16439,17263,82,24.1
TRUE,FALSE,0,FALSE,18582,19549,2230,22.2,TRUE,1,FALSE,16352,17437,-2230,19.6
FALSE,FALSE,0,FALSE,13943,17418,-1661,23.5,TRUE,0,FALSE,15604,18482,1661,24.1
FALSE,TRUE,0,FALSE,18410,19835,1720,24.1,FALSE,0,FALSE,16690,18471,-1720,21.2
FALSE,FALSE,0,FALSE,16689,18369,211,24,TRUE,0,FALSE,16478,17489,-211,21.4
FALSE,TRUE,0,FALSE,16060,16764,-27,20,FALSE,1,TRUE,16087,18611,27,19.4
FALSE,FALSE,0,FALSE,14035,14801,-5142,18.5,TRUE,1,TRUE,19177,17824,5142,21
TRUE,TRUE,2,TRUE,17757,18305,1818,21.8,FALSE,0,FALSE,15939,16544,-1818,20.4
FALSE,FALSE,0,FALSE,14267,16538,-5571,20.4,TRUE,2,TRUE,19838,20459,5571,26.8
FALSE,FALSE,0,FALSE,15951,16512,-1734,22.3,TRUE,2,TRUE,17685,20208,1734,22.1
FALSE,TRUE,0,FALSE,16688,17926,704,21.6,FALSE,1,TRUE,15984,18049,-704,19
FALSE,FALSE,2,TRUE,14303,15787,-2657,18.7,TRUE,0,FALSE,16960,17882,2657,23.7
TRUE,TRUE,1,TRUE,17396,17804,-377,20.5,FALSE,1,FALSE,17773,16962,377,22.3
TRUE,TRUE,1,FALSE,18159,19769,3037,24.5,FALSE,1,TRUE,15122,17092,-3037,21.3
FALSE,FALSE,1,FALSE,16269,18306,459,20.2,TRUE,1,TRUE,15810,16918,-459,21.2
TRUE,TRUE,1,TRUE,15316,17118,-2986,19.8,FALSE,0,FALSE,18302,20487,2986,24.7
TRUE,TRUE,1,TRUE,16498,17738,1699,23.7,FALSE,0,FALSE,14799,17100,-1699,20.2
TRUE,TRUE,1,TRUE,20603,20443,7873,24.5,FALSE,0,FALSE,12730,15218,-7873,18.8
TRUE,FALSE,1,FALSE,19606,18619,3534,22,TRUE,1,TRUE,16072,16274,-3534,17
TRUE,TRUE,1,FALSE,16940,17305,400,23.4,FALSE,1,TRUE,16540,17518,-400,22.2
TRUE,FALSE,0,FALSE,16814,18612,2247,23.8,TRUE,1,TRUE,14567,17350,-2247,22
TRUE,TRUE,1,FALSE,18146,17263,383,19.9,FALSE,0,FALSE,17763,18918,-383,20.1
FALSE,FALSE,0,FALSE,15242,17856,-774,21.6,TRUE,0,FALSE,16016,17522,774,24.3
FALSE,TRUE,1,TRUE,17454,18029,617,20.4,FALSE,0,FALSE,16837,17901,-617,17.8
FALSE,TRUE,1,TRUE,16053,17817,1614,22.7,FALSE,0,FALSE,14439,16638,-1614,20.6
TRUE,TRUE,0,FALSE,14975,16649,-2206,22.2,FALSE,1,TRUE,17181,19197,2206,21.6
TRUE,TRUE,1,TRUE,16095,18669,-262,24.1,FALSE,0,FALSE,16357,19044,262,25.7
TRUE,FALSE,0,FALSE,17123,17944,1012,22.3,TRUE,0,FALSE,16111,18564,-1012,22
FALSE,TRUE,1,TRUE,16986,17323,313,23.1,FALSE,1,FALSE,16673,19099,-313,23.6
FALSE,FALSE,0,FALSE,14731,17886,-1148,20.4,TRUE,1,TRUE,15879,17178,1148,23.7
TRUE,TRUE,1,TRUE,17316,18689,3172,22.7,FALSE,0,FALSE,14144,15892,-3172,20
TRUE,FALSE,0,FALSE,14889,17345,-819,25.6,TRUE,0,FALSE,15708,19054,819,24.6
FALSE,FALSE,1,FALSE,16416,18647,-205,25.3,TRUE,1,TRUE,16621,18688,205,23.9
TRUE,FALSE,0,FALSE,16943,17177,-1228,21.5,TRUE,1,TRUE,18171,18962,1228,21.7
TRUE,TRUE,1,FALSE,19940,20030,5521,19.2,FALSE,0,FALSE,14419,15595,-5521,21.2
FALSE,TRUE,0,FALSE,16204,17473,-1016,18.4,FALSE,1,TRUE,17220,18779,1016,21
TRUE,TRUE,1,TRUE,17062,18221,-1246,22,FALSE,0,FALSE,18308,18071,1246,20.3
FALSE,FALSE,0,FALSE,15691,17592,456,21.2,TRUE,2,TRUE,15235,17661,-456,19.2
FALSE,FALSE,0,FALSE,13511,16013,-5087,20,TRUE,0,FALSE,18598,18808,5087,22.6
TRUE,TRUE,0,FALSE,18927,19861,4006,23.1,FALSE,0,FALSE,14921,16183,-4006,17.6
TRUE,FALSE,1,TRUE,16164,17989,-876,19.6,TRUE,0,FALSE,17040,19130,876,23.9
TRUE,TRUE,0,FALSE,15572,17404,-1216,22.1,FALSE,0,FALSE,16788,19214,1216,25.6
FALSE,TRUE,1,FALSE,17469,17964,1432,22.9,FALSE,1,TRUE,16037,18853,-1432,20.3
TRUE,FALSE,1,TRUE,14686,17582,-3593,20.6,TRUE,0,FALSE,18279,20822,3593,22.6
FALSE,FALSE,0,FALSE,16325,17831,2,19.3,TRUE,1,TRUE,16323,18176,-2,22.7
TRUE,FALSE,1,TRUE,17233,17651,2034,20.2,TRUE,0,FALSE,15199,16767,-2034,20
FALSE,FALSE,0,FALSE,16004,18128,-966,24.1,TRUE,0,FALSE,16970,18583,966,21.3
TRUE,TRUE,0,FALSE,16651,16985,1167,21.8,FALSE,1,TRUE,15484,17446,-1167,20.7
TRUE,TRUE,0,FALSE,14959,17503,-2128,22.9,FALSE,1,TRUE,17087,18792,2128,21.9
FALSE,TRUE,0,FALSE,15917,17246,-1971,20,FALSE,2,TRUE,17888,19872,1971,20
TRUE,FALSE,0,FALSE,15754,16844,-708,19.8,TRUE,0,FALSE,16462,18155,708,20.7
FALSE,TRUE,1,TRUE,16891,17845,-1296,20.1,FALSE,0,FALSE,18187,17841,1296,21.7
FALSE,FALSE,0,FALSE,14878,16826,-5924,19.7,TRUE,2,TRUE,20802,20194,5924,22.6
TRUE,TRUE,0,FALSE,17150,19389,1443,22.5,FALSE,0,FALSE,15707,17246,-1443,22.9
FALSE,TRUE,1,TRUE,15941,17661,-2,23.6,FALSE,0,FALSE,15943,19145,2,23.7
TRUE,TRUE,0,FALSE,17802,19422,1070,23.9,FALSE,1,FALSE,16732,17691,-1070,21.1
TRUE,TRUE,1,TRUE,15548,18653,-1238,18.1,FALSE,0,FALSE,16786,20361,1238,21.9
TRUE,FALSE,0,FALSE,15556,17886,1300,21.9,TRUE,0,FALSE,14256,16658,-1300,21.8
TRUE,TRUE,1,TRUE,16098,18103,-282,20.9,FALSE,1,FALSE,16380,18295,282,22.4
TRUE,FALSE,1,FALSE,16107,17538,-456,21.3,TRUE,1,TRUE,16563,18673,456,20.3
FALSE,TRUE,0,FALSE,16315,18067,1167,20.1,FALSE,0,FALSE,15148,17557,-1167,24
FALSE,TRUE,1,FALSE,16587,16824,457,19.9,FALSE,1,TRUE,16130,17207,-457,19.4
FALSE,FALSE,0,FALSE,16112,16844,276,20.1,TRUE,1,TRUE,15836,16467,-276,16.7
TRUE,TRUE,2,TRUE,18212,18905,4429,19.6,FALSE,0,FALSE,13783,15901,-4429,18
FALSE,FALSE,0,FALSE,14761,17479,-907,20.4,TRUE,1,TRUE,15668,17065,907,22.5
FALSE,TRUE,1,TRUE,17613,19706,914,25.1,FALSE,0,FALSE,16699,18479,-914,22.4
FALSE,TRUE,0,FALSE,16384,16954,-232,21.8,FALSE,0,FALSE,16616,18587,232,24.2
TRUE,FALSE,0,FALSE,17001,19154,344,23,TRUE,0,FALSE,16657,17884,-344,25.5
FALSE,TRUE,0,FALSE,15084,16366,-2904,21.1,FALSE,1,FALSE,17988,19185,2904,23.7
TRUE,FALSE,0,FALSE,16918,18396,355,21.6,TRUE,1,TRUE,16563,18732,-355,21.4
TRUE,FALSE,0,FALSE,18562,18633,1911,20.3,TRUE,1,TRUE,16651,16664,-1911,20.6
TRUE,TRUE,1,TRUE,15822,17481,-1572,21.9,FALSE,1,FALSE,17394,19645,1572,24.8
FALSE,TRUE,1,TRUE,17405,18506,1996,18.7,FALSE,0,FALSE,15409,17646,-1996,23.6
TRUE,TRUE,2,TRUE,19696,18881,3802,22.2,FALSE,0,FALSE,15894,17119,-3802,20.9
TRUE,TRUE,0,FALSE,17322,16229,-956,18.2,FALSE,1,TRUE,18278,17680,956,20.7
TRUE,TRUE,0,FALSE,15532,17669,240,22.7,FALSE,0,FALSE,15292,17538,-240,24
FALSE,TRUE,0,FALSE,17823,17275,828,23.7,FALSE,1,TRUE,16995,17354,-828,20
FALSE,FALSE,0,FALSE,13291,15898,-5102,20.1,TRUE,2,TRUE,18393,19875,5102,22.7
TRUE,TRUE,0,FALSE,16851,16674,-778,21.6,FALSE,1,TRUE,17629,17426,778,20
TRUE,TRUE,0,FALSE,16830,18443,2431,23.2,FALSE,0,FALSE,14399,16557,-2431,20.9
TRUE,TRUE,0,FALSE,16061,18238,530,21,FALSE,0,FALSE,15531,16958,-530,20.4
FALSE,FALSE,0,FALSE,15608,17516,766,26,TRUE,0,FALSE,14842,17185,-766,22.9
FALSE,TRUE,0,FALSE,15144,16696,-4172,20.5,FALSE,0,FALSE,19316,18881,4172,22.1
FALSE,FALSE,0,FALSE,15778,15796,-1578,21.3,TRUE,2,TRUE,17356,18359,1578,20.1
TRUE,FALSE,0,FALSE,14721,18073,-964,23.4,TRUE,1,TRUE,15685,18001,964,23.8
TRUE,FALSE,0,FALSE,16154,18075,1764,19.2,TRUE,2,TRUE,14390,16560,-1764,21
FALSE,FALSE,0,FALSE,15136,18082,-3212,17,TRUE,1,TRUE,18348,18868,3212,22.7
FALSE,TRUE,0,FALSE,14231,16339,-2259,20.1,FALSE,1,TRUE,16490,18595,2259,23.4
TRUE,TRUE,1,FALSE,16470,19232,1718,23.2,FALSE,1,TRUE,14752,16285,-1718,21.8
TRUE,FALSE,0,FALSE,13674,17384,-1159,22.9,TRUE,1,TRUE,14833,17541,1159,23
FALSE,FALSE,0,FALSE,15251,16852,-3232,21,TRUE,2,TRUE,18483,19425,3232,21.5
TRUE,TRUE,1,FALSE,18856,19227,3248,23.1,FALSE,1,TRUE,15608,17075,-3248,18.9
TRUE,TRUE,0,FALSE,16274,17652,-1248,20.4,FALSE,0,FALSE,17522,18495,1248,21.1
FALSE,FALSE,1,FALSE,17241,18072,-136,24.2,TRUE,1,TRUE,17377,18655,136,23.4
TRUE,TRUE,1,FALSE,16201,15667,-468,20.4,FALSE,1,TRUE,16669,17553,468,21
FALSE,FALSE,0,FALSE,15622,16556,-3909,20,TRUE,2,TRUE,19531,18692,3909,22.2
FALSE,TRUE,1,TRUE,17575,17019,961,20.9,FALSE,0,FALSE,16614,17992,-961,20.8
TRUE,FALSE,1,TRUE,16408,18014,-2936,22.8,TRUE,0,FALSE,19344,19319,2936,23.2
TRUE,TRUE,1,TRUE,18073,19907,1766,22.1,FALSE,1,FALSE,16307,18301,-1766,19.8
TRUE,FALSE,0,FALSE,15370,17168,-2929,20,TRUE,1,TRUE,18299,18683,2929,21.7
FALSE,TRUE,0,FALSE,14659,17566,-1944,23.5,FALSE,1,FALSE,16603,18628,1944,24
FALSE,FALSE,0,FALSE,18855,18139,3164,18,TRUE,1,TRUE,15691,17852,-3164,20.6
FALSE,FALSE,0,FALSE,14695,16864,-1947,23,TRUE,1,TRUE,16642,18961,1947,25.5
FALSE,FALSE,1,FALSE,17927,18100,396,21.3,TRUE,1,TRUE,17531,19913,-396,22.9
TRUE,TRUE,1,TRUE,16326,18135,1697,21.7,FALSE,1,FALSE,14629,17842,-1697,24.6
TRUE,TRUE,1,TRUE,18552,17072,4845,20.7,FALSE,0,FALSE,13707,14283,-4845,18.3
TRUE,FALSE,1,TRUE,16669,18607,3370,22.6,TRUE,0,FALSE,13299,14123,-3370,19.4
FALSE,FALSE,0,FALSE,15304,15933,-5191,17.5,TRUE,0,FALSE,20495,19752,5191,22.9
FALSE,FALSE,0,FALSE,15242,16792,-3024,19.8,TRUE,0,FALSE,18266,18077,3024,23.6
FALSE,FALSE,1,FALSE,14237,17344,-2114,17.8,TRUE,1,TRUE,16351,18465,2114,24.8
FALSE,TRUE,0,FALSE,14280,15054,-3555,19,FALSE,1,TRUE,17835,18261,3555,22
TRUE,TRUE,0,FALSE,18809,18415,2309,22.5,FALSE,1,TRUE,16500,17204,-2309,18.5
FALSE,FALSE,1,FALSE,14238,16667,-2554,23.4,TRUE,0,FALSE,16792,19243,2554,22.5
FALSE,TRUE,1,TRUE,15101,17275,-654,20.5,FALSE,0,FALSE,15755,17372,654,21.2
TRUE,TRUE,1,FALSE,18237,19105,4824,22.1,FALSE,0,FALSE,13413,16165,-4824,17.9
TRUE,TRUE,1,TRUE,19820,19369,6883,24.7,FALSE,1,FALSE,12937,14032,-6883,17.9
FALSE,FALSE,1,TRUE,16884,17197,-968,19.3,TRUE,1,FALSE,17852,17200,968,21
FALSE,FALSE,1,TRUE,15880,16941,-4526,20.4,TRUE,0,FALSE,20406,19003,4526,20.1
FALSE,FALSE,0,FALSE,15430,18275,-2850,24,TRUE,1,TRUE,18280,19107,2850,23.5
FALSE,FALSE,0,FALSE,14258,17644,-2760,21.6,TRUE,2,TRUE,17018,19516,2760,24.8
TRUE,FALSE,0,FALSE,14849,17923,-2145,24.9,TRUE,1,TRUE,16994,19258,2145,24.5
TRUE,TRUE,0,FALSE,17023,17502,1202,19.8,FALSE,1,FALSE,15821,18037,-1202,18
TRUE,TRUE,0,FALSE,19143,20064,3469,24.3,FALSE,1,TRUE,15674,16380,-3469,19.9
FALSE,FALSE,0,FALSE,15620,17968,-1083,21.4,TRUE,1,TRUE,16703,18095,1083,21.8
TRUE,TRUE,1,TRUE,18623,17867,914,22.9,FALSE,0,FALSE,17709,17833,-914,23.7
TRUE,FALSE,0,FALSE,16564,18605,1436,22.2,TRUE,1,TRUE,15128,17008,-1436,22.1
TRUE,FALSE,1,TRUE,18421,18519,2256,23.2,TRUE,0,FALSE,16165,17794,-2256,22.2
FALSE,TRUE,1,FALSE,17364,18990,1206,21.5,FALSE,1,TRUE,16158,17935,-1206,24.8
TRUE,FALSE,1,TRUE,16749,17759,243,17.4,TRUE,0,FALSE,16506,18035,-243,22.7
FALSE,FALSE,0,FALSE,17987,17683,-368,20.9,TRUE,0,FALSE,18355,18295,368,23.6
FALSE,TRUE,1,TRUE,16103,18017,-90,22,FALSE,0,FALSE,16193,18756,90,20.5
TRUE,TRUE,0,FALSE,18384,18718,1717,22.6,FALSE,0,FALSE,16667,17383,-1717,22.9
TRUE,TRUE,1,FALSE,17465,17463,875,21.1,FALSE,0,FALSE,16590,17187,-875,18.3
FALSE,FALSE,0,FALSE,15591,16788,-2322,20.4,TRUE,1,TRUE,17913,19596,2322,21.6
TRUE,TRUE,0,FALSE,15391,17387,1343,23.2,FALSE,1,TRUE,14048,16298,-1343,21.8
FALSE,FALSE,0,FALSE,14953,17850,-3084,22.8,TRUE,1,TRUE,18037,19569,3084,25.8
TRUE,FALSE,1,TRUE,16640,18989,1964,24.7,TRUE,0,FALSE,14676,17573,-1964,21.5
TRUE,FALSE,1,TRUE,15501,17414,-257,24.5,TRUE,0,FALSE,15758,17594,257,19.9
FALSE,TRUE,1,TRUE,18891,19302,3024,23.5,FALSE,0,FALSE,15867,17322,-3024,18.5
TRUE,TRUE,1,TRUE,16999,18661,-647,23.2,FALSE,0,FALSE,17646,18118,647,22.6
TRUE,FALSE,0,FALSE,18291,18744,939,19.5,TRUE,0,FALSE,17352,17417,-939,20.9
FALSE,FALSE,0,FALSE,14588,18059,-1159,23.4,TRUE,2,TRUE,15747,18132,1159,24.3
TRUE,TRUE,1,TRUE,16432,18849,2390,20.8,FALSE,0,FALSE,14042,17071,-2390,21.9
FALSE,TRUE,1,FALSE,16199,17974,-2482,21.6,FALSE,1,TRUE,18681,20489,2482,21.9
TRUE,FALSE,1,TRUE,17342,17885,-447,17.9,TRUE,0,FALSE,17789,18840,447,20.6
FALSE,TRUE,1,FALSE,16247,19000,1351,25.7,FALSE,1,TRUE,14896,18060,-1351,26.9
TRUE,TRUE,1,TRUE,17038,18971,1530,23.3,FALSE,1,FALSE,15508,18637,-1530,23.3
FALSE,TRUE,0,FALSE,14607,17527,-2968,20.4,FALSE,2,TRUE,17575,19789,2968,24.3
FALSE,TRUE,0,FALSE,14839,16702,-2574,20.8,FALSE,1,TRUE,17413,17759,2574,22.7
TRUE,TRUE,0,FALSE,15142,17554,-1851,23.5,FALSE,2,TRUE,16993,19367,1851,24.2
FALSE,TRUE,1,TRUE,17836,19239,840,23.5,FALSE,0,FALSE,16996,19094,-840,26.3
TRUE,FALSE,1,TRUE,16538,18750,-626,23.1,TRUE,1,FALSE,17164,18511,626,23
TRUE,TRUE,1,TRUE,20558,18104,4230,23,FALSE,0,FALSE,16328,16559,-4230,16.7
TRUE,TRUE,1,TRUE,19813,18543,4173,23.6,FALSE,0,FALSE,15640,16631,-4173,16.7
TRUE,TRUE,1,TRUE,18537,19024,1809,20,FALSE,0,FALSE,16728,17391,-1809,19.3
TRUE,TRUE,2,TRUE,17806,18750,6304,24.4,FALSE,0,FALSE,11502,12846,-6304,15.5
TRUE,TRUE,0,FALSE,20853,20248,5501,27,FALSE,0,FALSE,15352,16700,-5501,18.8
FALSE,FALSE,0,FALSE,16441,19798,1218,24.3,TRUE,1,FALSE,15223,18631,-1218,25.2
FALSE,TRUE,0,FALSE,15801,18475,-187,20.6,FALSE,1,TRUE,15988,18836,187,25.1
FALSE,FALSE,1,TRUE,15871,17211,51,22.9,TRUE,0,FALSE,15820,18286,-51,21.6
FALSE,TRUE,0,FALSE,16199,16645,-811,20.6,FALSE,1,TRUE,17010,17443,811,19.2
FALSE,FALSE,0,FALSE,15831,17389,-2241,20.8,TRUE,2,TRUE,18072,19277,2241,21.8
FALSE,FALSE,0,FALSE,14467,16928,-3794,21.5,TRUE,1,TRUE,18261,18890,3794,23.4
FALSE,TRUE,1,TRUE,17795,18362,426,22.8,FALSE,1,FALSE,17369,17445,-426,19.4
TRUE,FALSE,1,TRUE,15832,18359,-1741,23.6,TRUE,1,FALSE,17573,19707,1741,23.4
TRUE,TRUE,2,TRUE,18170,19022,3058,19.1,FALSE,0,FALSE,15112,15739,-3058,18.9
FALSE,FALSE,1,TRUE,16196,18411,1106,23.8,TRUE,0,FALSE,15090,17397,-1106,21.6
FALSE,FALSE,0,FALSE,14680,17465,-1602,20.7,TRUE,2,TRUE,16282,18877,1602,24.3
TRUE,TRUE,1,TRUE,17029,17944,569,20.1,FALSE,0,FALSE,16460,19293,-569,20.4
FALSE,FALSE,0,FALSE,14298,17567,-873,22.8,TRUE,0,FALSE,15171,18303,873,23.8
FALSE,FALSE,0,FALSE,14058,16535,-5327,21.4,TRUE,2,TRUE,19385,21171,5327,23.4
TRUE,TRUE,2,TRUE,17385,18040,2745,22.1,FALSE,0,FALSE,14640,16562,-2745,20.3
TRUE,TRUE,0,FALSE,19008,19915,2763,23.5,FALSE,1,TRUE,16245,17896,-2763,21.6
FALSE,TRUE,0,FALSE,18038,18690,-22,23.6,FALSE,1,TRUE,18060,18604,22,21.4
TRUE,TRUE,0,FALSE,16454,18902,1510,22.8,FALSE,1,TRUE,14944,17357,-1510,22.2
TRUE,TRUE,1,TRUE,18313,17999,1099,21.4,FALSE,0,FALSE,17214,18672,-1099,17.8
TRUE,TRUE,0,FALSE,17057,17917,2019,24.3,FALSE,0,FALSE,15038,17779,-2019,20.9
FALSE,TRUE,0,FALSE,15046,17088,-4939,21.4,FALSE,1,FALSE,19985,20819,4939,25.1
FALSE,FALSE,0,FALSE,14455,16461,-2471,19.9,TRUE,1,TRUE,16926,18640,2471,24.9
TRUE,TRUE,0,FALSE,18480,17912,2532,20.1,FALSE,0,FALSE,15948,16683,-2532,20.3
TRUE,FALSE,0,FALSE,19153,18170,1249,21.7,TRUE,0,FALSE,17904,16291,-1249,17.7
TRUE,TRUE,1,TRUE,16688,18714,859,22.6,FALSE,0,FALSE,15829,18586,-859,24.2
FALSE,FALSE,0,FALSE,15567,16972,-1737,16.7,TRUE,1,TRUE,17304,17748,1737,24.5
TRUE,TRUE,1,TRUE,15429,18375,1453,21.8,FALSE,0,FALSE,13976,17124,-1453,23.1
TRUE,FALSE,1,FALSE,17491,18181,616,19.4,TRUE,1,TRUE,16875,18138,-616,25.3
FALSE,TRUE,1,TRUE,17679,17322,363,22.2,FALSE,1,FALSE,17316,19210,-363,23
TRUE,FALSE,1,TRUE,17397,19011,2598,24.4,TRUE,0,FALSE,14799,14499,-2598,18.6
FALSE,FALSE,0,FALSE,14416,11286,-5253,9,TRUE,0,FALSE,19669,16567,5253,20.3
FALSE,FALSE,0,FALSE,16820,16714,-2234,20.2,TRUE,1,TRUE,19054,19978,2234,20.9
TRUE,TRUE,0,FALSE,15659,17407,-127,21.1,FALSE,2,TRUE,15786,17852,127,20.9
TRUE,TRUE,0,FALSE,19353,18423,3458,22.3,FALSE,0,FALSE,15895,15219,-3458,16.3
FALSE,TRUE,0,FALSE,17794,18646,337,21.1,FALSE,1,TRUE,17457,18906,-337,21.8
TRUE,TRUE,1,TRUE,16443,17912,-1041,22.8,FALSE,0,FALSE,17484,18573,1041,21.6
TRUE,TRUE,0,FALSE,17773,20821,2421,24.2,FALSE,0,FALSE,15352,17812,-2421,22.1
TRUE,FALSE,1,TRUE,14996,17677,-4822,18.1,TRUE,0,FALSE,19818,20214,4822,24.9
FALSE,FALSE,1,TRUE,15803,18061,-2994,21.7,TRUE,1,FALSE,18797,19068,2994,24.8
TRUE,FALSE,0,FALSE,16241,18864,-1539,21.1,TRUE,1,TRUE,17780,19465,1539,24.9
TRUE,FALSE,1,TRUE,17774,18440,-76,18,TRUE,0,FALSE,17850,17054,76,19
FALSE,FALSE,0,FALSE,15823,18209,-1482,21.4,TRUE,1,TRUE,17305,17953,1482,24.7
TRUE,TRUE,0,FALSE,17684,19113,3847,22.4,FALSE,0,FALSE,13837,17086,-3847,21.7
FALSE,TRUE,0,FALSE,17898,18482,3044,24.7,FALSE,0,FALSE,14854,16707,-3044,21.3
TRUE,TRUE,2,TRUE,15562,16991,-1176,22.2,FALSE,0,FALSE,16738,18829,1176,20.1
FALSE,FALSE,0,FALSE,14881,17401,-1659,19.6,TRUE,1,TRUE,16540,18535,1659,24.8
TRUE,FALSE,2,TRUE,16636,19367,2547,24.6,TRUE,0,FALSE,14089,17850,-2547,21.5
TRUE,TRUE,0,FALSE,16396,18362,-389,20.9,FALSE,1,TRUE,16785,18391,389,21.3
FALSE,FALSE,0,FALSE,15396,16586,-1193,21.8,TRUE,1,FALSE,16589,17429,1193,23.8
TRUE,TRUE,1,FALSE,18164,18492,-640,19.8,FALSE,1,TRUE,18804,18089,640,20.4
TRUE,FALSE,0,FALSE,17774,17519,74,19.3,TRUE,0,FALSE,17700,18032,-74,22.1
FALSE,FALSE,0,FALSE,16990,18051,1954,24.4,TRUE,1,TRUE,15036,17006,-1954,22.5
TRUE,TRUE,1,TRUE,16508,18539,646,22.8,FALSE,0,FALSE,15862,18132,-646,23.8
FALSE,FALSE,0,FALSE,15533,18287,-1585,24.4,TRUE,1,TRUE,17118,18567,1585,25.6
TRUE,TRUE,1,TRUE,15391,17937,46,19.1,FALSE,0,FALSE,15345,16967,-46,23.6
TRUE,TRUE,0,FALSE,15076,16299,-426,19.6,FALSE,1,FALSE,15502,18648,426,21.8
TRUE,TRUE,0,FALSE,16119,16658,-524,21.7,FALSE,2,TRUE,16643,17687,524,19
FALSE,TRUE,0,FALSE,14377,17408,-3773,19.4,FALSE,1,TRUE,18150,21191,3773,25.8
TRUE,FALSE,0,FALSE,13958,17193,-4738,17.6,TRUE,2,TRUE,18696,20050,4738,26.4
TRUE,TRUE,1,TRUE,18834,17602,1059,20.3,FALSE,0,FALSE,17775,16417,-1059,18.2
TRUE,TRUE,1,TRUE,17895,18393,2330,20.8,FALSE,0,FALSE,15565,16680,-2330,20.4
TRUE,FALSE,0,FALSE,16526,18436,434,21.5,TRUE,0,FALSE,16092,17696,-434,22.6
FALSE,FALSE,0,FALSE,16075,17316,-1778,20,TRUE,1,TRUE,17853,18444,1778,20.8
FALSE,FALSE,1,FALSE,18947,17963,412,21.5,TRUE,1,TRUE,18535,18618,-412,24.1
FALSE,FALSE,0,FALSE,15137,16725,-2645,21.4,TRUE,1,TRUE,17782,18594,2645,22.5
FALSE,TRUE,0,FALSE,16157,17603,804,24,FALSE,0,FALSE,15353,17238,-804,20.6
FALSE,FALSE,0,FALSE,15152,17748,-619,22.9,TRUE,1,TRUE,15771,17558,619,18.8
TRUE,TRUE,0,FALSE,17041,17082,2263,22.7,FALSE,1,TRUE,14778,15756,-2263,17.9
TRUE,TRUE,1,TRUE,16742,19873,2805,23.6,FALSE,0,FALSE,13937,17274,-2805,25.4
FALSE,TRUE,1,TRUE,15660,17755,-2392,24.6,FALSE,0,FALSE,18052,20258,2392,26.6
TRUE,TRUE,0,FALSE,16298,19052,823,22.9,FALSE,1,TRUE,15475,17827,-823,23.5
TRUE,TRUE,1,TRUE,15860,18449,-1160,22.8,FALSE,1,FALSE,17020,18461,1160,20.3
TRUE,TRUE,1,TRUE,15809,18321,-1065,23.9,FALSE,1,FALSE,16874,17819,1065,23.5
TRUE,FALSE,0,FALSE,19470,20453,6297,24.3,TRUE,1,TRUE,13173,14676,-6297,18.9
FALSE,TRUE,2,TRUE,19660,17870,5255,18.6,FALSE,0,FALSE,14405,15615,-5255,18.3
FALSE,FALSE,0,FALSE,13631,15864,-5167,17.5,TRUE,0,FALSE,18798,19064,5167,23.4
TRUE,FALSE,0,FALSE,16748,17343,873,20.9,TRUE,0,FALSE,15875,17128,-873,23.5
FALSE,FALSE,0,FALSE,14434,17904,-920,22.1,TRUE,1,TRUE,15354,18355,920,23
TRUE,TRUE,0,FALSE,16287,16978,1099,23.5,FALSE,0,FALSE,15188,17600,-1099,18.3
FALSE,FALSE,1,TRUE,15102,16371,-3465,20.1,TRUE,1,FALSE,18567,17268,3465,25.3
TRUE,TRUE,2,TRUE,15492,18241,1412,21.2,FALSE,0,FALSE,14080,17504,-1412,23.6
TRUE,FALSE,1,TRUE,14554,16715,-2814,19.8,TRUE,0,FALSE,17368,19487,2814,22.8
TRUE,FALSE,0,FALSE,15403,17661,-1636,21.6,TRUE,1,TRUE,17039,19861,1636,24.5
FALSE,FALSE,0,FALSE,13024,15869,-4912,19.2,TRUE,2,TRUE,17936,20326,4912,25.1
TRUE,FALSE,1,TRUE,15799,17838,-1827,24.2,TRUE,1,FALSE,17626,18940,1827,24.3
FALSE,FALSE,1,FALSE,17127,17974,-373,24.3,TRUE,1,TRUE,17500,18186,373,22.9
TRUE,TRUE,2,TRUE,17208,18913,423,20.1,FALSE,0,FALSE,16785,17842,-423,22.2
TRUE,FALSE,0,FALSE,16860,15585,-91,18.3,TRUE,0,FALSE,16951,17947,91,20.4
FALSE,FALSE,0,FALSE,18082,17805,-1097,21.5,TRUE,1,TRUE,19179,18479,1097,20.4
FALSE,TRUE,0,FALSE,14813,14354,-5062,19.8,FALSE,2,TRUE,19875,20053,5062,25
TRUE,FALSE,0,FALSE,17989,18476,267,25.4,TRUE,0,FALSE,17722,18049,-267,21.9
TRUE,TRUE,0,FALSE,15815,16506,-1053,20.6,FALSE,1,TRUE,16868,19265,1053,24.7
TRUE,FALSE,1,TRUE,17991,19538,2664,21.9,TRUE,0,FALSE,15327,16265,-2664,18.7
FALSE,TRUE,0,FALSE,16560,17640,-1611,20,FALSE,1,TRUE,18171,19020,1611,20.9
FALSE,FALSE,0,FALSE,15260,17619,323,19.1,TRUE,2,TRUE,14937,16918,-323,21.2
FALSE,TRUE,0,FALSE,13544,15367,-5820,20.6,FALSE,0,FALSE,19364,19433,5820,25.5
TRUE,FALSE,0,FALSE,15462,18980,-1870,23.9,TRUE,1,TRUE,17332,19051,1870,23.8
FALSE,TRUE,1,TRUE,15000,16731,-3761,22.1,FALSE,0,FALSE,18761,19283,3761,22.5
TRUE,TRUE,1,FALSE,16399,18784,2036,23.5,FALSE,1,TRUE,14363,16011,-2036,22.1
FALSE,FALSE,0,FALSE,14594,17746,-1087,18.4,TRUE,0,FALSE,15681,17854,1087,22
TRUE,TRUE,1,FALSE,21046,19706,7995,25,FALSE,0,FALSE,13051,14973,-7995,17.9
FALSE,FALSE,1,TRUE,15382,17876,-1182,21.8,TRUE,1,FALSE,16564,18820,1182,20.7
TRUE,FALSE,0,FALSE,16095,17192,-1905,22.2,TRUE,0,FALSE,18000,19377,1905,21.7
FALSE,FALSE,0,FALSE,14863,17880,-3630,22.2,TRUE,2,TRUE,18493,17212,3630,21.6
FALSE,FALSE,0,FALSE,17668,18625,-788,19.4,TRUE,1,TRUE,18456,18828,788,18.5
FALSE,FALSE,0,FALSE,16420,16281,-3593,22.3,TRUE,2,TRUE,20013,19367,3593,22.9
TRUE,FALSE,0,FALSE,17194,18161,633,23.3,TRUE,0,FALSE,16561,19105,-633,20.2
TRUE,TRUE,0,FALSE,19529,19763,3476,20.4,FALSE,1,TRUE,16053,17738,-3476,18.2
TRUE,FALSE,1,TRUE,17762,18599,849,23.3,TRUE,0,FALSE,16913,17805,-849,20
TRUE,TRUE,0,FALSE,16987,18495,1153,25.5,FALSE,1,TRUE,15834,18500,-1153,24.1
TRUE,TRUE,0,FALSE,16985,18420,992,24.8,FALSE,1,TRUE,15993,18027,-992,22.9
FALSE,FALSE,0,FALSE,14845,16713,-3193,23.6,TRUE,1,TRUE,18038,18814,3193,20.7
FALSE,FALSE,0,FALSE,18174,17137,-787,22.2,TRUE,1,TRUE,18961,18063,787,22.5
TRUE,TRUE,1,TRUE,17120,18447,860,20.5,FALSE,0,FALSE,16260,18163,-860,20
FALSE,TRUE,1,TRUE,15776,16824,-400,19.9,FALSE,0,FALSE,16176,18135,400,21.7
TRUE,FALSE,0,FALSE,17175,18994,-680,26.4,TRUE,1,TRUE,17855,18427,680,23.9
FALSE,TRUE,0,FALSE,15656,16714,-1458,20.6,FALSE,2,TRUE,17114,17332,1458,19.3
FALSE,TRUE,1,TRUE,14867,17173,-2153,21.6,FALSE,0,FALSE,17020,19521,2153,22
TRUE,TRUE,1,TRUE,17381,18938,1895,23.2,FALSE,0,FALSE,15486,18303,-1895,21.1
TRUE,TRUE,2,TRUE,18821,20341,5301,22.5,FALSE,0,FALSE,13520,14469,-5301,16.7
FALSE,FALSE,0,FALSE,14459,17799,-2859,17.3,TRUE,0,FALSE,17318,17656,2859,24.2
FALSE,FALSE,1,TRUE,16654,18387,-959,23.9,TRUE,0,FALSE,17613,19389,959,21.1
TRUE,FALSE,0,FALSE,17438,18793,2152,24.9,TRUE,2,TRUE,15286,16857,-2152,22.7
TRUE,TRUE,0,FALSE,17431,18675,300,27.2,FALSE,2,TRUE,17131,18248,-300,23.6
TRUE,TRUE,1,TRUE,17327,19938,2060,24,FALSE,0,FALSE,15267,18317,-2060,22.6
TRUE,TRUE,2,TRUE,17637,17342,-430,19.6,FALSE,0,FALSE,18067,18370,430,21
TRUE,TRUE,1,TRUE,16021,18021,-620,19.9,FALSE,0,FALSE,16641,18405,620,21.7
TRUE,TRUE,1,TRUE,16997,17603,2107,22.7,FALSE,0,FALSE,14890,16498,-2107,22
FALSE,TRUE,1,TRUE,15530,17375,-2141,22,FALSE,1,FALSE,17671,17427,2141,23.6
TRUE,FALSE,0,FALSE,14569,16380,-575,23.4,TRUE,1,TRUE,15144,17875,575,20
TRUE,FALSE,0,FALSE,17212,18257,559,22.5,TRUE,1,TRUE,16653,18397,-559,22.5
FALSE,TRUE,0,FALSE,18494,19080,-790,22.3,FALSE,1,TRUE,19284,19914,790,23.7
FALSE,FALSE,1,FALSE,15632,17715,-2293,23,TRUE,1,TRUE,17925,19038,2293,23.4
TRUE,FALSE,0,FALSE,17455,19749,2409,25.4,TRUE,1,FALSE,15046,17563,-2409,23.9
TRUE,FALSE,1,TRUE,15716,18832,12,22.1,TRUE,0,FALSE,15704,18671,-12,24.4
TRUE,TRUE,2,TRUE,17577,20010,2812,21,FALSE,0,FALSE,14765,17263,-2812,20.5
TRUE,TRUE,1,TRUE,17822,19861,2435,23.7,FALSE,0,FALSE,15387,18433,-2435,21.5
FALSE,TRUE,1,TRUE,15381,17703,759,21.1,FALSE,0,FALSE,14622,17046,-759,24.5
TRUE,TRUE,0,FALSE,15485,16891,-215,20.1,FALSE,2,TRUE,15700,17437,215,17
TRUE,TRUE,1,FALSE,16953,18804,1491,23.8,FALSE,1,TRUE,15462,18271,-1491,21.3
FALSE,FALSE,0,FALSE,13229,15040,-6460,17.7,TRUE,0,FALSE,19689,20423,6460,23.3
TRUE,TRUE,1,TRUE,16579,19488,-27,24.9,FALSE,0,FALSE,16606,20137,27,24.6
FALSE,FALSE,0,FALSE,15562,17777,-1151,21.9,TRUE,2,TRUE,16713,18530,1151,22.7
TRUE,FALSE,1,FALSE,17192,18065,662,22.1,TRUE,1,TRUE,16530,18021,-662,19.6
TRUE,TRUE,1,FALSE,18764,18764,5121,26.8,FALSE,0,FALSE,13643,15818,-5121,20.1
FALSE,TRUE,0,FALSE,15790,16879,-1876,21.5,FALSE,1,TRUE,17666,19033,1876,20.8
TRUE,TRUE,1,TRUE,19380,19467,3844,24.4,FALSE,0,FALSE,15536,16727,-3844,18.9
FALSE,TRUE,0,FALSE,16554,17192,-154,21.5,FALSE,1,FALSE,16708,17385,154,21.8
FALSE,FALSE,0,FALSE,14017,16680,-5089,18.5,TRUE,0,FALSE,19106,18508,5089,24.5
FALSE,TRUE,1,TRUE,20136,19337,4322,22.5,FALSE,0,FALSE,15814,15507,-4322,18.6
TRUE,TRUE,1,TRUE,16717,18457,-450,22.3,FALSE,0,FALSE,17167,19449,450,24.7
TRUE,TRUE,1,FALSE,15927,17498,-412,22,FALSE,1,TRUE,16339,18107,412,23.4
FALSE,FALSE,0,FALSE,15729,16459,-5830,18.6,TRUE,1,FALSE,21559,20067,5830,22.5
FALSE,FALSE,1,TRUE,14814,17587,-3402,22.2,TRUE,0,FALSE,18216,19046,3402,22.9
FALSE,TRUE,1,TRUE,16610,18058,2044,22.7,FALSE,0,FALSE,14566,17680,-2044,22
TRUE,TRUE,2,TRUE,17588,18328,1219,23.3,FALSE,0,FALSE,16369,18036,-1219,21.6
FALSE,FALSE,1,TRUE,16017,17471,1598,20.8,TRUE,0,FALSE,14419,14993,-1598,19.4
FALSE,FALSE,0,FALSE,14851,17101,-1068,24.5,TRUE,2,TRUE,15919,17118,1068,21.2
FALSE,TRUE,2,TRUE,15420,17930,-2264,23.5,FALSE,0,FALSE,17684,19319,2264,23.7
TRUE,FALSE,0,FALSE,15476,16323,-963,19.2,TRUE,1,TRUE,16439,16869,963,16.4
FALSE,FALSE,0,FALSE,14463,18394,-2820,22.4,TRUE,1,TRUE,17283,19442,2820,25.8
TRUE,TRUE,1,TRUE,17653,18042,1931,21.8,FALSE,0,FALSE,15722,17950,-1931,20.5
FALSE,TRUE,0,FALSE,15097,18396,-429,21.8,FALSE,2,TRUE,15526,18341,429,24.4
TRUE,TRUE,1,TRUE,16476,18421,-323,23.8,FALSE,0,FALSE,16799,18076,323,23.1
TRUE,TRUE,1,TRUE,20136,20899,6290,23.5,FALSE,0,FALSE,13846,16180,-6290,20.1
FALSE,TRUE,0,FALSE,14385,17383,-959,21.6,FALSE,1,TRUE,15344,18714,959,22.3
FALSE,TRUE,0,FALSE,16672,18758,-1112,23.1,FALSE,0,FALSE,17784,18447,1112,21.1
TRUE,FALSE,0,FALSE,17286,18839,431,22.2,TRUE,1,TRUE,16855,18214,-431,19.3
FALSE,TRUE,0,FALSE,16385,18374,3001,24.9,FALSE,1,TRUE,13384,17151,-3001,21.3
TRUE,TRUE,0,FALSE,16902,17878,1451,20.7,FALSE,0,FALSE,15451,16724,-1451,19.9
TRUE,TRUE,2,TRUE,17127,19195,2735,22.1,FALSE,0,FALSE,14392,16876,-2735,20.8
TRUE,TRUE,0,FALSE,18383,18694,4152,23.3,FALSE,1,FALSE,14231,17228,-4152,21.3
FALSE,FALSE,0,FALSE,15475,15944,-2395,20.5,TRUE,1,TRUE,17870,19061,2395,21
TRUE,FALSE,0,FALSE,18950,18183,227,21.6,TRUE,0,FALSE,18723,17244,-227,21.7
TRUE,TRUE,1,TRUE,16942,17249,3843,21.4,FALSE,0,FALSE,13099,14418,-3843,19.1
FALSE,FALSE,0,FALSE,15423,18648,-2055,23.2,TRUE,1,TRUE,17478,19508,2055,25.8
FALSE,TRUE,0,FALSE,18296,18788,1011,20.8,FALSE,0,FALSE,17285,18771,-1011,23.7
FALSE,FALSE,0,FALSE,15166,15761,-3865,16.2,TRUE,1,TRUE,19031,18681,3865,20.4
FALSE,FALSE,0,FALSE,16230,18114,-1222,23,TRUE,1,FALSE,17452,18239,1222,22.1
TRUE,TRUE,1,TRUE,20005,20561,5201,22.2,FALSE,0,FALSE,14804,16163,-5201,21.1
FALSE,TRUE,0,FALSE,14485,17358,-953,21.1,FALSE,0,FALSE,15438,18220,953,24.6
FALSE,FALSE,1,TRUE,15313,18483,496,22.1,TRUE,0,FALSE,14817,17118,-496,23.7
TRUE,TRUE,0,FALSE,17147,19004,1412,19.7,FALSE,1,TRUE,15735,17107,-1412,21
FALSE,FALSE,0,FALSE,16078,18042,-1408,21.7,TRUE,1,TRUE,17486,19234,1408,24.5
FALSE,FALSE,0,FALSE,14511,17013,-2246,19.3,TRUE,1,TRUE,16757,17974,2246,23.3
FALSE,TRUE,1,TRUE,15224,17138,1168,21.8,FALSE,0,FALSE,14056,16657,-1168,23.1
FALSE,TRUE,0,FALSE,15989,16090,-2662,17.9,FALSE,1,TRUE,18651,18260,2662,20.4
TRUE,TRUE,0,FALSE,17558,19554,2704,25.1,FALSE,1,TRUE,14854,17814,-2704,22.4
TRUE,TRUE,0,FALSE,15215,16664,0,21.2,FALSE,1,TRUE,15215,17032,0,19.7
TRUE,TRUE,0,FALSE,14887,15841,-3088,20.9,FALSE,0,FALSE,17975,17869,3088,20.3
FALSE,FALSE,0,FALSE,14100,16725,-5508,20.4,TRUE,1,TRUE,19608,20246,5508,23.9
TRUE,FALSE,1,TRUE,17097,17368,1800,19.9,TRUE,0,FALSE,15297,16822,-1800,18.2
FALSE,FALSE,0,FALSE,14082,16368,-3196,23.8,TRUE,1,TRUE,17278,17690,3196,21.6
TRUE,TRUE,0,FALSE,17500,18692,2077,22.6,FALSE,1,TRUE,15423,18426,-2077,21.2
TRUE,TRUE,2,TRUE,17970,19866,2003,20.8,FALSE,0,FALSE,15967,17711,-2003,23
TRUE,FALSE,0,FALSE,15198,18486,-266,20.5,TRUE,1,TRUE,15464,18471,266,22.4
TRUE,TRUE,0,FALSE,17194,19447,2588,26.3,FALSE,0,FALSE,14606,17819,-2588,21.5
FALSE,TRUE,0,FALSE,14951,17632,-2002,20.6,FALSE,1,TRUE,16953,18197,2002,21.4
FALSE,TRUE,1,TRUE,16966,19062,1996,22.2,FALSE,0,FALSE,14970,16984,-1996,22.2
TRUE,FALSE,1,TRUE,14513,16872,-1494,20.2,TRUE,0,FALSE,16007,17240,1494,23.2
FALSE,TRUE,0,FALSE,18446,19075,1918,19.5,FALSE,2,TRUE,16528,17437,-1918,19.1
FALSE,FALSE,0,FALSE,17100,18774,825,21.3,TRUE,1,TRUE,16275,18456,-825,19.6
TRUE,TRUE,2,TRUE,20611,19378,4096,21,FALSE,0,FALSE,16515,15862,-4096,16.6
TRUE,FALSE,0,FALSE,18672,19296,2427,25,TRUE,1,TRUE,16245,18554,-2427,18.4
FALSE,FALSE,0,FALSE,14988,18065,428,25.6,TRUE,1,TRUE,14560,18101,-428,22
FALSE,TRUE,0,FALSE,17250,18266,-862,22.2,FALSE,0,FALSE,18112,19862,862,21.6
TRUE,TRUE,1,FALSE,20145,19898,5634,24.2,FALSE,1,TRUE,14511,17804,-5634,19.6
TRUE,FALSE,1,TRUE,17325,18954,1243,20.7,TRUE,0,FALSE,16082,17448,-1243,21.8
TRUE,TRUE,1,FALSE,19336,21123,6221,26.7,FALSE,1,TRUE,13115,14980,-6221,20.5
FALSE,FALSE,0,FALSE,13701,15626,-4873,20,TRUE,1,TRUE,18574,18292,4873,22.2
FALSE,TRUE,1,TRUE,15765,17647,-164,21.4,FALSE,0,FALSE,15929,17960,164,21.8
FALSE,FALSE,0,FALSE,14841,17969,-224,18.3,TRUE,2,TRUE,15065,17334,224,23.4
FALSE,TRUE,0,FALSE,15597,17541,717,23.2,FALSE,1,TRUE,14880,17326,-717,19.7
FALSE,FALSE,0,FALSE,13828,16964,-3588,22.8,TRUE,0,FALSE,17416,19465,3588,25.8
FALSE,FALSE,0,FALSE,16275,18687,-184,20.9,TRUE,1,TRUE,16459,18630,184,25
FALSE,FALSE,0,FALSE,16763,19010,-729,25.2,TRUE,2,TRUE,17492,19630,729,24.1
TRUE,TRUE,0,FALSE,21089,18924,5859,21.8,FALSE,0,FALSE,15230,15635,-5859,20.5
FALSE,FALSE,0,FALSE,15155,16875,-2548,20.1,TRUE,1,TRUE,17703,17701,2548,21.2
TRUE,TRUE,2,TRUE,17226,18458,2061,19.3,FALSE,0,FALSE,15165,16765,-2061,22
FALSE,TRUE,1,FALSE,17634,18416,825,23.7,FALSE,1,TRUE,16809,19783,-825,21.5
TRUE,FALSE,1,TRUE,17562,18512,1948,22.4,TRUE,0,FALSE,15614,17748,-1948,20.2
TRUE,FALSE,0,FALSE,16161,18920,-167,21.4,TRUE,0,FALSE,16328,18065,167,21.3
TRUE,TRUE,1,TRUE,20853,20447,5477,25.1,FALSE,0,FALSE,15376,16755,-5477,20.6
TRUE,FALSE,1,FALSE,15743,18383,-251,26.4,TRUE,1,TRUE,15994,17826,251,21
TRUE,TRUE,1,FALSE,15204,17963,153,20.9,FALSE,1,TRUE,15051,17046,-153,23.2
FALSE,FALSE,0,FALSE,15013,16860,-741,21.2,TRUE,1,TRUE,15754,17497,741,22.5
TRUE,TRUE,1,FALSE,20176,19773,5830,26,FALSE,0,FALSE,14346,17794,-5830,19.4
FALSE,FALSE,0,FALSE,15856,17723,-460,22.4,TRUE,1,TRUE,16316,17663,460,23.8
TRUE,TRUE,2,TRUE,17097,18583,1186,22,FALSE,0,FALSE,15911,17676,-1186,21.3
FALSE,TRUE,0,FALSE,16595,18766,-829,21.7,FALSE,2,TRUE,17424,18477,829,22
FALSE,FALSE,0,FALSE,13952,15665,-3559,17.2,TRUE,2,TRUE,17511,18477,3559,23
TRUE,TRUE,2,TRUE,18413,19681,2377,22.8,FALSE,0,FALSE,16036,17346,-2377,17.2
FALSE,TRUE,0,FALSE,16113,18642,1277,23.6,FALSE,1,TRUE,14836,17285,-1277,22.1
TRUE,FALSE,0,FALSE,15508,17985,-919,25.8,TRUE,0,FALSE,16427,18908,919,22.6
FALSE,TRUE,1,TRUE,18345,17559,941,22.2,FALSE,1,FALSE,17404,18120,-941,20.7
TRUE,TRUE,0,FALSE,18882,19357,291,22.4,FALSE,0,FALSE,18591,18518,-291,22.2
FALSE,TRUE,0,FALSE,14734,17665,-1871,22.6,FALSE,0,FALSE,16605,18270,1871,23.1
FALSE,FALSE,0,FALSE,15337,17456,-1167,21.1,TRUE,0,FALSE,16504,18721,1167,17.3
FALSE,FALSE,0,FALSE,15280,18773,447,25.7,TRUE,1,TRUE,14833,18164,-447,24
TRUE,TRUE,0,FALSE,16861,18561,2211,19.6,FALSE,1,TRUE,14650,17060,-2211,20.8
TRUE,FALSE,0,FALSE,16321,17802,-2593,18.5,TRUE,1,TRUE,18914,19470,2593,24.5
FALSE,TRUE,0,FALSE,15885,16848,-1566,22,FALSE,1,TRUE,17451,19387,1566,22.1
FALSE,FALSE,0,FALSE,16007,17004,-3397,20.6,TRUE,1,TRUE,19404,19496,3397,22.9
TRUE,FALSE,0,FALSE,16171,17226,-857,19.1,TRUE,1,TRUE,17028,18582,857,23.4
FALSE,FALSE,0,FALSE,15726,16968,-3796,17.6,TRUE,0,FALSE,19522,17294,3796,21.9
FALSE,FALSE,0,FALSE,16851,17624,-2174,21.5,TRUE,0,FALSE,19025,17741,2174,21.1
FALSE,FALSE,0,FALSE,14448,17263,-2969,15.6,TRUE,1,TRUE,17417,18398,2969,22.5
TRUE,TRUE,0,FALSE,15045,16887,220,22.1,FALSE,0,FALSE,14825,17171,-220,19.9
TRUE,TRUE,2,TRUE,17267,17580,-356,20.3,FALSE,0,FALSE,17623,17988,356,18
TRUE,TRUE,0,FALSE,17706,18003,1893,19.4,FALSE,1,TRUE,15813,17240,-1893,19.3
FALSE,TRUE,0,FALSE,15576,16352,-887,22.1,FALSE,1,FALSE,16463,18230,887,19.7
TRUE,TRUE,1,TRUE,17084,18215,2439,22.7,FALSE,0,FALSE,14645,16145,-2439,20.8
FALSE,TRUE,1,TRUE,15614,16000,-2683,19.6,FALSE,1,FALSE,18297,19323,2683,22.3
TRUE,TRUE,1,TRUE,19602,20259,5238,23.6,FALSE,0,FALSE,14364,17605,-5238,20.9
FALSE,TRUE,0,FALSE,15409,18219,-2550,24.7,FALSE,1,TRUE,17959,19011,2550,25.6
TRUE,TRUE,0,FALSE,14298,15101,852,17.1,FALSE,0,FALSE,13446,15127,-852,21.3
TRUE,TRUE,2,TRUE,18507,19423,3756,24.5,FALSE,0,FALSE,14751,17669,-3756,24.7
FALSE,FALSE,0,FALSE,16179,18305,-97,26.3,TRUE,2,TRUE,16276,17191,97,22.1
TRUE,TRUE,1,TRUE,17018,19495,1463,23.8,FALSE,0,FALSE,15555,17924,-1463,21.9
FALSE,FALSE,1,TRUE,15306,16874,-961,22,TRUE,0,FALSE,16267,18301,961,25.6
FALSE,TRUE,0,FALSE,15079,18092,-1226,19.6,FALSE,0,FALSE,16305,19470,1226,26.1
TRUE,TRUE,1,TRUE,17622,17879,173,19.2,FALSE,0,FALSE,17449,17838,-173,22.7
FALSE,TRUE,0,FALSE,17341,19621,1266,20.3,FALSE,0,FALSE,16075,17851,-1266,19.3
FALSE,TRUE,0,FALSE,15868,16452,-585,20.1,FALSE,0,FALSE,16453,17247,585,24.2
TRUE,FALSE,1,TRUE,17170,18583,-522,20.4,TRUE,0,FALSE,17692,18357,522,19.2
FALSE,FALSE,1,TRUE,15716,17135,-3393,18.9,TRUE,0,FALSE,19109,18312,3393,20.6
FALSE,FALSE,0,FALSE,15036,17957,-2855,19.8,TRUE,1,TRUE,17891,20410,2855,26.9
TRUE,FALSE,0,FALSE,16608,18490,-114,20.1,TRUE,1,TRUE,16722,17131,114,20
FALSE,FALSE,0,FALSE,16116,17070,-77,19.6,TRUE,1,TRUE,16193,16654,77,20.4
TRUE,TRUE,1,TRUE,21386,20807,7420,26.4,FALSE,0,FALSE,13966,14938,-7420,19
FALSE,FALSE,0,FALSE,16441,16272,132,21.8,TRUE,1,TRUE,16309,18885,-132,20.3
FALSE,FALSE,0,FALSE,15446,16131,-1995,19.8,TRUE,1,TRUE,17441,17523,1995,21.6
FALSE,TRUE,0,FALSE,15799,16589,-1069,22.4,FALSE,0,FALSE,16868,18490,1069,21.5
TRUE,FALSE,1,TRUE,17909,18562,-292,21.4,TRUE,0,FALSE,18201,19068,292,20.5
FALSE,FALSE,0,FALSE,15309,16938,-4962,17.5,TRUE,1,FALSE,20271,19250,4962,24.2
TRUE,TRUE,1,TRUE,19077,18861,3669,21.5,FALSE,0,FALSE,15408,15831,-3669,20.7
FALSE,TRUE,0,FALSE,15321,17311,-2338,17.1,FALSE,0,FALSE,17659,20035,2338,22.5
FALSE,FALSE,0,FALSE,14522,15305,-3596,21.1,TRUE,1,FALSE,18118,18043,3596,23.6
FALSE,FALSE,2,TRUE,17996,18896,1295,20.8,TRUE,0,FALSE,16701,18461,-1295,22.7
FALSE,TRUE,1,TRUE,16447,18423,-168,20.1,FALSE,0,FALSE,16615,18047,168,22.4
FALSE,FALSE,0,FALSE,13068,15506,-5375,19.8,TRUE,2,TRUE,18443,19931,5375,23.5
FALSE,TRUE,0,FALSE,17757,18821,2341,21.7,FALSE,1,TRUE,15416,16596,-2341,18.5
FALSE,TRUE,0,FALSE,17459,17338,-531,22.6,FALSE,0,FALSE,17990,18415,531,20
TRUE,FALSE,0,FALSE,14068,17057,-3083,20.6,TRUE,0,FALSE,17151,19296,3083,25.2
FALSE,FALSE,0,FALSE,13960,15667,-4808,20.2,TRUE,1,TRUE,18768,19765,4808,24.1
TRUE,FALSE,1,FALSE,18255,17685,-1237,20.6,TRUE,0,FALSE,19492,18559,1237,20.3
TRUE,TRUE,0,FALSE,17134,19465,408,20.7,FALSE,1,TRUE,16726,18723,-408,23.6
FALSE,TRUE,0,FALSE,17487,17660,274,21.1,FALSE,1,TRUE,17213,18119,-274,19.8
FALSE,TRUE,0,FALSE,16335,17339,-956,19.2,FALSE,1,FALSE,17291,17323,956,20.2
TRUE,TRUE,1,FALSE,16405,18502,861,23.9,FALSE,1,TRUE,15544,17424,-861,23.3
FALSE,TRUE,0,FALSE,14145,15252,-5471,18.6,FALSE,2,TRUE,19616,19733,5471,22.8
TRUE,FALSE,0,FALSE,16419,17295,159,23.3,TRUE,2,TRUE,16260,16932,-159,19.4
TRUE,TRUE,0,FALSE,14482,17114,-3335,19.8,FALSE,2,TRUE,17817,19616,3335,24.8
TRUE,TRUE,1,TRUE,15967,17855,803,20.3,FALSE,0,FALSE,15164,17057,-803,22.6
FALSE,FALSE,0,FALSE,16093,17056,-700,20.9,TRUE,0,FALSE,16793,18837,700,19.2
TRUE,TRUE,0,FALSE,20827,19657,5491,21.5,FALSE,0,FALSE,15336,15017,-5491,18.3
FALSE,FALSE,1,TRUE,14697,17818,-1620,22.2,TRUE,0,FALSE,16317,19473,1620,25.5
FALSE,FALSE,0,FALSE,17702,16589,-1478,19.8,TRUE,0,FALSE,19180,18246,1478,20.2
FALSE,FALSE,1,TRUE,14730,17103,-4406,24.6,TRUE,1,FALSE,19136,19766,4406,23.3
FALSE,FALSE,0,FALSE,16876,16812,-1015,23.8,TRUE,0,FALSE,17891,17843,1015,21.2
TRUE,FALSE,0,FALSE,16203,17059,-5057,18.7,TRUE,1,TRUE,21260,20791,5057,25.5
FALSE,TRUE,1,FALSE,17214,18232,1465,21.9,FALSE,1,TRUE,15749,17000,-1465,19.3
TRUE,FALSE,1,TRUE,14019,17177,-3720,20.6,TRUE,0,FALSE,17739,19303,3720,25.1
FALSE,FALSE,0,FALSE,16163,16956,-1825,20.1,TRUE,1,TRUE,17988,18130,1825,19.6
FALSE,FALSE,2,TRUE,15745,17708,-2082,22.5,TRUE,0,FALSE,17827,18713,2082,26.4
TRUE,FALSE,0,FALSE,18933,19905,2109,21,TRUE,0,FALSE,16824,16751,-2109,19.4
TRUE,FALSE,1,TRUE,16452,19169,772,26.6,TRUE,0,FALSE,15680,18467,-772,21.5
FALSE,TRUE,0,FALSE,16527,17257,1338,22.5,FALSE,0,FALSE,15189,17642,-1338,19.1
FALSE,FALSE,0,FALSE,16977,16961,841,22.2,TRUE,0,FALSE,16136,17639,-841,21.6
FALSE,FALSE,0,FALSE,13874,15799,-2933,21.9,TRUE,2,TRUE,16807,17958,2933,21.5
FALSE,FALSE,2,TRUE,17272,18189,-88,21,TRUE,0,FALSE,17360,17634,88,22.3
FALSE,FALSE,0,FALSE,15125,17217,-3346,22.3,TRUE,2,TRUE,18471,18902,3346,21.9
FALSE,FALSE,0,FALSE,14691,17573,-4024,20.7,TRUE,1,TRUE,18715,19572,4024,24.2
FALSE,TRUE,0,FALSE,16961,18707,1155,24,FALSE,1,TRUE,15806,17839,-1155,20.1
TRUE,FALSE,0,FALSE,16688,18637,1004,21.5,TRUE,0,FALSE,15684,18179,-1004,23.1
TRUE,TRUE,1,FALSE,17143,18702,2043,23.7,FALSE,1,TRUE,15100,16836,-2043,23.6
TRUE,TRUE,1,FALSE,18097,18058,811,24.3,FALSE,1,TRUE,17286,17632,-811,19.4
TRUE,TRUE,1,TRUE,19276,19210,4275,23.7,FALSE,0,FALSE,15001,16267,-4275,20.5
FALSE,FALSE,1,TRUE,17114,18783,-218,21,TRUE,0,FALSE,17332,19623,218,22.6
TRUE,FALSE,0,FALSE,16602,16879,-786,16.3,TRUE,0,FALSE,17388,17687,786,20.6
FALSE,FALSE,0,FALSE,14975,15932,-3359,19.4,TRUE,1,TRUE,18334,18187,3359,22.1
TRUE,FALSE,1,TRUE,15843,16910,-2292,20.6,TRUE,0,FALSE,18135,17720,2292,21
FALSE,FALSE,0,FALSE,15777,18110,-1838,20.3,TRUE,1,TRUE,17615,18476,1838,21.4
TRUE,TRUE,0,FALSE,17142,18615,2121,22.1,FALSE,0,FALSE,15021,16802,-2121,20
TRUE,TRUE,0,FALSE,18027,17905,2394,21.7,FALSE,1,TRUE,15633,17032,-2394,21.9
TRUE,TRUE,1,TRUE,16003,17885,-1084,23.8,FALSE,0,FALSE,17087,19517,1084,24.4
TRUE,FALSE,1,TRUE,19116,19104,1159,22,TRUE,0,FALSE,17957,15960,-1159,16.9
TRUE,FALSE,1,TRUE,18078,18102,1328,19.2,TRUE,0,FALSE,16750,16996,-1328,19.7
TRUE,FALSE,1,TRUE,18011,18540,1522,24.3,TRUE,0,FALSE,16489,18263,-1522,21
FALSE,TRUE,0,FALSE,15336,16216,-3534,19.6,FALSE,1,TRUE,18870,18030,3534,20.8
FALSE,FALSE,1,TRUE,17273,18685,292,22.6,TRUE,0,FALSE,16981,17925,-292,22.5
FALSE,TRUE,0,FALSE,17875,18320,2561,20.3,FALSE,0,FALSE,15314,16445,-2561,17.9
FALSE,FALSE,0,FALSE,17215,17349,-1908,19.8,TRUE,0,FALSE,19123,18343,1908,23.5
TRUE,FALSE,0,FALSE,15579,16747,-1815,20.4,TRUE,2,TRUE,17394,18056,1815,20.5
FALSE,FALSE,0,FALSE,16479,16357,-266,23,TRUE,2,TRUE,16745,16422,266,18.6
FALSE,FALSE,1,TRUE,13918,17189,-1382,20.9,TRUE,0,FALSE,15300,17460,1382,26
TRUE,FALSE,2,TRUE,17615,19117,2643,21.8,TRUE,0,FALSE,14972,15777,-2643,19.4
FALSE,TRUE,1,TRUE,15848,18490,1259,25.1,FALSE,0,FALSE,14589,17770,-1259,22
FALSE,TRUE,0,FALSE,15941,17560,1231,22.8,FALSE,0,FALSE,14710,17467,-1231,21.2
TRUE,TRUE,2,TRUE,14448,17294,-2279,19.8,FALSE,0,FALSE,16727,18252,2279,23.9
TRUE,TRUE,0,FALSE,15719,19029,753,23,FALSE,1,TRUE,14966,18766,-753,23.6
FALSE,FALSE,0,FALSE,17139,16389,-201,19.9,TRUE,1,TRUE,17340,17452,201,16.7
FALSE,FALSE,1,TRUE,15977,17115,1033,22.4,TRUE,0,FALSE,14944,15906,-1033,18.5
TRUE,TRUE,1,TRUE,14938,17538,-353,24.6,FALSE,0,FALSE,15291,17908,353,23
FALSE,TRUE,0,FALSE,17187,18709,619,19.9,FALSE,1,TRUE,16568,17688,-619,21.4
TRUE,TRUE,1,FALSE,17558,17905,-483,20.2,FALSE,1,TRUE,18041,18332,483,20.5
TRUE,TRUE,2,TRUE,17945,18758,2404,26.8,FALSE,0,FALSE,15541,17629,-2404,26
TRUE,FALSE,0,FALSE,15151,16795,-244,20.3,TRUE,0,FALSE,15395,16717,244,21.5
TRUE,FALSE,0,FALSE,14983,16993,-2653,20.8,TRUE,1,TRUE,17636,18365,2653,20.7
TRUE,FALSE,1,TRUE,16527,16322,94,22.9,TRUE,0,FALSE,16433,16809,-94,19
FALSE,FALSE,1,TRUE,16359,17830,-736,20.4,TRUE,1,FALSE,17095,18056,736,23.2
TRUE,TRUE,1,TRUE,19038,18856,4034,23.9,FALSE,0,FALSE,15004,16918,-4034,22.8
FALSE,FALSE,1,TRUE,15976,17352,609,23.2,TRUE,1,FALSE,15367,17961,-609,23.5
FALSE,FALSE,0,FALSE,13512,16628,-2327,22.4,TRUE,1,TRUE,15839,17370,2327,21.5
FALSE,TRUE,0,FALSE,14923,17285,-3916,17.3,FALSE,1,TRUE,18839,20168,3916,23.9
FALSE,TRUE,1,FALSE,16124,17227,-725,22.5,FALSE,1,TRUE,16849,18152,725,24.6
FALSE,FALSE,0,FALSE,14058,16215,-2675,21.3,TRUE,1,FALSE,16733,18407,2675,22.9
FALSE,TRUE,0,FALSE,14422,16781,-2346,20.1,FALSE,0,FALSE,16768,18652,2346,23.7
TRUE,FALSE,1,TRUE,16539,19570,-65,24.2,TRUE,0,FALSE,16604,18362,65,23
FALSE,FALSE,0,FALSE,15794,16652,-3750,20.3,TRUE,1,TRUE,19544,18099,3750,21.2
FALSE,TRUE,0,FALSE,16867,17923,150,22.8,FALSE,1,TRUE,16717,18369,-150,22.2
FALSE,TRUE,0,FALSE,17197,18127,-1383,20.5,FALSE,0,FALSE,18580,19097,1383,23.2
TRUE,TRUE,1,FALSE,15881,16164,-1441,20.4,FALSE,1,TRUE,17322,17102,1441,19.7
TRUE,FALSE,0,FALSE,19373,19208,4898,22.8,TRUE,1,TRUE,14475,16116,-4898,19
FALSE,FALSE,0,FALSE,16548,17430,503,23,TRUE,2,TRUE,16045,17624,-503,21.1
FALSE,FALSE,0,FALSE,14126,15246,-6319,20,TRUE,1,TRUE,20445,18637,6319,19.3
TRUE,FALSE,0,FALSE,16518,17024,238,20.2,TRUE,0,FALSE,16280,16749,-238,21
TRUE,TRUE,0,FALSE,15897,17075,-3048,21.5,FALSE,1,TRUE,18945,20250,3048,24.5
TRUE,FALSE,0,FALSE,22845,19608,8234,25,TRUE,0,FALSE,14611,13582,-8234,15.8
FALSE,FALSE,1,TRUE,14445,17594,-925,23.2,TRUE,0,FALSE,15370,17553,925,21.1
TRUE,TRUE,1,FALSE,17293,18795,1339,23.1,FALSE,1,TRUE,15954,18181,-1339,23.6
FALSE,TRUE,0,FALSE,17239,18339,1201,21,FALSE,1,TRUE,16038,18385,-1201,22.5
TRUE,FALSE,2,TRUE,18339,19765,-59,23.3,TRUE,0,FALSE,18398,18534,59,21.2
TRUE,FALSE,1,TRUE,16541,19056,1294,24.9,TRUE,0,FALSE,15247,17891,-1294,21.1
TRUE,FALSE,1,TRUE,20488,17390,4535,20.1,TRUE,0,FALSE,15953,15420,-4535,19.1
TRUE,FALSE,1,FALSE,15072,17951,-1925,18.9,TRUE,0,FALSE,16997,18855,1925,24.4
FALSE,FALSE,1,TRUE,15433,18889,-1629,21.8,TRUE,0,FALSE,17062,19176,1629,24.9
TRUE,FALSE,0,FALSE,15766,16923,-856,21.3,TRUE,1,TRUE,16622,17565,856,23.9
TRUE,TRUE,1,TRUE,18459,17936,2955,18.7,FALSE,0,FALSE,15504,16812,-2955,19.6
FALSE,TRUE,2,TRUE,16467,17952,1418,20.9,FALSE,0,FALSE,15049,17823,-1418,23.1
TRUE,TRUE,1,TRUE,18384,18583,1263,20.8,FALSE,0,FALSE,17121,18975,-1263,20.7
TRUE,TRUE,1,FALSE,18479,19708,3187,23.2,FALSE,1,TRUE,15292,17897,-3187,25.8
FALSE,FALSE,1,FALSE,14812,16674,-3244,19.9,TRUE,1,TRUE,18056,17882,3244,20.5
TRUE,TRUE,1,TRUE,14702,17961,-1626,21.2,FALSE,1,FALSE,16328,18810,1626,24.3
TRUE,TRUE,0,FALSE,15715,18159,-1235,24.6,FALSE,1,TRUE,16950,19115,1235,25.2
FALSE,TRUE,0,FALSE,16736,18330,1271,22.7,FALSE,0,FALSE,15465,17799,-1271,22.1
FALSE,FALSE,1,TRUE,17344,18253,706,18.4,TRUE,1,FALSE,16638,17487,-706,20.6
TRUE,FALSE,1,FALSE,18625,17323,1430,19,TRUE,1,TRUE,17195,16407,-1430,21.5
TRUE,FALSE,0,FALSE,13825,15977,-2891,18.5,TRUE,0,FALSE,16716,19173,2891,22.9
FALSE,FALSE,1,TRUE,14604,17494,-3333,19.8,TRUE,1,FALSE,17937,17873,3333,24.5
FALSE,FALSE,0,FALSE,15770,16913,-2580,24.1,TRUE,1,FALSE,18350,20220,2580,22.4
TRUE,FALSE,0,FALSE,16566,18723,-1838,21.4,TRUE,2,TRUE,18404,19850,1838,23.8
FALSE,TRUE,0,FALSE,17129,17586,1440,22.8,FALSE,1,TRUE,15689,17339,-1440,21.1
FALSE,FALSE,0,FALSE,16176,18293,-992,25.4,TRUE,1,TRUE,17168,19097,992,26.2
TRUE,FALSE,1,FALSE,21056,19016,5433,20.6,TRUE,0,FALSE,15623,15652,-5433,19.3
TRUE,TRUE,1,TRUE,20471,20212,3941,23,FALSE,0,FALSE,16530,17168,-3941,19.8
TRUE,FALSE,0,FALSE,18823,18188,4509,24.5,TRUE,1,TRUE,14314,15935,-4509,21.8
TRUE,TRUE,0,FALSE,17204,19558,2385,25.5,FALSE,1,TRUE,14819,18592,-2385,21.5
TRUE,TRUE,0,FALSE,17628,14939,4007,18.4,FALSE,0,FALSE,13621,13969,-4007,18.3
FALSE,TRUE,1,TRUE,16562,17625,438,18,FALSE,0,FALSE,16124,17429,-438,20.1
FALSE,FALSE,1,TRUE,16543,17893,-3032,21.3,TRUE,0,FALSE,19575,18895,3032,24
FALSE,FALSE,0,FALSE,19292,18197,4062,21.3,TRUE,2,TRUE,15230,15865,-4062,19.1
FALSE,FALSE,0,FALSE,15590,18314,-816,21.1,TRUE,0,FALSE,16406,17982,816,22.7
TRUE,FALSE,0,FALSE,15885,17852,2107,25,TRUE,1,TRUE,13778,17388,-2107,23.1
TRUE,FALSE,1,TRUE,15936,17184,-2542,23.3,TRUE,0,FALSE,18478,18192,2542,23.3
TRUE,TRUE,0,FALSE,15040,16582,-952,20.5,FALSE,2,TRUE,15992,17850,952,20.5
TRUE,FALSE,1,TRUE,15927,17735,1824,19.8,TRUE,0,FALSE,14103,17097,-1824,20.2
FALSE,FALSE,0,FALSE,14231,17522,-2681,23,TRUE,2,TRUE,16912,19399,2681,24.8
FALSE,FALSE,0,FALSE,14998,17859,-993,21.8,TRUE,1,TRUE,15991,19009,993,23.6
FALSE,FALSE,1,FALSE,18315,17665,-337,23.2,TRUE,1,TRUE,18652,18960,337,19.7
TRUE,TRUE,1,TRUE,16977,19499,3115,19.9,FALSE,0,FALSE,13862,17336,-3115,21.7
TRUE,TRUE,1,TRUE,14857,17267,-2748,22.8,FALSE,1,FALSE,17605,19684,2748,20.8
FALSE,TRUE,0,FALSE,14819,15937,-3477,18.3,FALSE,1,TRUE,18296,19238,3477,22.7
FALSE,TRUE,1,TRUE,15570,18813,-61,23.6,FALSE,0,FALSE,15631,18913,61,26
FALSE,FALSE,0,FALSE,14231,15543,-5316,20.8,TRUE,0,FALSE,19547,19191,5316,21.4
TRUE,TRUE,1,TRUE,19558,19133,3257,21.5,FALSE,0,FALSE,16301,17726,-3257,20.3
TRUE,TRUE,1,TRUE,18531,18550,1492,21.7,FALSE,0,FALSE,17039,19226,-1492,21.4
FALSE,FALSE,0,FALSE,15211,16678,-1310,17.9,TRUE,0,FALSE,16521,18273,1310,22.2
FALSE,FALSE,2,TRUE,13683,16232,-2032,19.8,TRUE,0,FALSE,15715,18108,2032,26.2
TRUE,TRUE,0,FALSE,16887,19954,846,23.2,FALSE,1,TRUE,16041,19274,-846,24.2
TRUE,TRUE,0,FALSE,16317,17928,-248,22.8,FALSE,2,TRUE,16565,19485,248,22.5
TRUE,TRUE,1,FALSE,19000,18072,4181,21,FALSE,0,FALSE,14819,16488,-4181,19.3
FALSE,FALSE,0,FALSE,16421,18535,121,22.2,TRUE,1,TRUE,16300,18658,-121,24
TRUE,TRUE,1,TRUE,16341,19567,1567,23.6,FALSE,1,FALSE,14774,17930,-1567,20.3
TRUE,TRUE,0,FALSE,18901,19110,2972,24.4,FALSE,0,FALSE,15929,17311,-2972,20.6
TRUE,FALSE,0,FALSE,13860,16835,-2807,19.3,TRUE,0,FALSE,16667,18372,2807,24.9
FALSE,FALSE,0,FALSE,15317,18310,-1742,22.5,TRUE,1,TRUE,17059,18667,1742,22.1
TRUE,TRUE,1,TRUE,20111,18316,4588,23.1,FALSE,0,FALSE,15523,17386,-4588,15.3
TRUE,TRUE,1,TRUE,18631,19229,3123,22.9,FALSE,0,FALSE,15508,15865,-3123,19.4
FALSE,TRUE,0,FALSE,14766,16685,-1174,23.6,FALSE,1,TRUE,15940,18163,1174,19
TRUE,FALSE,0,FALSE,15967,17567,-844,22.2,TRUE,0,FALSE,16811,18207,844,23.4
TRUE,TRUE,1,TRUE,18117,19804,5779,23.6,FALSE,0,FALSE,12338,14592,-5779,19.7
TRUE,TRUE,1,TRUE,16379,17323,377,20.7,FALSE,0,FALSE,16002,16951,-377,24.3
TRUE,FALSE,0,FALSE,16530,17332,-673,22.6,TRUE,0,FALSE,17203,18748,673,19.8
FALSE,FALSE,0,FALSE,15451,17544,-3380,24.3,TRUE,0,FALSE,18831,20203,3380,23.4
TRUE,FALSE,1,FALSE,17553,19041,2034,20.3,TRUE,1,TRUE,15519,17039,-2034,21.1
TRUE,TRUE,0,FALSE,18721,19444,2411,24,FALSE,1,TRUE,16310,17592,-2411,21.9
TRUE,TRUE,0,FALSE,16611,18323,912,21.6,FALSE,1,TRUE,15699,17818,-912,19.5
FALSE,TRUE,1,TRUE,15059,17260,-345,19.6,FALSE,0,FALSE,15404,17975,345,23.7
FALSE,FALSE,0,FALSE,14715,17406,-2290,19.8,TRUE,1,TRUE,17005,18740,2290,22.9
FALSE,FALSE,1,TRUE,16753,18557,204,23.3,TRUE,1,FALSE,16549,19387,-204,21.7
FALSE,FALSE,0,FALSE,15676,17356,-2653,21,TRUE,1,TRUE,18329,17732,2653,19.1
FALSE,FALSE,0,FALSE,17616,18731,356,19.5,TRUE,0,FALSE,17260,18166,-356,20.8
TRUE,TRUE,2,TRUE,16727,18834,613,22,FALSE,0,FALSE,16114,19436,-613,24.7
TRUE,TRUE,1,TRUE,19626,20682,4400,22.8,FALSE,0,FALSE,15226,17590,-4400,22.3
TRUE,FALSE,0,FALSE,16763,17822,54,20.7,TRUE,1,TRUE,16709,17941,-54,21.4
TRUE,TRUE,0,FALSE,15686,18036,126,20.6,FALSE,0,FALSE,15560,17746,-126,22.4
TRUE,FALSE,1,TRUE,14502,17745,-430,21.7,TRUE,0,FALSE,14932,17692,430,22.3
FALSE,FALSE,0,FALSE,15130,16749,-2528,22,TRUE,0,FALSE,17658,18075,2528,21.8
TRUE,TRUE,0,FALSE,16718,18415,558,20,FALSE,0,FALSE,16160,19723,-558,22.5
TRUE,TRUE,0,FALSE,16929,18100,1134,20,FALSE,1,TRUE,15795,16954,-1134,23.9
TRUE,FALSE,0,FALSE,16407,18871,-949,16.8,TRUE,1,TRUE,17356,19168,949,21.6
TRUE,TRUE,1,TRUE,19165,20050,4297,21.9,FALSE,0,FALSE,14868,17408,-4297,17.7
FALSE,TRUE,1,FALSE,15698,16251,-1838,18.9,FALSE,1,TRUE,17536,17681,1838,21.1
FALSE,FALSE,0,FALSE,15398,17682,-2115,18.4,TRUE,0,FALSE,17513,18829,2115,23.3
TRUE,TRUE,2,TRUE,17201,17943,2184,18.6,FALSE,0,FALSE,15017,17524,-2184,21.1
TRUE,FALSE,1,FALSE,15964,18056,-406,19.9,TRUE,1,TRUE,16370,19106,406,19
FALSE,FALSE,0,FALSE,13121,14672,-6707,17.2,TRUE,2,TRUE,19828,19924,6707,20.3
FALSE,FALSE,1,TRUE,15701,17966,826,24.5,TRUE,0,FALSE,14875,18348,-826,19.3
TRUE,TRUE,0,FALSE,17917,17997,-1074,19.9,FALSE,1,TRUE,18991,19026,1074,23.3
TRUE,TRUE,0,FALSE,18288,19406,2616,20.7,FALSE,1,TRUE,15672,16298,-2616,17.7
TRUE,TRUE,1,TRUE,18857,18670,1292,19.5,FALSE,0,FALSE,17565,17858,-1292,20.7
FALSE,TRUE,0,FALSE,17374,17514,562,21.4,FALSE,1,TRUE,16812,17271,-562,20.4
FALSE,TRUE,1,FALSE,17620,18344,1345,22.7,FALSE,1,TRUE,16275,16983,-1345,19.9
FALSE,FALSE,0,FALSE,17238,17907,-2693,20.4,TRUE,0,FALSE,19931,18616,2693,22.8
FALSE,TRUE,1,FALSE,15709,17814,-1696,20.7,FALSE,1,TRUE,17405,19562,1696,23.9
FALSE,FALSE,1,FALSE,17693,19111,-384,20.2,TRUE,1,TRUE,18077,19456,384,19.9
TRUE,FALSE,0,FALSE,16343,18250,77,23.3,TRUE,1,TRUE,16266,18011,-77,20.3
TRUE,FALSE,1,TRUE,17033,18063,2789,22.5,TRUE,0,FALSE,14244,16063,-2789,21
FALSE,TRUE,0,FALSE,15956,17947,56,22.9,FALSE,1,TRUE,15900,18534,-56,23.1
FALSE,FALSE,0,FALSE,14780,16972,-2568,21.5,TRUE,1,TRUE,17348,19286,2568,21.5
TRUE,FALSE,2,TRUE,16709,18855,728,22.2,TRUE,0,FALSE,15981,16760,-728,22.4
TRUE,TRUE,1,TRUE,18748,17735,2236,18.1,FALSE,0,FALSE,16512,17398,-2236,19.4
FALSE,TRUE,0,FALSE,15598,18672,-518,20.4,FALSE,0,FALSE,16116,17804,518,22.5
FALSE,FALSE,0,FALSE,15108,17595,-3086,20.2,TRUE,1,TRUE,18194,19296,3086,22.2
FALSE,FALSE,0,FALSE,13679,16597,-4365,20.9,TRUE,1,TRUE,18044,19480,4365,24.3
TRUE,TRUE,2,TRUE,17453,17851,1478,23.7,FALSE,0,FALSE,15975,17368,-1478,19.9
FALSE,FALSE,0,FALSE,15120,16829,-5023,19.1,TRUE,2,TRUE,20143,18203,5023,21.7
TRUE,TRUE,0,FALSE,17491,16826,233,20,FALSE,0,FALSE,17258,18047,-233,21.6
TRUE,FALSE,0,FALSE,16798,18520,916,22.5,TRUE,0,FALSE,15882,17740,-916,23.6
TRUE,FALSE,2,TRUE,14379,17751,-411,24.7,TRUE,0,FALSE,14790,17321,411,22.8
FALSE,TRUE,0,FALSE,15953,16466,-1047,22.3,FALSE,1,TRUE,17000,16659,1047,17.9
TRUE,FALSE,0,FALSE,17303,18048,3111,21.6,TRUE,1,TRUE,14192,16461,-3111,16.5
TRUE,TRUE,1,TRUE,16114,18458,1694,23.3,FALSE,1,FALSE,14420,17259,-1694,21
TRUE,TRUE,1,TRUE,21314,19360,6950,24.5,FALSE,0,FALSE,14364,15824,-6950,19.3
TRUE,TRUE,2,TRUE,15660,18225,413,22.4,FALSE,0,FALSE,15247,17278,-413,22.6
FALSE,TRUE,1,TRUE,17169,17934,-92,21.6,FALSE,1,FALSE,17261,19345,92,22.1
TRUE,FALSE,2,TRUE,15649,17052,-2822,18.6,TRUE,0,FALSE,18471,18292,2822,24.8
TRUE,TRUE,0,FALSE,17088,18086,180,20.4,FALSE,2,TRUE,16908,17193,-180,23
TRUE,TRUE,1,TRUE,18042,19223,2006,23.9,FALSE,1,FALSE,16036,18877,-2006,22.2
FALSE,FALSE,0,FALSE,15424,17248,-4585,19.1,TRUE,2,TRUE,20009,20373,4585,22.8
TRUE,FALSE,0,FALSE,15459,18000,-174,23,TRUE,2,TRUE,15633,17769,174,21.2
TRUE,TRUE,0,FALSE,19588,19987,3864,21.7,FALSE,0,FALSE,15724,16999,-3864,16.2
TRUE,TRUE,1,FALSE,16951,18684,-32,20,FALSE,1,TRUE,16983,18888,32,21.6
FALSE,FALSE,1,TRUE,15533,18431,-3728,21.4,TRUE,0,FALSE,19261,20510,3728,25.9
FALSE,TRUE,0,FALSE,17653,18461,2962,23.1,FALSE,0,FALSE,14691,16031,-2962,21
FALSE,FALSE,0,FALSE,14811,17429,-2076,22.4,TRUE,0,FALSE,16887,18108,2076,23.5
TRUE,TRUE,0,FALSE,14538,15395,-1266,17.7,FALSE,1,TRUE,15804,16650,1266,20
TRUE,TRUE,0,FALSE,20188,18981,2735,22.6,FALSE,0,FALSE,17453,17905,-2735,19.8
FALSE,FALSE,0,FALSE,16021,19551,-470,21.6,TRUE,0,FALSE,16491,18027,470,23.7
TRUE,FALSE,0,FALSE,16112,17631,922,20.7,TRUE,2,TRUE,15190,17485,-922,19.9
TRUE,FALSE,1,TRUE,15967,18611,-999,23.7,TRUE,1,FALSE,16966,19389,999,25
FALSE,FALSE,0,FALSE,13126,17066,-3823,17.3,TRUE,2,TRUE,16949,19679,3823,23.4
TRUE,TRUE,2,TRUE,17501,19153,2122,24.8,FALSE,0,FALSE,15379,17195,-2122,22.9
TRUE,TRUE,1,TRUE,18826,20300,3988,22.5,FALSE,1,FALSE,14838,16054,-3988,19.5
FALSE,FALSE,1,TRUE,14165,17829,-1963,21.8,TRUE,0,FALSE,16128,17874,1963,20.5
FALSE,TRUE,1,TRUE,18110,18193,2607,19.3,FALSE,0,FALSE,15503,17536,-2607,23.6
FALSE,TRUE,1,FALSE,16731,19377,1675,23.8,FALSE,1,TRUE,15056,17355,-1675,21.8
FALSE,FALSE,0,FALSE,16984,18400,-1720,20.6,TRUE,1,TRUE,18704,19776,1720,22.6
TRUE,FALSE,1,TRUE,14341,17715,-1929,23.3,TRUE,0,FALSE,16270,18395,1929,23.3
TRUE,TRUE,1,TRUE,17667,19486,2461,23.7,FALSE,0,FALSE,15206,17707,-2461,21.7
FALSE,FALSE,0,FALSE,13704,16135,-5578,20.2,TRUE,2,TRUE,19282,18615,5578,24.7
FALSE,TRUE,1,TRUE,15863,17107,-3479,19.1,FALSE,0,FALSE,19342,19312,3479,22.2
FALSE,FALSE,0,FALSE,14834,17374,-4063,19.8,TRUE,0,FALSE,18897,19972,4063,24.3
TRUE,FALSE,0,FALSE,19246,19668,2861,23.1,TRUE,0,FALSE,16385,18236,-2861,21.3
TRUE,TRUE,2,TRUE,17091,17740,940,21.4,FALSE,0,FALSE,16151,17237,-940,21
FALSE,FALSE,1,TRUE,13803,15972,-5226,18.1,TRUE,1,FALSE,19029,19673,5226,25.9
TRUE,TRUE,2,TRUE,16485,19097,-264,25,FALSE,0,FALSE,16749,18782,264,23.3
FALSE,FALSE,0,FALSE,14876,18374,-1187,21.8,TRUE,1,TRUE,16063,19935,1187,22.2
TRUE,TRUE,0,FALSE,17594,18431,2264,23.7,FALSE,0,FALSE,15330,17425,-2264,19
FALSE,FALSE,0,FALSE,16230,17275,-2725,22.5,TRUE,1,TRUE,18955,19392,2725,22.1
TRUE,TRUE,1,TRUE,15239,18213,-251,22.2,FALSE,1,FALSE,15490,17982,251,21.3
FALSE,TRUE,0,FALSE,16247,16555,-3023,18.9,FALSE,0,FALSE,19270,20185,3023,24.4
FALSE,TRUE,0,FALSE,15223,18081,-375,21.6,FALSE,1,TRUE,15598,17901,375,22.6
FALSE,TRUE,1,TRUE,16099,18159,-1367,24.4,FALSE,1,FALSE,17466,19685,1367,19.7
TRUE,TRUE,0,FALSE,17940,19752,3828,22.4,FALSE,1,TRUE,14112,17203,-3828,20
FALSE,TRUE,0,FALSE,15652,19647,-194,27,FALSE,1,TRUE,15846,19188,194,27.6
FALSE,TRUE,1,TRUE,18161,19168,1926,21.3,FALSE,0,FALSE,16235,16768,-1926,20.2
FALSE,FALSE,0,FALSE,13569,14129,-3535,16.5,TRUE,2,TRUE,17104,17326,3535,21.5
TRUE,FALSE,0,FALSE,18048,18082,1831,24.2,TRUE,2,TRUE,16217,17088,-1831,21.8
FALSE,FALSE,1,TRUE,17046,18406,-190,19.7,TRUE,1,FALSE,17236,18982,190,22.9
TRUE,FALSE,1,TRUE,16647,19826,744,22.7,TRUE,0,FALSE,15903,18948,-744,24.2
TRUE,TRUE,1,TRUE,16283,18397,-152,22.8,FALSE,0,FALSE,16435,18326,152,25.3
TRUE,TRUE,0,FALSE,22433,20086,7621,23,FALSE,1,TRUE,14812,15439,-7621,19.2
FALSE,TRUE,0,FALSE,15429,16480,1043,20.2,FALSE,0,FALSE,14386,17888,-1043,20.3
FALSE,FALSE,0,FALSE,16239,17518,-1289,18.6,TRUE,1,TRUE,17528,18902,1289,20.4
TRUE,TRUE,0,FALSE,18228,19423,3419,25,FALSE,1,TRUE,14809,14714,-3419,19.3
FALSE,TRUE,1,TRUE,16983,18017,-851,23.8,FALSE,1,FALSE,17834,18132,851,22.8
TRUE,FALSE,0,FALSE,16957,18220,1484,20.4,TRUE,0,FALSE,15473,17751,-1484,22.6
TRUE,TRUE,1,TRUE,18962,20021,3833,20.7,FALSE,1,FALSE,15129,17172,-3833,20.3
FALSE,FALSE,1,TRUE,16888,17236,993,20,TRUE,0,FALSE,15895,16453,-993,20.6
FALSE,FALSE,0,FALSE,14993,16201,-3416,20.8,TRUE,1,TRUE,18409,18548,3416,20.6
TRUE,TRUE,1,TRUE,16076,14942,143,18.1,FALSE,0,FALSE,15933,15545,-143,17.8
TRUE,TRUE,0,FALSE,17007,19713,3332,24.2,FALSE,1,TRUE,13675,17303,-3332,19.4
FALSE,FALSE,1,TRUE,16000,16023,-1208,21.2,TRUE,0,FALSE,17208,18549,1208,21
FALSE,TRUE,1,FALSE,16021,18017,-217,20.9,FALSE,1,TRUE,16238,17446,217,23.6
TRUE,FALSE,0,FALSE,17345,18111,1421,18.3,TRUE,1,TRUE,15924,18903,-1421,20.7
FALSE,FALSE,0,FALSE,17976,18454,1642,17.6,TRUE,1,TRUE,16334,16489,-1642,19.5
FALSE,FALSE,0,FALSE,16853,18059,-1590,22.5,TRUE,1,TRUE,18443,19926,1590,24.2
FALSE,TRUE,1,FALSE,16300,18376,286,22.6,FALSE,1,TRUE,16014,18388,-286,23.9
TRUE,TRUE,1,TRUE,16417,18579,1930,24.8,FALSE,0,FALSE,14487,17786,-1930,25.7
FALSE,TRUE,1,TRUE,17466,17536,2887,23.9,FALSE,0,FALSE,14579,15451,-2887,17.4
TRUE,FALSE,1,TRUE,19830,19377,2594,21.7,TRUE,0,FALSE,17236,16892,-2594,18.5
FALSE,FALSE,0,FALSE,16726,18564,897,23.4,TRUE,1,TRUE,15829,18198,-897,21.4
FALSE,TRUE,0,FALSE,17162,18004,778,19.3,FALSE,1,TRUE,16384,17456,-778,20
TRUE,TRUE,1,TRUE,19535,19835,4778,23.1,FALSE,0,FALSE,14757,15511,-4778,17.3
TRUE,FALSE,0,FALSE,15514,18840,-81,23.5,TRUE,0,FALSE,15595,17958,81,26.1
TRUE,TRUE,0,FALSE,16008,19253,344,24.7,FALSE,0,FALSE,15664,17955,-344,26.4
TRUE,TRUE,0,FALSE,16981,19106,2483,23.2,FALSE,1,TRUE,14498,16807,-2483,19
FALSE,FALSE,0,FALSE,14722,17262,-2208,19,TRUE,2,TRUE,16930,20124,2208,21
TRUE,FALSE,0,FALSE,15715,17843,-1425,23.7,TRUE,0,FALSE,17140,19139,1425,22.8
FALSE,FALSE,0,FALSE,16102,19258,-281,25.7,TRUE,1,TRUE,16383,19148,281,25.1
FALSE,TRUE,0,FALSE,14991,17681,-2000,18,FALSE,1,TRUE,16991,19154,2000,20.8
TRUE,TRUE,0,FALSE,19379,18120,3021,21.5,FALSE,0,FALSE,16358,17773,-3021,18.6
TRUE,FALSE,0,FALSE,17101,17725,2294,21.4,TRUE,2,TRUE,14807,15736,-2294,18.2
TRUE,TRUE,0,FALSE,17186,19734,2478,26.3,FALSE,2,TRUE,14708,18629,-2478,20.9
TRUE,FALSE,1,TRUE,15115,19609,-90,21.9,TRUE,1,FALSE,15205,18627,90,21.3
TRUE,FALSE,2,TRUE,16127,17245,1210,23.5,TRUE,0,FALSE,14917,15835,-1210,19.1
TRUE,FALSE,0,FALSE,15445,16320,-3473,18.8,TRUE,0,FALSE,18918,17634,3473,21.7
FALSE,FALSE,0,FALSE,16585,18064,-627,20.7,TRUE,0,FALSE,17212,19062,627,22.2
FALSE,TRUE,1,TRUE,15788,18264,671,24.3,FALSE,0,FALSE,15117,17383,-671,22.8
TRUE,TRUE,1,TRUE,17400,19175,567,23.9,FALSE,0,FALSE,16833,19183,-567,23.7
FALSE,TRUE,1,FALSE,14157,16183,-3421,19.8,FALSE,1,TRUE,17578,19161,3421,23.8
FALSE,TRUE,1,FALSE,14992,18110,-415,22.6,FALSE,1,TRUE,15407,16886,415,22.2
FALSE,TRUE,1,FALSE,17182,18530,946,24.3,FALSE,1,TRUE,16236,18173,-946,22.8
TRUE,TRUE,1,FALSE,16426,17766,846,18.7,FALSE,1,TRUE,15580,19659,-846,23.1
TRUE,FALSE,0,FALSE,16135,16250,-2299,18.4,TRUE,2,TRUE,18434,19461,2299,23.5
TRUE,TRUE,0,FALSE,15833,17979,1284,19.6,FALSE,2,TRUE,14549,17954,-1284,20.2
TRUE,TRUE,2,TRUE,18062,19711,2449,22.3,FALSE,0,FALSE,15613,18565,-2449,23.3
FALSE,FALSE,1,TRUE,14318,17405,-2928,20.7,TRUE,0,FALSE,17246,17515,2928,24
TRUE,FALSE,1,TRUE,14969,16927,-1404,19.5,TRUE,0,FALSE,16373,17436,1404,20.6
TRUE,TRUE,0,FALSE,17177,19119,3368,22.3,FALSE,1,TRUE,13809,16767,-3368,20.5
FALSE,TRUE,0,FALSE,16617,17480,-985,18.4,FALSE,1,TRUE,17602,18921,985,22.2
FALSE,TRUE,0,FALSE,16908,18246,383,20.8,FALSE,1,TRUE,16525,16578,-383,18.2
TRUE,FALSE,2,TRUE,18419,19957,1773,24.6,TRUE,0,FALSE,16646,18004,-1773,24.4
FALSE,TRUE,0,FALSE,15570,15894,-2365,19.8,FALSE,0,FALSE,17935,17337,2365,20.4
FALSE,FALSE,0,FALSE,15016,17172,-2188,21.6,TRUE,1,TRUE,17204,18925,2188,21.7
TRUE,TRUE,1,TRUE,14402,17604,-1506,19.3,FALSE,0,FALSE,15908,18104,1506,22.7
FALSE,FALSE,1,TRUE,14999,15530,-6027,19.2,TRUE,0,FALSE,21026,19485,6027,22.8
FALSE,TRUE,1,TRUE,15149,16969,-1887,21.7,FALSE,0,FALSE,17036,17536,1887,24.1
TRUE,TRUE,1,TRUE,15761,17003,-839,18.7,FALSE,1,FALSE,16600,17803,839,20.6
FALSE,FALSE,0,FALSE,14714,17620,-2484,21.7,TRUE,0,FALSE,17198,19609,2484,23.2
TRUE,TRUE,0,FALSE,15154,15685,1087,20.6,FALSE,0,FALSE,14067,16963,-1087,19.2
TRUE,TRUE,0,FALSE,20998,19521,8347,22.8,FALSE,0,FALSE,12651,14287,-8347,18.1
TRUE,TRUE,0,FALSE,17607,19309,716,21.2,FALSE,1,TRUE,16891,18708,-716,20.4
FALSE,FALSE,0,FALSE,15141,17975,-770,19.6,TRUE,1,TRUE,15911,17779,770,17.8
TRUE,FALSE,1,TRUE,21285,20332,5154,22.9,TRUE,0,FALSE,16131,16495,-5154,17.4
TRUE,FALSE,0,FALSE,16984,17014,1580,21.4,TRUE,0,FALSE,15404,16409,-1580,19.4
FALSE,FALSE,0,FALSE,13489,14875,-2345,19.2,TRUE,1,TRUE,15834,17834,2345,19.8
TRUE,TRUE,2,TRUE,14653,17643,758,22.4,FALSE,0,FALSE,13895,17141,-758,22.1
FALSE,FALSE,0,FALSE,15335,16838,-3983,18.7,TRUE,0,FALSE,19318,20514,3983,24.2
TRUE,TRUE,0,FALSE,15853,17174,-1448,19.2,FALSE,2,TRUE,17301,18082,1448,19.7
FALSE,FALSE,0,FALSE,15476,16691,-2199,19.8,TRUE,1,TRUE,17675,18949,2199,21.8
TRUE,TRUE,2,TRUE,15211,18741,464,20,FALSE,0,FALSE,14747,17221,-464,24.2
FALSE,FALSE,0,FALSE,15796,17121,-1044,18.4,TRUE,1,TRUE,16840,17608,1044,22.6
FALSE,TRUE,1,TRUE,15420,18542,-136,23.7,FALSE,1,FALSE,15556,19349,136,23.7
TRUE,TRUE,1,TRUE,20961,19939,6387,22.5,FALSE,1,FALSE,14574,16486,-6387,18.2
FALSE,TRUE,1,TRUE,17633,18304,-811,21.8,FALSE,0,FALSE,18444,18714,811,23
TRUE,TRUE,1,TRUE,16647,20048,2179,24,FALSE,0,FALSE,14468,17385,-2179,22.6
TRUE,FALSE,0,FALSE,14141,16555,-2749,21.1,TRUE,0,FALSE,16890,17355,2749,20.6
TRUE,FALSE,1,TRUE,16374,18573,825,26.3,TRUE,0,FALSE,15549,17507,-825,25.3
FALSE,FALSE,0,FALSE,17125,17861,1294,21,TRUE,1,TRUE,15831,17408,-1294,22.3
FALSE,FALSE,0,FALSE,15531,17609,-1814,21.8,TRUE,1,TRUE,17345,19915,1814,25.6
TRUE,TRUE,1,TRUE,18529,18907,3048,25.2,FALSE,0,FALSE,15481,18435,-3048,20.3
FALSE,FALSE,0,FALSE,14450,15750,-4637,18.6,TRUE,0,FALSE,19087,19105,4637,21
FALSE,FALSE,2,TRUE,18185,19645,2363,20.4,TRUE,0,FALSE,15822,17483,-2363,20.4
FALSE,FALSE,0,FALSE,15423,18346,-89,24.4,TRUE,1,TRUE,15512,18387,89,22.8
FALSE,TRUE,2,TRUE,14675,18039,-1749,23.1,FALSE,0,FALSE,16424,19541,1749,26.4
TRUE,TRUE,1,TRUE,18722,18618,4246,21.2,FALSE,0,FALSE,14476,14738,-4246,17.6
FALSE,TRUE,1,FALSE,14421,18228,-837,23.4,FALSE,1,TRUE,15258,18679,837,22.9
TRUE,TRUE,0,FALSE,17532,18592,1068,23.3,FALSE,0,FALSE,16464,17297,-1068,20
TRUE,TRUE,1,FALSE,19271,18923,4290,24.5,FALSE,0,FALSE,14981,17023,-4290,19.3
FALSE,TRUE,1,TRUE,18655,18368,-942,17.3,FALSE,0,FALSE,19597,18124,942,22.6
FALSE,FALSE,1,FALSE,14164,16392,-5120,20.2,TRUE,0,FALSE,19284,18982,5120,23.2
FALSE,FALSE,1,FALSE,14476,15711,-3638,18,TRUE,0,FALSE,18114,17293,3638,18.9
TRUE,TRUE,1,FALSE,18339,19803,694,23.2,FALSE,1,TRUE,17645,18498,-694,24.5
TRUE,FALSE,2,TRUE,17450,17226,555,22.6,TRUE,0,FALSE,16895,18248,-555,23.2
FALSE,TRUE,0,FALSE,16381,18126,134,22.1,FALSE,2,TRUE,16247,19268,-134,23.1
TRUE,TRUE,0,FALSE,15446,16681,-1257,18.3,FALSE,1,TRUE,16703,18087,1257,18.6
TRUE,FALSE,1,TRUE,14970,16402,-1187,20.8,TRUE,0,FALSE,16157,17460,1187,20.8
FALSE,TRUE,0,FALSE,14711,16207,-2625,22.1,FALSE,1,TRUE,17336,19582,2625,24.4
TRUE,FALSE,0,FALSE,17219,18432,-55,21.2,TRUE,1,TRUE,17274,18730,55,25.1
TRUE,TRUE,1,FALSE,18010,19401,2585,23.9,FALSE,1,TRUE,15425,17113,-2585,22.6
TRUE,FALSE,1,TRUE,19708,18711,5186,20.1,TRUE,0,FALSE,14522,15972,-5186,17
TRUE,TRUE,1,TRUE,16825,18820,2492,24.7,FALSE,0,FALSE,14333,17644,-2492,20.5
TRUE,TRUE,1,FALSE,14755,18264,1371,22.3,FALSE,0,FALSE,13384,16118,-1371,23
TRUE,TRUE,0,FALSE,17592,18440,1635,22.4,FALSE,0,FALSE,15957,16735,-1635,19.5
FALSE,FALSE,0,FALSE,15351,16664,-2885,17.9,TRUE,2,TRUE,18236,20266,2885,22.2
FALSE,TRUE,1,TRUE,17787,18660,2360,23.2,FALSE,0,FALSE,15427,17221,-2360,16.1
TRUE,FALSE,0,FALSE,15031,17787,421,24.6,TRUE,1,TRUE,14610,17947,-421,23.9
TRUE,TRUE,0,FALSE,15407,16669,-1207,22.3,FALSE,0,FALSE,16614,18750,1207,22.6
FALSE,FALSE,0,FALSE,14569,17180,-1195,19.4,TRUE,1,TRUE,15764,17236,1195,19.4
TRUE,TRUE,1,TRUE,16452,17156,-2343,19.1,FALSE,1,FALSE,18795,19232,2343,26.1
TRUE,FALSE,1,TRUE,17437,18302,3156,25.5,TRUE,0,FALSE,14281,14383,-3156,19.6
TRUE,FALSE,0,FALSE,14665,15242,-2277,18.8,TRUE,0,FALSE,16942,17046,2277,22.5
TRUE,TRUE,1,TRUE,18395,19241,3354,23.6,FALSE,0,FALSE,15041,16923,-3354,18.5
TRUE,TRUE,0,FALSE,16961,19188,4060,24.5,FALSE,0,FALSE,12901,15931,-4060,17.6
FALSE,FALSE,0,FALSE,14011,15027,-4043,19.7,TRUE,1,TRUE,18054,19169,4043,20.7
TRUE,FALSE,0,FALSE,16871,18870,659,22.7,TRUE,1,TRUE,16212,18981,-659,23.8
FALSE,TRUE,0,FALSE,16125,17377,-3290,19.6,FALSE,0,FALSE,19415,20074,3290,23.1
FALSE,FALSE,0,FALSE,13773,16568,-3660,19.2,TRUE,1,TRUE,17433,19850,3660,23.9
TRUE,TRUE,0,FALSE,18458,18924,-913,24.3,FALSE,0,FALSE,19371,19116,913,23.1
FALSE,FALSE,0,FALSE,16258,18533,585,25.5,TRUE,0,FALSE,15673,17963,-585,18
TRUE,FALSE,1,TRUE,16997,20958,1176,22.2,TRUE,1,FALSE,15821,17358,-1176,19.6
FALSE,FALSE,1,FALSE,15356,18213,-3505,18.6,TRUE,1,TRUE,18861,18991,3505,24.7
TRUE,TRUE,1,FALSE,18870,18945,4909,25.2,FALSE,1,TRUE,13961,16185,-4909,20.2
FALSE,FALSE,0,FALSE,15639,16156,-1003,19.6,TRUE,1,TRUE,16642,17933,1003,20.4
FALSE,FALSE,1,TRUE,19632,20057,84,22.8,TRUE,0,FALSE,19548,19065,-84,23.7
FALSE,FALSE,1,TRUE,16942,17991,330,24.7,TRUE,1,FALSE,16612,18299,-330,19.2
FALSE,TRUE,0,FALSE,17077,16354,974,17.1,FALSE,1,TRUE,16103,17404,-974,20
FALSE,TRUE,1,TRUE,20269,20117,3331,24.2,FALSE,0,FALSE,16938,18322,-3331,19.2
TRUE,TRUE,1,TRUE,19079,20020,4371,24.9,FALSE,0,FALSE,14708,17315,-4371,23.7
TRUE,FALSE,1,TRUE,15815,16869,-1754,19.6,TRUE,0,FALSE,17569,17080,1754,20.1
FALSE,TRUE,1,FALSE,16970,17789,381,25.2,FALSE,1,TRUE,16589,17681,-381,19.9
TRUE,TRUE,0,FALSE,18064,19192,2321,25.2,FALSE,1,TRUE,15743,17918,-2321,19.8
TRUE,FALSE,0,FALSE,17169,18362,1574,23.9,TRUE,2,TRUE,15595,17009,-1574,25.2
FALSE,FALSE,1,TRUE,16413,16989,188,20.9,TRUE,0,FALSE,16225,18113,-188,24.8
TRUE,FALSE,1,TRUE,15464,17053,679,21.9,TRUE,1,FALSE,14785,17744,-679,22
FALSE,TRUE,1,TRUE,15600,16815,-475,20.7,FALSE,0,FALSE,16075,18266,475,23.3
FALSE,FALSE,0,FALSE,13802,15859,-3276,21.6,TRUE,1,TRUE,17078,18649,3276,21.7
FALSE,TRUE,0,FALSE,15033,16265,-1520,22.6,FALSE,0,FALSE,16553,16878,1520,20.1
TRUE,TRUE,1,TRUE,16803,18053,1349,25.1,FALSE,0,FALSE,15454,17129,-1349,18.2
FALSE,TRUE,1,TRUE,15444,18334,-352,21.5,FALSE,0,FALSE,15796,18158,352,25.7
TRUE,FALSE,0,FALSE,17659,18496,-987,24.4,TRUE,2,TRUE,18646,18407,987,20.6
TRUE,TRUE,0,FALSE,18720,19060,520,23.2,FALSE,2,TRUE,18200,18163,-520,20.2
FALSE,TRUE,1,TRUE,17639,17826,1181,24.7,FALSE,1,FALSE,16458,18509,-1181,24
TRUE,TRUE,0,FALSE,17307,18013,2516,24.9,FALSE,1,TRUE,14791,16960,-2516,20.3
TRUE,FALSE,1,TRUE,15712,17867,66,24.1,TRUE,0,FALSE,15646,18228,-66,24.5
TRUE,FALSE,1,TRUE,17616,18140,2590,24.3,TRUE,1,FALSE,15026,17122,-2590,24.8
FALSE,FALSE,0,FALSE,17235,19915,2648,25.7,TRUE,0,FALSE,14587,17320,-2648,19.1
TRUE,TRUE,2,TRUE,20065,18844,2763,20.4,FALSE,0,FALSE,17302,15776,-2763,16.8
FALSE,FALSE,2,TRUE,15537,17374,1024,24.4,TRUE,0,FALSE,14513,16959,-1024,22.4
FALSE,FALSE,0,FALSE,18359,17074,1462,19,TRUE,0,FALSE,16897,16825,-1462,16
TRUE,TRUE,0,FALSE,15884,17698,739,25.1,FALSE,1,TRUE,15145,16059,-739,17.5
FALSE,FALSE,0,FALSE,14512,16088,-3476,22.6,TRUE,2,TRUE,17988,20107,3476,24.9
FALSE,TRUE,0,FALSE,15440,17277,-2494,17.5,FALSE,0,FALSE,17934,20032,2494,23.7
TRUE,FALSE,1,TRUE,16296,18093,1576,22.2,TRUE,0,FALSE,14720,16520,-1576,19.2
FALSE,FALSE,0,FALSE,14979,18306,-2607,23.2,TRUE,2,TRUE,17586,18247,2607,23.8
TRUE,TRUE,1,TRUE,16364,17787,978,22.6,FALSE,0,FALSE,15386,17472,-978,19.4
FALSE,FALSE,0,FALSE,14003,16419,-5945,19.5,TRUE,0,FALSE,19948,18541,5945,23.2
FALSE,TRUE,0,FALSE,16459,18612,-2021,20.1,FALSE,0,FALSE,18480,20503,2021,23.5
FALSE,TRUE,0,FALSE,15361,17290,-1226,23.5,FALSE,0,FALSE,16587,19722,1226,22.1
FALSE,FALSE,1,FALSE,18345,20002,3272,24.7,TRUE,1,TRUE,15073,16943,-3272,18.3
FALSE,FALSE,1,TRUE,18497,19069,3609,22.3,TRUE,0,FALSE,14888,15449,-3609,17.4
FALSE,FALSE,0,FALSE,14642,16219,-744,22.9,TRUE,2,TRUE,15386,17474,744,21.2
FALSE,FALSE,0,FALSE,15539,17792,-2925,21.4,TRUE,2,TRUE,18464,19904,2925,24.2
FALSE,TRUE,0,FALSE,18781,17690,2348,20.4,FALSE,0,FALSE,16433,16228,-2348,19.1
FALSE,FALSE,0,FALSE,16509,17298,-1997,21,TRUE,0,FALSE,18506,19888,1997,22.8
TRUE,FALSE,1,TRUE,14820,16751,-292,21.5,TRUE,1,FALSE,15112,16878,292,22.2
FALSE,FALSE,0,FALSE,15465,17217,-398,21.7,TRUE,1,TRUE,15863,17980,398,24.9
FALSE,FALSE,0,FALSE,15241,18179,-1514,25.2,TRUE,2,TRUE,16755,19212,1514,22.4
FALSE,FALSE,0,FALSE,15842,17016,-1214,21.1,TRUE,2,TRUE,17056,17856,1214,19.8
FALSE,FALSE,1,FALSE,16388,17168,-420,22,TRUE,0,FALSE,16808,18686,420,23.9
TRUE,TRUE,2,TRUE,15837,18178,425,22.6,FALSE,0,FALSE,15412,17756,-425,25.5
TRUE,FALSE,1,TRUE,18929,19632,4175,22,TRUE,1,FALSE,14754,15702,-4175,20.1
TRUE,TRUE,1,TRUE,17336,18459,2866,23.1,FALSE,0,FALSE,14470,16985,-2866,19.8
FALSE,FALSE,0,FALSE,15802,17403,-3645,21.8,TRUE,1,TRUE,19447,19204,3645,21.4
FALSE,TRUE,1,TRUE,16995,18679,930,23,FALSE,0,FALSE,16065,18112,-930,22.1
TRUE,TRUE,0,FALSE,16528,20454,2617,26.2,FALSE,1,TRUE,13911,16719,-2617,23.1
FALSE,FALSE,1,TRUE,17182,18588,1276,23.3,TRUE,0,FALSE,15906,17427,-1276,21.3
FALSE,FALSE,0,FALSE,16017,17524,-1031,20.2,TRUE,0,FALSE,17048,18094,1031,22.6
TRUE,FALSE,0,FALSE,16286,18048,-396,23,TRUE,1,TRUE,16682,17253,396,22.9
FALSE,FALSE,1,FALSE,19084,17286,2445,22.5,TRUE,1,TRUE,16639,17367,-2445,18.9
FALSE,FALSE,0,FALSE,14899,16761,-5515,19,TRUE,0,FALSE,20414,20152,5515,23.9
FALSE,FALSE,0,FALSE,17290,17418,-3502,22.3,TRUE,1,TRUE,20792,19605,3502,22.8
FALSE,TRUE,0,FALSE,17569,17848,1613,26.5,FALSE,2,TRUE,15956,17768,-1613,21.4
TRUE,FALSE,1,TRUE,17964,19813,3311,21.3,TRUE,0,FALSE,14653,15822,-3311,19.8
TRUE,FALSE,0,FALSE,15400,18242,-1255,19.7,TRUE,1,TRUE,16655,18363,1255,25
FALSE,TRUE,1,TRUE,17761,19090,642,22,FALSE,0,FALSE,17119,19093,-642,21.8
TRUE,TRUE,1,TRUE,16480,17338,-1428,18.3,FALSE,0,FALSE,17908,18870,1428,19.2
FALSE,TRUE,0,FALSE,16975,19639,1735,23.8,FALSE,0,FALSE,15240,17610,-1735,22.8
TRUE,FALSE,1,TRUE,16459,18670,785,22.2,TRUE,0,FALSE,15674,17482,-785,22.9
TRUE,TRUE,1,TRUE,16636,17569,-1117,20.7,FALSE,0,FALSE,17753,18078,1117,23
FALSE,FALSE,0,FALSE,16550,17563,-748,20.4,TRUE,1,FALSE,17298,19428,748,22.7
TRUE,TRUE,1,TRUE,16400,18604,-125,18.1,FALSE,0,FALSE,16525,18067,125,24.7
FALSE,FALSE,1,TRUE,14478,16901,-3613,23.7,TRUE,0,FALSE,18091,18493,3613,23.2
TRUE,TRUE,1,TRUE,19058,19477,3723,21.4,FALSE,1,FALSE,15335,16662,-3723,20
TRUE,TRUE,1,TRUE,20316,18784,5073,23,FALSE,1,FALSE,15243,16981,-5073,22.4
TRUE,TRUE,0,FALSE,17083,18817,1031,24.8,FALSE,2,TRUE,16052,18719,-1031,22
TRUE,TRUE,1,TRUE,17613,18689,2470,22.5,FALSE,0,FALSE,15143,16772,-2470,19.9
TRUE,TRUE,1,TRUE,17731,18766,2748,25.2,FALSE,0,FALSE,14983,17924,-2748,21.4
TRUE,FALSE,2,TRUE,14312,16196,-2861,14.4,TRUE,0,FALSE,17173,18544,2861,21.7
TRUE,TRUE,2,TRUE,16903,19854,2524,20.7,FALSE,0,FALSE,14379,17121,-2524,19.9
TRUE,FALSE,1,TRUE,17137,18628,2191,24,TRUE,0,FALSE,14946,16408,-2191,20.3
TRUE,TRUE,0,FALSE,18870,18880,5014,23.2,FALSE,0,FALSE,13856,15642,-5014,17.3
TRUE,FALSE,1,TRUE,15279,18515,-1023,24,TRUE,1,FALSE,16302,18423,1023,24.3
TRUE,TRUE,1,FALSE,19262,18021,1497,22.3,FALSE,1,TRUE,17765,16466,-1497,21.1
FALSE,TRUE,0,FALSE,15651,16491,-1554,21.1,FALSE,0,FALSE,17205,17272,1554,20.3
TRUE,TRUE,0,FALSE,17682,20336,2310,20.1,FALSE,1,TRUE,15372,15880,-2310,21
FALSE,TRUE,1,TRUE,16209,18802,-907,23.5,FALSE,0,FALSE,17116,19961,907,24.2
FALSE,FALSE,0,FALSE,18996,18231,3227,23.1,TRUE,1,TRUE,15769,17073,-3227,17.5
TRUE,TRUE,1,TRUE,20855,20164,4083,19.6,FALSE,0,FALSE,16772,16424,-4083,17.1
FALSE,FALSE,0,FALSE,15485,17345,-1397,20.8,TRUE,1,TRUE,16882,18075,1397,22.5
FALSE,TRUE,1,TRUE,16043,17912,-564,22.7,FALSE,1,FALSE,16607,18334,564,23.6
FALSE,FALSE,0,FALSE,16476,17056,-1221,21.5,TRUE,1,TRUE,17697,17270,1221,18.6
FALSE,FALSE,0,FALSE,15473,17491,-1093,21.5,TRUE,1,TRUE,16566,17940,1093,23.6
FALSE,TRUE,2,TRUE,15157,17194,-1301,21.8,FALSE,0,FALSE,16458,17696,1301,20.9
FALSE,TRUE,0,FALSE,14812,17359,-2393,18.3,FALSE,0,FALSE,17205,18240,2393,21.4
FALSE,FALSE,0,FALSE,15959,16675,66,23.6,TRUE,1,TRUE,15893,16790,-66,18.7
TRUE,TRUE,1,TRUE,16850,19499,1994,22.8,FALSE,1,FALSE,14856,17958,-1994,22.4
TRUE,FALSE,0,FALSE,14940,16977,-1131,23.8,TRUE,0,FALSE,16071,18898,1131,24.7
FALSE,FALSE,1,FALSE,17550,19690,1055,21.8,TRUE,1,TRUE,16495,18031,-1055,24.8
FALSE,FALSE,0,FALSE,16542,17667,798,21.4,TRUE,1,TRUE,15744,18930,-798,19.5
TRUE,FALSE,1,FALSE,17297,17523,1134,19.6,TRUE,1,TRUE,16163,17366,-1134,23.8
FALSE,FALSE,1,FALSE,19581,18509,2883,23.2,TRUE,1,TRUE,16698,17450,-2883,20.1
FALSE,TRUE,1,FALSE,14712,17001,-3226,23,FALSE,1,TRUE,17938,19336,3226,23.7
TRUE,TRUE,2,TRUE,16587,17630,814,21.2,FALSE,0,FALSE,15773,15431,-814,17.6
TRUE,TRUE,1,FALSE,17429,18630,-1209,19.8,FALSE,0,FALSE,18638,19377,1209,21.2
TRUE,TRUE,1,FALSE,15547,17921,256,20.8,FALSE,1,TRUE,15291,17680,-256,22.2
FALSE,FALSE,0,FALSE,14957,17705,-3881,17.3,TRUE,0,FALSE,18838,18152,3881,22.3
TRUE,TRUE,1,TRUE,17450,19276,3610,23.3,FALSE,0,FALSE,13840,16981,-3610,22.6
TRUE,TRUE,1,TRUE,17199,19353,3013,23.5,FALSE,0,FALSE,14186,17109,-3013,20.5
TRUE,TRUE,1,TRUE,16610,18953,1353,23.1,FALSE,0,FALSE,15257,17621,-1353,23.6
FALSE,FALSE,1,TRUE,14795,16454,-2914,17.8,TRUE,1,FALSE,17709,19137,2914,22.9
FALSE,FALSE,0,FALSE,18269,19161,1974,22.8,TRUE,2,TRUE,16295,18300,-1974,19.9
FALSE,FALSE,1,FALSE,13889,16427,-3012,20.5,TRUE,1,TRUE,16901,17727,3012,19.5
TRUE,FALSE,1,TRUE,15950,17916,-30,22,TRUE,1,FALSE,15980,18116,30,23.8
TRUE,FALSE,2,TRUE,15235,16288,-1747,18.9,TRUE,0,FALSE,16982,18115,1747,22.3
TRUE,FALSE,1,FALSE,16697,19017,-333,20.5,TRUE,1,TRUE,17030,17659,333,22.2
FALSE,FALSE,0,FALSE,17450,18559,1294,23.6,TRUE,0,FALSE,16156,18346,-1294,21.3
FALSE,TRUE,0,FALSE,15896,17492,-1773,17.1,FALSE,1,TRUE,17669,17914,1773,22.1
FALSE,TRUE,0,FALSE,15943,19085,-325,23.9,FALSE,1,TRUE,16268,18313,325,22.6
FALSE,TRUE,1,FALSE,18063,16794,-163,22.8,FALSE,1,TRUE,18226,17468,163,20.1
TRUE,FALSE,0,FALSE,16177,17721,-2281,21.4,TRUE,1,TRUE,18458,19004,2281,22.9
FALSE,TRUE,1,FALSE,14896,17066,-1243,20.5,FALSE,1,TRUE,16139,17701,1243,19.5
FALSE,TRUE,1,FALSE,16959,19261,1522,21.5,FALSE,1,TRUE,15437,17524,-1522,21.8
TRUE,TRUE,1,FALSE,16363,17356,2448,20.9,FALSE,0,FALSE,13915,15495,-2448,18.4
FALSE,FALSE,0,FALSE,16665,17063,-3701,18.9,TRUE,1,TRUE,20366,19802,3701,22
TRUE,TRUE,1,TRUE,15377,17617,-166,22.9,FALSE,0,FALSE,15543,18329,166,21.4
FALSE,TRUE,0,FALSE,13977,15961,-2707,18.5,FALSE,2,TRUE,16684,19093,2707,22.6
TRUE,FALSE,0,FALSE,13918,17849,-1932,20,TRUE,1,TRUE,15850,17890,1932,22.5
TRUE,FALSE,1,TRUE,17630,18364,13,23,TRUE,0,FALSE,17617,16352,-13,16.5
TRUE,FALSE,0,FALSE,15777,17261,-621,22.9,TRUE,1,TRUE,16398,18045,621,20.4
FALSE,FALSE,0,FALSE,16043,17403,-689,23.7,TRUE,1,TRUE,16732,19071,689,23.1
TRUE,TRUE,0,FALSE,19022,19112,3028,21.7,FALSE,0,FALSE,15994,16588,-3028,19
FALSE,TRUE,1,TRUE,13957,16250,-2788,18.7,FALSE,0,FALSE,16745,17554,2788,21
FALSE,FALSE,1,TRUE,14547,16366,-5367,21.2,TRUE,1,FALSE,19914,19830,5367,23.8
TRUE,TRUE,1,TRUE,15649,17165,-1209,24,FALSE,0,FALSE,16858,18349,1209,23.8
TRUE,TRUE,1,TRUE,17654,19048,1405,24.9,FALSE,1,FALSE,16249,16930,-1405,20.4
TRUE,TRUE,1,FALSE,19858,19501,3335,21.6,FALSE,1,TRUE,16523,16715,-3335,16.8
FALSE,FALSE,0,FALSE,13517,16278,-3700,22.2,TRUE,1,TRUE,17217,18408,3700,24.7
TRUE,TRUE,2,TRUE,17791,18557,2763,25,FALSE,0,FALSE,15028,17540,-2763,20
TRUE,TRUE,1,TRUE,16817,17889,1060,20.8,FALSE,1,FALSE,15757,16937,-1060,18.5
TRUE,FALSE,1,FALSE,14920,17487,-1959,21.7,TRUE,1,TRUE,16879,18117,1959,24.2
FALSE,FALSE,0,FALSE,17160,18450,2613,22.1,TRUE,1,TRUE,14547,17000,-2613,21.3
TRUE,FALSE,1,FALSE,15436,18911,-684,22,TRUE,1,TRUE,16120,19653,684,26.7
TRUE,FALSE,1,TRUE,15442,18590,-79,22,TRUE,1,FALSE,15521,19405,79,21.7
TRUE,TRUE,0,FALSE,15764,17960,-1929,23.7,FALSE,1,FALSE,17693,18615,1929,23.6
FALSE,FALSE,1,TRUE,16744,18061,-615,23.1,TRUE,0,FALSE,17359,18211,615,23.7
TRUE,TRUE,1,TRUE,20308,18069,5058,21.6,FALSE,0,FALSE,15250,16533,-5058,19.7
TRUE,TRUE,1,FALSE,18731,18892,1601,19.1,FALSE,1,TRUE,17130,18433,-1601,24
FALSE,FALSE,0,FALSE,15529,17544,-2347,20,TRUE,1,FALSE,17876,18890,2347,22.9
TRUE,FALSE,0,FALSE,15169,18276,585,20.8,TRUE,0,FALSE,14584,16239,-585,19.6
TRUE,FALSE,1,FALSE,17075,17991,-372,21.8,TRUE,0,FALSE,17447,17814,372,21.7
TRUE,TRUE,0,FALSE,17467,20584,3407,24.5,FALSE,0,FALSE,14060,17374,-3407,21.4
TRUE,TRUE,1,TRUE,17259,19920,2452,24.9,FALSE,0,FALSE,14807,18320,-2452,22.1
TRUE,FALSE,0,FALSE,17979,18648,2507,21.4,TRUE,1,TRUE,15472,15968,-2507,21.4
FALSE,TRUE,0,FALSE,14269,16548,-2153,19.6,FALSE,0,FALSE,16422,18067,2153,21.1
TRUE,TRUE,1,TRUE,18309,20268,3039,23.4,FALSE,0,FALSE,15270,17933,-3039,22.3
FALSE,FALSE,1,TRUE,17116,19586,286,24.6,TRUE,0,FALSE,16830,18800,-286,21.9
FALSE,TRUE,1,TRUE,15970,17491,-336,20,FALSE,0,FALSE,16306,18172,336,22
FALSE,FALSE,0,FALSE,14626,16067,-4726,15.4,TRUE,1,TRUE,19352,18134,4726,22.4
TRUE,TRUE,0,FALSE,16427,17468,-3441,19.1,FALSE,0,FALSE,19868,19344,3441,25.9
FALSE,FALSE,1,TRUE,14676,14842,-4489,19.1,TRUE,0,FALSE,19165,18889,4489,22.4
FALSE,FALSE,0,FALSE,13943,16274,-5302,20.4,TRUE,0,FALSE,19245,20255,5302,23.8
TRUE,FALSE,0,FALSE,15488,16539,-4903,18.4,TRUE,1,TRUE,20391,19685,4903,20.4
FALSE,TRUE,1,TRUE,15437,16652,-152,19.8,FALSE,1,FALSE,15589,17553,152,22
FALSE,TRUE,0,FALSE,17083,19485,2263,24.1,FALSE,1,TRUE,14820,17819,-2263,25
FALSE,FALSE,1,FALSE,14825,17113,-3103,23.6,TRUE,1,TRUE,17928,19468,3103,23
TRUE,TRUE,1,TRUE,19402,19955,5650,24.2,FALSE,0,FALSE,13752,15435,-5650,18.8
FALSE,FALSE,1,TRUE,15129,17887,-1330,19.7,TRUE,0,FALSE,16459,18526,1330,24.1
FALSE,TRUE,0,FALSE,15053,17983,-3526,24.8,FALSE,0,FALSE,18579,19256,3526,23.4
FALSE,TRUE,0,FALSE,14672,16400,-1209,22.9,FALSE,1,TRUE,15881,18433,1209,25.2
FALSE,TRUE,1,TRUE,18280,19939,2171,24.1,FALSE,0,FALSE,16109,18100,-2171,19.6
FALSE,FALSE,1,TRUE,15290,17203,-2387,21.9,TRUE,0,FALSE,17677,19556,2387,24.2
TRUE,FALSE,1,FALSE,17329,18182,2252,18.9,TRUE,0,FALSE,15077,17096,-2252,24.4
TRUE,FALSE,1,TRUE,16409,18420,596,23.2,TRUE,0,FALSE,15813,17934,-596,20.2
TRUE,TRUE,1,FALSE,18237,17871,206,23.5,FALSE,0,FALSE,18031,17614,-206,17.5
TRUE,FALSE,2,TRUE,17259,18091,3146,21.4,TRUE,0,FALSE,14113,15834,-3146,22.1
TRUE,TRUE,1,FALSE,17816,18186,1789,22.6,FALSE,1,TRUE,16027,17942,-1789,21
FALSE,TRUE,1,TRUE,16465,17106,84,21.5,FALSE,0,FALSE,16381,18291,-84,20.3
FALSE,TRUE,0,FALSE,19029,19459,340,23.4,FALSE,0,FALSE,18689,18373,-340,18.2
TRUE,TRUE,1,TRUE,17075,17444,1531,20.2,FALSE,0,FALSE,15544,17666,-1531,25.2
TRUE,TRUE,0,FALSE,16689,19570,-177,23.3,FALSE,0,FALSE,16866,19608,177,23.6
TRUE,FALSE,0,FALSE,14402,17052,-688,23.3,TRUE,1,TRUE,15090,17629,688,25.8
FALSE,TRUE,1,TRUE,16379,18268,1429,24,FALSE,0,FALSE,14950,17044,-1429,22.6
FALSE,FALSE,0,FALSE,14579,15951,-3603,22.7,TRUE,0,FALSE,18182,19744,3603,23.2
FALSE,TRUE,0,FALSE,16455,18248,-614,21.4,FALSE,2,TRUE,17069,19578,614,24.3
FALSE,FALSE,1,TRUE,13770,15846,-2374,19.2,TRUE,0,FALSE,16144,18162,2374,23.9
TRUE,FALSE,1,TRUE,16042,17983,-1416,21.8,TRUE,0,FALSE,17458,18345,1416,24.3
TRUE,FALSE,1,TRUE,14905,18468,-1090,24.4,TRUE,0,FALSE,15995,17946,1090,24.3
TRUE,FALSE,0,FALSE,18733,19592,3925,20.1,TRUE,1,TRUE,14808,15487,-3925,17.9
FALSE,TRUE,0,FALSE,17496,17522,-2574,18.5,FALSE,1,TRUE,20070,20076,2574,19.8
TRUE,TRUE,2,TRUE,18303,18032,2667,20.2,FALSE,0,FALSE,15636,16081,-2667,17.4
FALSE,FALSE,1,TRUE,15395,17472,-1421,22.1,TRUE,1,FALSE,16816,18839,1421,21.2
TRUE,TRUE,1,TRUE,16540,18026,-41,23,FALSE,1,FALSE,16581,17719,41,25.4
FALSE,TRUE,1,FALSE,16342,17877,-2579,21.1,FALSE,1,TRUE,18921,18971,2579,23.8
FALSE,FALSE,0,FALSE,15540,17724,-468,23.6,TRUE,2,TRUE,16008,18305,468,23.4
FALSE,FALSE,0,FALSE,14993,17460,-2884,20.8,TRUE,1,TRUE,17877,19838,2884,22.6
FALSE,TRUE,0,FALSE,16022,17931,318,22.7,FALSE,1,TRUE,15704,17561,-318,21
TRUE,FALSE,1,TRUE,17978,18771,2604,21.6,TRUE,0,FALSE,15374,18339,-2604,22
FALSE,TRUE,0,FALSE,17898,18357,1388,21.5,FALSE,1,TRUE,16510,17916,-1388,21.2
FALSE,FALSE,0,FALSE,13170,15312,-5455,16.2,TRUE,0,FALSE,18625,17456,5455,21.1
FALSE,FALSE,0,FALSE,14364,17602,-3333,19,TRUE,1,TRUE,17697,18991,3333,25.1
TRUE,TRUE,1,FALSE,19294,18363,4570,23.4,FALSE,0,FALSE,14724,16158,-4570,16.2
TRUE,TRUE,0,FALSE,17446,18714,900,18.6,FALSE,1,TRUE,16546,17621,-900,22
TRUE,TRUE,1,TRUE,17943,18261,1493,22,FALSE,0,FALSE,16450,18228,-1493,19.7
TRUE,TRUE,1,TRUE,16656,17435,1786,21.4,FALSE,0,FALSE,14870,17696,-1786,20.6
TRUE,TRUE,2,TRUE,16149,18239,1819,22,FALSE,0,FALSE,14330,16977,-1819,20.6
FALSE,FALSE,0,FALSE,15564,17895,-433,21.6,TRUE,1,TRUE,15997,17450,433,22.5
FALSE,FALSE,0,FALSE,15128,17938,-860,25.1,TRUE,1,TRUE,15988,18272,860,22.6
TRUE,FALSE,1,FALSE,15551,17278,43,20.6,TRUE,1,TRUE,15508,18370,-43,21.8
TRUE,TRUE,0,FALSE,16426,18382,-642,23.1,FALSE,1,TRUE,17068,18779,642,19.3
TRUE,FALSE,2,TRUE,15594,18180,-1328,20.1,TRUE,0,FALSE,16922,17847,1328,22.7
FALSE,TRUE,2,TRUE,15674,17096,-622,21.5,FALSE,0,FALSE,16296,17037,622,18.9
TRUE,FALSE,0,FALSE,18444,19294,1903,19.6,TRUE,1,TRUE,16541,17134,-1903,17.3
TRUE,TRUE,1,TRUE,16929,19809,580,22.2,FALSE,0,FALSE,16349,16850,-580,19.2
TRUE,FALSE,1,TRUE,17701,19075,2252,24.6,TRUE,0,FALSE,15449,17498,-2252,22.8
TRUE,FALSE,2,TRUE,17020,19853,1686,23.8,TRUE,0,FALSE,15334,17701,-1686,25.3
TRUE,FALSE,1,TRUE,18395,18790,718,19.3,TRUE,0,FALSE,17677,17477,-718,20.6
TRUE,TRUE,1,TRUE,18646,19823,3767,25.3,FALSE,0,FALSE,14879,16546,-3767,19.5
FALSE,FALSE,0,FALSE,15887,16048,-2596,19.1,TRUE,0,FALSE,18483,18939,2596,22
FALSE,TRUE,1,TRUE,14098,14987,-2511,19.8,FALSE,0,FALSE,16609,17275,2511,21.6
FALSE,FALSE,1,TRUE,15521,15093,189,14.6,TRUE,1,FALSE,15332,17981,-189,19.3
TRUE,FALSE,1,TRUE,16460,18782,192,22.2,TRUE,0,FALSE,16268,18166,-192,23.6
FALSE,FALSE,1,FALSE,16749,15390,-3586,20.3,TRUE,1,TRUE,20335,18230,3586,19.4
TRUE,TRUE,1,FALSE,17329,19915,881,22.6,FALSE,0,FALSE,16448,17356,-881,19.9
FALSE,FALSE,0,FALSE,16582,15066,-157,20.3,TRUE,2,TRUE,16739,17660,157,21.9
FALSE,FALSE,0,FALSE,13206,15553,-6001,19.5,TRUE,1,TRUE,19207,20957,6001,24.4
FALSE,FALSE,0,FALSE,16423,18901,-859,21.2,TRUE,0,FALSE,17282,17982,859,22.6
TRUE,FALSE,2,TRUE,17074,17874,949,21.4,TRUE,0,FALSE,16125,17283,-949,22.5
FALSE,FALSE,0,FALSE,13449,16803,-1641,18.9,TRUE,0,FALSE,15090,17303,1641,22.4
TRUE,TRUE,2,TRUE,17466,18793,1499,24.6,FALSE,0,FALSE,15967,16324,-1499,21.5
TRUE,FALSE,2,TRUE,16941,18581,2104,22.9,TRUE,0,FALSE,14837,16938,-2104,21.3
TRUE,TRUE,1,TRUE,18601,18627,1939,22,FALSE,0,FALSE,16662,18461,-1939,17.4
FALSE,FALSE,1,TRUE,17003,17843,253,22.2,TRUE,0,FALSE,16750,19143,-253,21.8
TRUE,TRUE,0,FALSE,14577,17474,-1742,26.3,FALSE,1,TRUE,16319,18684,1742,23.4
TRUE,FALSE,1,TRUE,17813,17461,986,20.2,TRUE,0,FALSE,16827,16912,-986,21.6
FALSE,TRUE,1,FALSE,15332,18496,-1442,21.5,FALSE,1,TRUE,16774,19544,1442,22
TRUE,FALSE,1,TRUE,14627,16759,-1113,21.4,TRUE,0,FALSE,15740,18176,1113,23.5
FALSE,TRUE,0,FALSE,16187,15234,-229,15.6,FALSE,1,TRUE,16416,15721,229,16.9
TRUE,TRUE,2,TRUE,19787,19493,4284,24.2,FALSE,0,FALSE,15503,16908,-4284,20.5
TRUE,FALSE,0,FALSE,18596,18850,3378,18.8,TRUE,1,TRUE,15218,15682,-3378,20.7
FALSE,TRUE,0,FALSE,16233,17076,70,22.3,FALSE,2,TRUE,16163,18004,-70,22.5
FALSE,FALSE,0,FALSE,15468,17872,-2507,20.3,TRUE,1,TRUE,17975,19345,2507,24.3
FALSE,FALSE,0,FALSE,16699,17881,320,24,TRUE,1,TRUE,16379,18624,-320,21.6
FALSE,TRUE,1,TRUE,15311,16384,-1768,23.4,FALSE,1,FALSE,17079,17347,1768,21.7
TRUE,TRUE,1,TRUE,16580,19213,1586,21,FALSE,0,FALSE,14994,17940,-1586,23.2
TRUE,TRUE,0,FALSE,16450,17381,-57,22.4,FALSE,0,FALSE,16507,18720,57,22
FALSE,TRUE,0,FALSE,16197,15405,-2941,20.3,FALSE,1,TRUE,19138,18548,2941,19.4
FALSE,TRUE,1,FALSE,15773,16701,-2175,21.6,FALSE,1,TRUE,17948,19006,2175,21.6
FALSE,FALSE,0,FALSE,14815,14755,-7866,18.3,TRUE,2,TRUE,22681,20132,7866,21.9
TRUE,TRUE,1,TRUE,17731,18498,1870,25.7,FALSE,1,FALSE,15861,17331,-1870,21.6
TRUE,FALSE,0,FALSE,13952,17089,-2729,19.7,TRUE,1,TRUE,16681,18516,2729,25.2
TRUE,TRUE,1,FALSE,18504,19037,2842,21.2,FALSE,1,TRUE,15662,17912,-2842,19.2
FALSE,FALSE,0,FALSE,14777,17450,-1276,21.5,TRUE,2,TRUE,16053,18466,1276,24.1
FALSE,FALSE,0,FALSE,14018,16730,152,23.3,TRUE,1,TRUE,13866,17854,-152,22
TRUE,FALSE,0,FALSE,16140,17727,556,21.1,TRUE,1,TRUE,15584,16848,-556,21.5
TRUE,TRUE,0,FALSE,16246,18652,750,19.9,FALSE,0,FALSE,15496,17866,-750,19.9
FALSE,FALSE,1,TRUE,16122,17866,-1782,18.6,TRUE,1,FALSE,17904,18174,1782,25.3
FALSE,FALSE,0,FALSE,15429,17256,-2375,19.8,TRUE,1,TRUE,17804,19264,2375,22.2
FALSE,TRUE,0,FALSE,14270,16394,-1103,23,FALSE,1,TRUE,15373,19086,1103,24.4
TRUE,TRUE,0,FALSE,16327,19683,2246,24,FALSE,0,FALSE,14081,16785,-2246,23.5
TRUE,TRUE,0,FALSE,18225,18898,1868,23.6,FALSE,0,FALSE,16357,18172,-1868,22.3
TRUE,TRUE,1,FALSE,17778,18403,-628,20.4,FALSE,1,TRUE,18406,19267,628,19.7
TRUE,FALSE,2,TRUE,16680,19095,899,24.7,TRUE,0,FALSE,15781,18126,-899,20.9
FALSE,TRUE,1,TRUE,16434,18059,428,21.4,FALSE,1,FALSE,16006,18998,-428,18.4
TRUE,FALSE,0,FALSE,18721,18774,1721,16.4,TRUE,2,TRUE,17000,17096,-1721,19.5
FALSE,TRUE,1,TRUE,15107,17606,-2607,18.7,FALSE,0,FALSE,17714,19971,2607,23.8
TRUE,TRUE,1,TRUE,16897,20576,3084,24,FALSE,0,FALSE,13813,17224,-3084,21.9
TRUE,FALSE,0,FALSE,17013,17832,-941,24.6,TRUE,0,FALSE,17954,19549,941,24
TRUE,TRUE,0,FALSE,18047,18160,2175,23.9,FALSE,1,TRUE,15872,17654,-2175,22.9
FALSE,FALSE,1,TRUE,15175,18100,-1243,23.2,TRUE,0,FALSE,16418,18525,1243,21.9
FALSE,FALSE,0,FALSE,16722,16113,-978,19,TRUE,1,TRUE,17700,17345,978,20
TRUE,TRUE,0,FALSE,15722,16349,679,22.2,FALSE,0,FALSE,15043,15878,-679,18.1
FALSE,TRUE,1,FALSE,17077,16829,-995,17.5,FALSE,1,TRUE,18072,18326,995,22.8
FALSE,TRUE,2,TRUE,17016,19237,3266,21.4,FALSE,0,FALSE,13750,17900,-3266,21.8
FALSE,TRUE,2,TRUE,17231,17227,792,17.5,FALSE,0,FALSE,16439,17701,-792,17.7
TRUE,TRUE,2,TRUE,17039,18656,3032,22,FALSE,0,FALSE,14007,16560,-3032,18.5
TRUE,FALSE,1,TRUE,17596,19377,3252,20.3,TRUE,0,FALSE,14344,16000,-3252,17.1
FALSE,FALSE,0,FALSE,16887,17187,1270,21.5,TRUE,1,TRUE,15617,18812,-1270,21.2
TRUE,FALSE,0,FALSE,15157,17482,-549,24.1,TRUE,2,TRUE,15706,18287,549,22.3
TRUE,TRUE,2,TRUE,20259,19498,6210,23.8,FALSE,0,FALSE,14049,15899,-6210,18
FALSE,TRUE,1,TRUE,16388,17753,-1436,21.3,FALSE,0,FALSE,17824,19159,1436,22
TRUE,TRUE,0,FALSE,17269,18087,8,20.9,FALSE,2,TRUE,17261,18003,-8,21.6
TRUE,TRUE,1,TRUE,17389,18252,836,19.8,FALSE,0,FALSE,16553,17369,-836,23.7
FALSE,TRUE,0,FALSE,17622,18672,2077,24.7,FALSE,1,TRUE,15545,17686,-2077,22.6
TRUE,FALSE,0,FALSE,15736,18798,-259,23.2,TRUE,2,TRUE,15995,18243,259,22
TRUE,TRUE,1,FALSE,17965,19735,-195,21.9,FALSE,1,TRUE,18160,19089,195,24.4
FALSE,FALSE,0,FALSE,15067,17556,-3456,22.3,TRUE,1,TRUE,18523,19177,3456,23.5
FALSE,FALSE,0,FALSE,13855,15500,-5043,21.5,TRUE,1,TRUE,18898,20127,5043,24.4
TRUE,TRUE,0,FALSE,17561,19152,2134,20.7,FALSE,1,TRUE,15427,17652,-2134,20.4
TRUE,FALSE,0,FALSE,16284,16793,-3235,20.8,TRUE,2,TRUE,19519,19000,3235,21.5
FALSE,TRUE,0,FALSE,17048,16378,1453,22.7,FALSE,0,FALSE,15595,16632,-1453,18.8
FALSE,FALSE,1,TRUE,16294,18718,613,21.8,TRUE,0,FALSE,15681,18395,-613,23.2
FALSE,FALSE,1,TRUE,16877,19179,-772,22.5,TRUE,0,FALSE,17649,19724,772,22.6
FALSE,FALSE,0,FALSE,15222,15621,-1262,17.8,TRUE,0,FALSE,16484,17000,1262,17.8
FALSE,FALSE,1,FALSE,17245,18890,-862,23.6,TRUE,1,TRUE,18107,17836,862,21.9
FALSE,TRUE,1,TRUE,17187,17605,-1675,19.7,FALSE,1,FALSE,18862,18987,1675,20.6
FALSE,TRUE,2,TRUE,15156,16017,-2997,15.6,FALSE,0,FALSE,18153,19069,2997,22.2
FALSE,FALSE,0,FALSE,13977,17736,-4097,20.8,TRUE,0,FALSE,18074,19394,4097,22.6
FALSE,TRUE,0,FALSE,16383,18625,1678,25.8,FALSE,1,TRUE,14705,17470,-1678,21.6
FALSE,TRUE,0,FALSE,15392,17234,-1445,24,FALSE,0,FALSE,16837,17928,1445,22.5
TRUE,TRUE,1,TRUE,15397,18585,1516,20.4,FALSE,0,FALSE,13881,17876,-1516,19.6
FALSE,FALSE,0,FALSE,16142,18299,-1769,19.1,TRUE,1,TRUE,17911,19508,1769,26.4
TRUE,TRUE,0,FALSE,17855,19265,2063,20,FALSE,1,TRUE,15792,17134,-2063,18.2
FALSE,FALSE,0,FALSE,13956,16492,-3535,21,TRUE,1,TRUE,17491,18212,3535,20.3
FALSE,FALSE,1,TRUE,15753,16744,-1964,20.3,TRUE,1,FALSE,17717,18159,1964,23.8
FALSE,FALSE,0,FALSE,16272,16687,-1117,17.9,TRUE,1,TRUE,17389,17894,1117,22.3
TRUE,FALSE,0,FALSE,16869,18297,713,23,TRUE,1,TRUE,16156,18355,-713,21.3
FALSE,TRUE,0,FALSE,16990,17317,-1534,19.8,FALSE,0,FALSE,18524,18390,1534,21.8
FALSE,FALSE,0,FALSE,17991,20130,1350,21.9,TRUE,2,TRUE,16641,17775,-1350,20.8
FALSE,FALSE,0,FALSE,15143,18397,129,23.9,TRUE,1,TRUE,15014,18197,-129,22.4
TRUE,TRUE,1,TRUE,16735,17862,926,21.5,FALSE,0,FALSE,15809,16895,-926,18.8
TRUE,FALSE,1,FALSE,15971,17247,603,24.1,TRUE,0,FALSE,15368,18179,-603,21.5
TRUE,FALSE,0,FALSE,17752,18405,1512,21.2,TRUE,1,TRUE,16240,17958,-1512,21.9
FALSE,TRUE,0,FALSE,15023,17982,-2942,22.2,FALSE,1,TRUE,17965,20556,2942,22.8
TRUE,TRUE,2,TRUE,16007,17370,701,20.2,FALSE,0,FALSE,15306,17998,-701,23.6
TRUE,TRUE,0,FALSE,15454,17256,-1648,19.9,FALSE,2,TRUE,17102,18610,1648,21.7
TRUE,TRUE,0,FALSE,17058,16737,2559,20.7,FALSE,0,FALSE,14499,15931,-2559,19.6
FALSE,TRUE,1,FALSE,18374,18219,1142,21.8,FALSE,0,FALSE,17232,17250,-1142,18.8
FALSE,TRUE,0,FALSE,16259,16804,-1501,22.4,FALSE,1,TRUE,17760,18867,1501,24
FALSE,FALSE,1,FALSE,15894,18026,409,22.2,TRUE,1,TRUE,15485,16621,-409,24.1
FALSE,TRUE,1,TRUE,15524,17508,-2752,21.4,FALSE,0,FALSE,18276,19678,2752,25.2
FALSE,TRUE,0,FALSE,18956,19208,3415,24.3,FALSE,1,TRUE,15541,17321,-3415,19.2
TRUE,FALSE,1,TRUE,17881,19236,1867,23.8,TRUE,0,FALSE,16014,17398,-1867,20.5
TRUE,TRUE,0,FALSE,17131,19074,1692,22.9,FALSE,1,TRUE,15439,18869,-1692,18.6
TRUE,TRUE,1,FALSE,17666,18167,3198,24,FALSE,1,TRUE,14468,16739,-3198,20.1
TRUE,TRUE,2,TRUE,17538,19556,1652,22.9,FALSE,0,FALSE,15886,17842,-1652,20.9
TRUE,TRUE,1,TRUE,16942,20255,2875,26.1,FALSE,0,FALSE,14067,17220,-2875,22.2
FALSE,TRUE,0,FALSE,18224,19875,2978,22.5,FALSE,0,FALSE,15246,16646,-2978,22.4
TRUE,TRUE,1,TRUE,16345,17499,134,24.6,FALSE,0,FALSE,16211,18521,-134,23.9
FALSE,TRUE,0,FALSE,15865,18437,-418,23.8,FALSE,1,TRUE,16283,18403,418,23.1
FALSE,TRUE,0,FALSE,15266,17065,-3446,20.9,FALSE,1,TRUE,18712,18233,3446,22.2
FALSE,TRUE,1,FALSE,15454,17213,957,22.6,FALSE,0,FALSE,14497,16807,-957,21.5
TRUE,FALSE,1,TRUE,17051,20109,2358,25.9,TRUE,0,FALSE,14693,17519,-2358,24.8
FALSE,TRUE,0,FALSE,17705,17690,-1291,20.1,FALSE,0,FALSE,18996,18757,1291,21.3
FALSE,TRUE,0,FALSE,16763,17181,3371,20.9,FALSE,0,FALSE,13392,16008,-3371,19.5
FALSE,FALSE,0,FALSE,16808,17371,-400,18.9,TRUE,1,TRUE,17208,17910,400,19.4
FALSE,FALSE,0,FALSE,15111,16978,-4189,21.8,TRUE,2,TRUE,19300,20366,4189,24.9
FALSE,TRUE,1,TRUE,14998,15823,-4011,19.9,FALSE,0,FALSE,19009,19030,4011,23.3
FALSE,TRUE,0,FALSE,16942,17624,9,22.7,FALSE,1,TRUE,16933,18820,-9,21.5
FALSE,FALSE,0,FALSE,15270,17079,-2630,18.1,TRUE,1,TRUE,17900,19283,2630,23.8
FALSE,FALSE,0,FALSE,14586,16499,-1494,19.4,TRUE,0,FALSE,16080,17199,1494,23.1
TRUE,FALSE,1,TRUE,18232,18215,2655,22.8,TRUE,0,FALSE,15577,16109,-2655,22.6
TRUE,FALSE,0,FALSE,17190,16876,329,20.4,TRUE,1,TRUE,16861,17174,-329,20.6
FALSE,FALSE,0,FALSE,15008,17416,1219,22.5,TRUE,1,TRUE,13789,15858,-1219,19.3
TRUE,TRUE,1,TRUE,21755,18071,5494,19.1,FALSE,0,FALSE,16261,16084,-5494,16.8
TRUE,TRUE,1,TRUE,15787,19141,1259,22.3,FALSE,0,FALSE,14528,16824,-1259,23.6
FALSE,FALSE,0,FALSE,16404,18840,-919,24.5,TRUE,0,FALSE,17323,18793,919,21.9
TRUE,FALSE,1,TRUE,17878,20464,2566,23.2,TRUE,0,FALSE,15312,17367,-2566,23.5
TRUE,TRUE,2,TRUE,18532,18460,1428,24,FALSE,0,FALSE,17104,18165,-1428,20.1
FALSE,TRUE,1,FALSE,16901,16288,-763,17.6,FALSE,0,FALSE,17664,16738,763,20.4
FALSE,FALSE,0,FALSE,17563,17585,-1360,19.9,TRUE,1,TRUE,18923,19146,1360,24.4
TRUE,TRUE,0,FALSE,15967,17892,-553,22.5,FALSE,2,TRUE,16520,17608,553,21.7
FALSE,FALSE,0,FALSE,16280,17372,-3279,22.3,TRUE,1,TRUE,19559,18838,3279,25.2
TRUE,TRUE,1,FALSE,17142,18245,2301,22.1,FALSE,1,TRUE,14841,15683,-2301,17.7
FALSE,TRUE,0,FALSE,14807,17294,-2462,20.1,FALSE,0,FALSE,17269,19188,2462,22.9
TRUE,TRUE,0,FALSE,18697,17238,-198,21.3,FALSE,1,FALSE,18895,18397,198,18.8
FALSE,TRUE,0,FALSE,17057,17009,240,19,FALSE,0,FALSE,16817,17912,-240,19.7
TRUE,FALSE,1,TRUE,16487,18581,1780,23.5,TRUE,0,FALSE,14707,17571,-1780,21.8
TRUE,TRUE,0,FALSE,15721,17087,435,21,FALSE,0,FALSE,15286,18126,-435,22.9
TRUE,FALSE,1,TRUE,17182,19944,1591,24.6,TRUE,0,FALSE,15591,18166,-1591,25.7
TRUE,FALSE,2,TRUE,16993,18608,937,21.2,TRUE,0,FALSE,16056,18078,-937,20.5
TRUE,FALSE,0,FALSE,15710,17847,-2320,22.3,TRUE,1,TRUE,18030,20123,2320,23.7
TRUE,FALSE,1,FALSE,17793,18327,496,19.3,TRUE,1,TRUE,17297,18140,-496,22
TRUE,TRUE,1,TRUE,19867,19401,6977,23.6,FALSE,0,FALSE,12890,14098,-6977,16.8
TRUE,TRUE,0,FALSE,18538,19307,2832,22.5,FALSE,0,FALSE,15706,16446,-2832,21.4
FALSE,TRUE,0,FALSE,14624,16231,-4073,21.1,FALSE,1,FALSE,18697,18826,4073,22.6
TRUE,TRUE,0,FALSE,16005,17430,1561,22.8,FALSE,1,TRUE,14444,16809,-1561,18.7
FALSE,FALSE,0,FALSE,15194,17750,-2143,22,TRUE,1,FALSE,17337,19001,2143,20.5
TRUE,FALSE,1,FALSE,20943,21575,6081,23.5,TRUE,1,TRUE,14862,16827,-6081,19.7
TRUE,TRUE,0,FALSE,15983,19092,515,21.8,FALSE,1,TRUE,15468,17689,-515,19.4
FALSE,FALSE,0,FALSE,14513,17238,-2382,21.8,TRUE,1,TRUE,16895,19457,2382,24.8
TRUE,TRUE,1,TRUE,17536,19253,2880,26.6,FALSE,0,FALSE,14656,16468,-2880,19.7
FALSE,TRUE,1,TRUE,15796,16848,724,22.1,FALSE,0,FALSE,15072,18595,-724,20.9
TRUE,TRUE,1,TRUE,20833,20278,4882,23.1,FALSE,0,FALSE,15951,17372,-4882,20.2
TRUE,TRUE,1,TRUE,18650,20329,3877,24.8,FALSE,0,FALSE,14773,18567,-3877,22
FALSE,FALSE,1,TRUE,15044,17888,-2127,21.4,TRUE,0,FALSE,17171,18885,2127,22.8
FALSE,TRUE,1,TRUE,15811,17771,161,21.2,FALSE,0,FALSE,15650,17868,-161,22.2
FALSE,TRUE,0,FALSE,15612,17757,608,22.8,FALSE,1,TRUE,15004,17395,-608,20.8
FALSE,FALSE,1,TRUE,15151,16565,-4570,20.4,TRUE,1,FALSE,19721,19917,4570,20.7
FALSE,FALSE,0,FALSE,16496,18365,120,24.4,TRUE,1,TRUE,16376,16822,-120,20.6
FALSE,TRUE,0,FALSE,16059,17499,-1073,19,FALSE,1,FALSE,17132,18156,1073,23.2
TRUE,FALSE,0,FALSE,15120,16083,-3181,18.9,TRUE,0,FALSE,18301,18981,3181,21.4
TRUE,TRUE,1,FALSE,16185,17330,-226,21.2,FALSE,1,TRUE,16411,17592,226,22.8
FALSE,TRUE,0,FALSE,15404,17439,-3096,24,FALSE,1,TRUE,18500,21191,3096,25.6
TRUE,TRUE,0,FALSE,17952,18161,2123,21,FALSE,1,TRUE,15829,15598,-2123,19.2
FALSE,TRUE,0,FALSE,14776,15469,-5760,16.1,FALSE,1,FALSE,20536,19637,5760,23.5
FALSE,FALSE,0,FALSE,16183,17767,-2155,25.1,TRUE,1,TRUE,18338,20016,2155,21.9
TRUE,FALSE,0,FALSE,16037,18122,-519,23.1,TRUE,0,FALSE,16556,16830,519,21.3
TRUE,FALSE,2,TRUE,18041,18637,786,22.1,TRUE,0,FALSE,17255,17588,-786,21.3
TRUE,FALSE,1,TRUE,14820,16224,-1671,16.7,TRUE,0,FALSE,16491,17324,1671,22.3
FALSE,FALSE,0,FALSE,13943,17294,-4036,23,TRUE,1,TRUE,17979,19138,4036,23.1
FALSE,FALSE,2,TRUE,17023,16951,-1148,20.1,TRUE,0,FALSE,18171,19148,1148,22.6
TRUE,TRUE,0,FALSE,15011,17250,-1399,22.3,FALSE,1,TRUE,16410,18013,1399,20.8
TRUE,FALSE,0,FALSE,20067,20095,4409,22.9,TRUE,1,TRUE,15658,15592,-4409,18.2
TRUE,TRUE,1,TRUE,17149,17815,770,19.6,FALSE,0,FALSE,16379,17861,-770,20.2
FALSE,TRUE,1,TRUE,14688,16866,-2193,19.9,FALSE,0,FALSE,16881,18440,2193,21.7
FALSE,TRUE,2,TRUE,16125,19055,1236,23.5,FALSE,0,FALSE,14889,18911,-1236,24.9
FALSE,TRUE,1,FALSE,14197,17212,-2144,22.5,FALSE,1,TRUE,16341,19663,2144,24.6
TRUE,TRUE,1,FALSE,18863,20134,4785,23.8,FALSE,0,FALSE,14078,15659,-4785,20.6
TRUE,FALSE,1,TRUE,15488,18538,-344,24,TRUE,0,FALSE,15832,17177,344,24.1
TRUE,FALSE,0,FALSE,18283,18662,905,20.9,TRUE,1,TRUE,17378,18350,-905,20.6
TRUE,TRUE,0,FALSE,18538,19030,1806,24.7,FALSE,1,TRUE,16732,18398,-1806,21.6
TRUE,FALSE,1,FALSE,17875,20182,2095,20.6,TRUE,1,TRUE,15780,18518,-2095,21.5
TRUE,FALSE,0,FALSE,16954,17771,2589,22.1,TRUE,1,TRUE,14365,15262,-2589,18.7
FALSE,FALSE,2,TRUE,15073,16649,-745,23.4,TRUE,0,FALSE,15818,18475,745,20
TRUE,TRUE,0,FALSE,16038,18686,329,21.9,FALSE,1,TRUE,15709,16982,-329,20.8
FALSE,FALSE,0,FALSE,16032,18159,-478,22.9,TRUE,1,TRUE,16510,18548,478,22.1
FALSE,TRUE,1,TRUE,15669,17654,273,22.3,FALSE,0,FALSE,15396,18764,-273,23.7
TRUE,TRUE,1,TRUE,18198,18250,2713,24.6,FALSE,1,FALSE,15485,17786,-2713,18.7
FALSE,TRUE,1,TRUE,19528,18855,1852,21.1,FALSE,0,FALSE,17676,18636,-1852,21.7
TRUE,FALSE,2,TRUE,17316,18199,767,20.6,TRUE,0,FALSE,16549,17403,-767,21.6
FALSE,FALSE,0,FALSE,16509,18241,373,20.2,TRUE,1,TRUE,16136,19809,-373,22.4
TRUE,TRUE,0,FALSE,17741,18253,2405,23,FALSE,1,TRUE,15336,16814,-2405,19.9
FALSE,TRUE,2,TRUE,16124,18986,2186,24.4,FALSE,0,FALSE,13938,17667,-2186,24.1
TRUE,TRUE,1,TRUE,16395,17740,1315,21.4,FALSE,0,FALSE,15080,17839,-1315,20.9
TRUE,TRUE,1,TRUE,18020,18981,2533,25.3,FALSE,0,FALSE,15487,17809,-2533,21.2
FALSE,FALSE,0,FALSE,14759,17310,-1394,19.4,TRUE,1,TRUE,16153,17899,1394,24.6
FALSE,TRUE,0,FALSE,14521,16346,-4413,18.6,FALSE,1,TRUE,18934,21417,4413,23.4
TRUE,TRUE,1,FALSE,18341,19885,3347,22.9,FALSE,1,TRUE,14994,16927,-3347,20.6
FALSE,TRUE,0,FALSE,19599,19082,4085,21.1,FALSE,1,TRUE,15514,16943,-4085,18.8
FALSE,TRUE,0,FALSE,18019,17440,4581,21,FALSE,0,FALSE,13438,14648,-4581,15.3
FALSE,TRUE,1,TRUE,16491,16774,453,19,FALSE,0,FALSE,16038,18519,-453,23.8
TRUE,TRUE,0,FALSE,21699,20734,5773,24.2,FALSE,1,TRUE,15926,17091,-5773,20.8
FALSE,FALSE,1,FALSE,16249,18403,251,21.7,TRUE,1,TRUE,15998,17329,-251,22.9
FALSE,FALSE,1,TRUE,16476,17474,335,21,TRUE,0,FALSE,16141,16743,-335,20.6
TRUE,TRUE,2,TRUE,18246,17783,3826,22.8,FALSE,0,FALSE,14420,14661,-3826,15.6
TRUE,TRUE,2,TRUE,16646,18549,919,24.2,FALSE,0,FALSE,15727,18455,-919,25.8
TRUE,TRUE,0,FALSE,16568,18389,2150,22.2,FALSE,1,TRUE,14418,17914,-2150,22.8
TRUE,TRUE,1,TRUE,18519,18555,1840,22.3,FALSE,1,FALSE,16679,18411,-1840,21.4
FALSE,FALSE,0,FALSE,15498,17805,-1953,22.8,TRUE,2,TRUE,17451,19659,1953,25.9
FALSE,FALSE,0,FALSE,14927,17831,-2435,20.5,TRUE,1,TRUE,17362,18681,2435,22.7
FALSE,FALSE,0,FALSE,15120,17606,-1338,23,TRUE,1,TRUE,16458,18385,1338,23.4
TRUE,FALSE,1,TRUE,17146,19310,2072,22.7,TRUE,0,FALSE,15074,16943,-2072,24.1
FALSE,TRUE,1,FALSE,16141,17238,-1634,22.9,FALSE,0,FALSE,17775,20082,1634,24
TRUE,TRUE,1,TRUE,17798,18795,3120,22,FALSE,0,FALSE,14678,16331,-3120,19.2
TRUE,FALSE,0,FALSE,15945,17648,-781,24.8,TRUE,1,TRUE,16726,17359,781,19.5
FALSE,FALSE,0,FALSE,16169,17326,-620,21.4,TRUE,2,TRUE,16789,19310,620,23.7
FALSE,TRUE,0,FALSE,15177,17645,-1716,22,FALSE,0,FALSE,16893,20456,1716,24.1
TRUE,TRUE,0,FALSE,18307,19628,5027,23.5,FALSE,0,FALSE,13280,16234,-5027,21.1
FALSE,FALSE,2,TRUE,16473,18395,-932,20.1,TRUE,0,FALSE,17405,18245,932,24.6
TRUE,TRUE,1,TRUE,19483,18561,5415,21.1,FALSE,0,FALSE,14068,15570,-5415,20.3
FALSE,TRUE,0,FALSE,15230,15161,-3832,18.5,FALSE,1,TRUE,19062,19076,3832,21.9
TRUE,FALSE,1,TRUE,16583,17389,840,22.2,TRUE,0,FALSE,15743,17004,-840,21.3
FALSE,FALSE,1,FALSE,16840,18376,-990,22.1,TRUE,1,TRUE,17830,20390,990,24.7
TRUE,TRUE,1,FALSE,17836,19027,969,21.4,FALSE,1,TRUE,16867,17473,-969,21.6
TRUE,TRUE,0,FALSE,21658,20318,6413,21.1,FALSE,2,TRUE,15245,16366,-6413,20.3
TRUE,FALSE,0,FALSE,19170,18219,3062,19.3,TRUE,0,FALSE,16108,15447,-3062,14.2
TRUE,TRUE,0,FALSE,18229,18093,2765,23,FALSE,2,TRUE,15464,16686,-2765,19.5
TRUE,FALSE,0,FALSE,17591,18925,3208,23.5,TRUE,0,FALSE,14383,15640,-3208,18.6
FALSE,TRUE,0,FALSE,15067,17232,-1641,17.2,FALSE,0,FALSE,16708,18842,1641,25.4
FALSE,FALSE,0,FALSE,13844,15601,-5161,22.4,TRUE,1,TRUE,19005,19700,5161,20
FALSE,TRUE,0,FALSE,15699,17479,-907,22.6,FALSE,1,TRUE,16606,19129,907,24.4
TRUE,FALSE,0,FALSE,17077,19128,-162,24.2,TRUE,0,FALSE,17239,18951,162,24.5
TRUE,FALSE,0,FALSE,15710,16731,-3731,20.5,TRUE,1,TRUE,19441,18189,3731,23
TRUE,TRUE,0,FALSE,16450,18801,1771,22.9,FALSE,1,TRUE,14679,16955,-1771,19.4
FALSE,FALSE,0,FALSE,16228,18476,352,23.4,TRUE,0,FALSE,15876,17837,-352,20.3
FALSE,TRUE,1,TRUE,16803,18812,1189,25.5,FALSE,0,FALSE,15614,17661,-1189,20.6
FALSE,TRUE,1,TRUE,15462,17729,-1176,24.9,FALSE,0,FALSE,16638,19228,1176,24.8
TRUE,TRUE,1,FALSE,16233,17972,1404,21,FALSE,0,FALSE,14829,16686,-1404,20.9
TRUE,TRUE,1,FALSE,16239,16109,-4876,20.2,FALSE,1,TRUE,21115,19590,4876,23
FALSE,TRUE,0,FALSE,15514,16759,249,22.3,FALSE,1,TRUE,15265,16577,-249,20.4
FALSE,TRUE,0,FALSE,18466,19801,2220,21.8,FALSE,1,TRUE,16246,17501,-2220,18.5
FALSE,TRUE,1,TRUE,16907,18996,1559,25.9,FALSE,0,FALSE,15348,18182,-1559,18.9
TRUE,TRUE,0,FALSE,17662,18294,1673,19.5,FALSE,1,FALSE,15989,17758,-1673,17.3
FALSE,FALSE,0,FALSE,14738,16575,-4785,19.9,TRUE,1,TRUE,19523,19892,4785,22
FALSE,FALSE,1,TRUE,16225,17213,-2463,20.6,TRUE,0,FALSE,18688,19376,2463,22.4
TRUE,TRUE,0,FALSE,18486,20095,5159,26.4,FALSE,1,TRUE,13327,15179,-5159,18.2
FALSE,FALSE,0,FALSE,14597,17317,-3805,22,TRUE,0,FALSE,18402,19876,3805,27.4
TRUE,TRUE,0,FALSE,16818,19595,2274,25,FALSE,0,FALSE,14544,16901,-2274,20.2
FALSE,FALSE,0,FALSE,13714,16890,-5129,20.1,TRUE,1,FALSE,18843,19945,5129,25
TRUE,FALSE,1,TRUE,17946,18589,2398,22.5,TRUE,1,FALSE,15548,17016,-2398,23
FALSE,FALSE,1,FALSE,16141,19201,488,21.5,TRUE,1,TRUE,15653,16852,-488,18.3
FALSE,FALSE,0,FALSE,17151,17131,-2489,21.5,TRUE,1,TRUE,19640,19186,2489,20.5
TRUE,TRUE,0,FALSE,18483,18474,270,22.2,FALSE,1,TRUE,18213,19162,-270,20.7
TRUE,TRUE,2,TRUE,15530,17715,1219,23.5,FALSE,0,FALSE,14311,17483,-1219,23.8
FALSE,FALSE,1,TRUE,15900,18137,-435,20.6,TRUE,0,FALSE,16335,19097,435,21.8
TRUE,TRUE,2,TRUE,17520,19639,4228,24.5,FALSE,0,FALSE,13292,16759,-4228,19.4
FALSE,TRUE,0,FALSE,15933,18047,465,24.6,FALSE,2,TRUE,15468,17415,-465,20.3
FALSE,TRUE,0,FALSE,16369,18174,-1673,23.6,FALSE,0,FALSE,18042,19395,1673,23.9
TRUE,FALSE,0,FALSE,14422,17039,-1723,24.5,TRUE,1,TRUE,16145,17584,1723,22.9
FALSE,FALSE,0,FALSE,13570,15620,-6578,19.4,TRUE,2,TRUE,20148,20427,6578,26.7
FALSE,FALSE,0,FALSE,15706,17720,-1992,24.4,TRUE,2,TRUE,17698,19308,1992,25.6
TRUE,FALSE,0,FALSE,17898,18398,-113,23.1,TRUE,1,TRUE,18011,18514,113,21.8
FALSE,FALSE,0,FALSE,14397,16267,-3517,21,TRUE,1,TRUE,17914,19641,3517,22.6
TRUE,FALSE,1,FALSE,17227,18492,2582,24.5,TRUE,1,TRUE,14645,15837,-2582,20
FALSE,FALSE,1,TRUE,16080,17928,533,21.8,TRUE,0,FALSE,15547,16741,-533,21.9
FALSE,TRUE,1,TRUE,15346,16812,-973,23,FALSE,0,FALSE,16319,17824,973,17.8
FALSE,FALSE,1,FALSE,13853,14781,-3650,20.5,TRUE,0,FALSE,17503,17900,3650,22.1
FALSE,TRUE,0,FALSE,14417,16652,-1930,19.8,FALSE,1,TRUE,16347,18695,1930,22.3
TRUE,TRUE,0,FALSE,18676,18018,3188,19.6,FALSE,0,FALSE,15488,15729,-3188,16.4
FALSE,TRUE,0,FALSE,18858,18627,2674,19.5,FALSE,0,FALSE,16184,16997,-2674,24
TRUE,TRUE,1,TRUE,18463,19599,3002,24.8,FALSE,1,FALSE,15461,17474,-3002,21.8
FALSE,TRUE,0,FALSE,15286,16864,-1936,18.1,FALSE,1,TRUE,17222,17510,1936,23
FALSE,TRUE,1,TRUE,17088,18472,-2595,20.6,FALSE,0,FALSE,19683,19046,2595,23.3
FALSE,TRUE,0,FALSE,14674,15727,-5092,18.4,FALSE,0,FALSE,19766,19923,5092,24
TRUE,FALSE,0,FALSE,16676,18316,-978,20.1,TRUE,0,FALSE,17654,19392,978,20.3
FALSE,TRUE,2,TRUE,16843,19160,1597,24.1,FALSE,0,FALSE,15246,17543,-1597,23.1
TRUE,TRUE,1,TRUE,17640,18174,4035,20.7,FALSE,0,FALSE,13605,14863,-4035,15.5
FALSE,TRUE,1,FALSE,16517,16968,473,18.2,FALSE,1,TRUE,16044,16522,-473,18.3
TRUE,TRUE,1,FALSE,18626,19683,5448,20.5,FALSE,1,TRUE,13178,15264,-5448,17.9
TRUE,TRUE,1,TRUE,20996,19123,6476,21.8,FALSE,0,FALSE,14520,14862,-6476,14.7
TRUE,FALSE,0,FALSE,16595,19727,1584,22,TRUE,2,TRUE,15011,17278,-1584,20.4
FALSE,FALSE,1,FALSE,16561,18103,-1637,23.9,TRUE,1,TRUE,18198,18989,1637,24
FALSE,FALSE,0,FALSE,15676,19519,-2476,22.3,TRUE,2,TRUE,18152,19913,2476,26
TRUE,FALSE,1,TRUE,16847,17670,505,20.9,TRUE,0,FALSE,16342,18687,-505,21.2
TRUE,FALSE,0,FALSE,14837,17198,-576,20.5,TRUE,1,TRUE,15413,18516,576,17.2
FALSE,FALSE,0,FALSE,15624,18203,-1647,22.9,TRUE,1,TRUE,17271,20069,1647,24.3
FALSE,FALSE,1,TRUE,14587,16414,-2395,22.2,TRUE,1,FALSE,16982,18628,2395,25.4
FALSE,TRUE,1,FALSE,15904,16786,-1067,23.2,FALSE,1,TRUE,16971,18384,1067,23
FALSE,FALSE,1,FALSE,14103,17162,-1977,23,TRUE,0,FALSE,16080,17862,1977,22.4
TRUE,TRUE,1,TRUE,16685,18048,2306,21.6,FALSE,0,FALSE,14379,16389,-2306,20.8
TRUE,FALSE,1,TRUE,16501,18178,366,23.4,TRUE,0,FALSE,16135,18094,-366,23.1
FALSE,TRUE,1,FALSE,15694,17103,567,24.8,FALSE,1,TRUE,15127,18121,-567,24.5
TRUE,FALSE,1,TRUE,16544,18907,272,24.7,TRUE,0,FALSE,16272,17422,-272,22.1
FALSE,TRUE,0,FALSE,18923,18843,1744,22.5,FALSE,1,FALSE,17179,18389,-1744,21.9
FALSE,TRUE,0,FALSE,14756,16229,-2175,22.6,FALSE,0,FALSE,16931,18615,2175,23.3
TRUE,FALSE,1,FALSE,14450,15560,-5976,18.6,TRUE,1,TRUE,20426,20179,5976,26.4
TRUE,TRUE,0,FALSE,15332,17832,359,22.9,FALSE,1,TRUE,14973,18218,-359,24.2
FALSE,FALSE,0,FALSE,14026,17348,-2478,21,TRUE,0,FALSE,16504,18606,2478,24.4
FALSE,TRUE,0,FALSE,16835,18378,700,22,FALSE,0,FALSE,16135,17564,-700,21
TRUE,TRUE,0,FALSE,17301,20766,1207,24.1,FALSE,0,FALSE,16094,18522,-1207,24.3
TRUE,FALSE,0,FALSE,16489,17951,-592,21.9,TRUE,2,TRUE,17081,18174,592,22.7
TRUE,TRUE,0,FALSE,17212,17919,684,22.7,FALSE,0,FALSE,16528,17752,-684,19.9
FALSE,TRUE,2,TRUE,15090,15998,-3684,17.6,FALSE,0,FALSE,18774,19133,3684,24.6
FALSE,FALSE,0,FALSE,14319,16364,-1272,21.9,TRUE,0,FALSE,15591,18699,1272,23.6
TRUE,FALSE,0,FALSE,16721,18046,1788,23.7,TRUE,0,FALSE,14933,15622,-1788,21
FALSE,TRUE,0,FALSE,15089,17098,-5292,23.5,FALSE,1,TRUE,20381,21102,5292,23.4
TRUE,TRUE,0,FALSE,15662,17214,-130,20.2,FALSE,1,TRUE,15792,17838,130,20
FALSE,FALSE,0,FALSE,15463,16939,-2791,20.6,TRUE,1,TRUE,18254,19185,2791,22.7
FALSE,TRUE,0,FALSE,16880,17307,-2125,21.6,FALSE,1,FALSE,19005,20422,2125,22.1
TRUE,FALSE,2,TRUE,15216,18894,-101,21.6,TRUE,0,FALSE,15317,19450,101,24.8
TRUE,TRUE,0,FALSE,17674,18595,1269,20.9,FALSE,0,FALSE,16405,17807,-1269,20.5
FALSE,TRUE,1,TRUE,16533,17396,251,23.1,FALSE,0,FALSE,16282,17736,-251,21.7
TRUE,FALSE,0,FALSE,15716,16980,-3446,22.5,TRUE,2,TRUE,19162,20797,3446,23.9
TRUE,TRUE,0,FALSE,17631,18398,2803,26.1,FALSE,1,FALSE,14828,15927,-2803,18.8
FALSE,FALSE,0,FALSE,15148,18263,-1416,21.3,TRUE,1,TRUE,16564,18200,1416,23
FALSE,FALSE,0,FALSE,14649,17099,-2588,18.6,TRUE,1,TRUE,17237,17983,2588,24.6
FALSE,FALSE,1,TRUE,16517,16913,-409,23.8,TRUE,1,FALSE,16926,19011,409,25.4
TRUE,FALSE,0,FALSE,18026,18214,894,21.1,TRUE,0,FALSE,17132,17575,-894,19.5
FALSE,TRUE,0,FALSE,16399,18258,-1977,21.4,FALSE,0,FALSE,18376,19202,1977,23.1
TRUE,TRUE,1,FALSE,18959,18151,2316,18.6,FALSE,1,TRUE,16643,16853,-2316,21.9
FALSE,FALSE,0,FALSE,13888,15518,-3220,17.2,TRUE,1,FALSE,17108,19612,3220,24.2
TRUE,FALSE,1,TRUE,15188,17748,52,23.6,TRUE,0,FALSE,15136,16712,-52,21.4
FALSE,FALSE,0,FALSE,14395,17060,-1386,21,TRUE,0,FALSE,15781,17395,1386,21.1
FALSE,TRUE,0,FALSE,17663,18440,1942,20.2,FALSE,1,FALSE,15721,17550,-1942,20.5
TRUE,TRUE,1,FALSE,18348,19545,3111,21.6,FALSE,1,TRUE,15237,16806,-3111,20.2
TRUE,FALSE,0,FALSE,13337,15472,-4427,19.7,TRUE,1,TRUE,17764,18771,4427,23.6
TRUE,TRUE,0,FALSE,17064,18586,1183,20.7,FALSE,1,FALSE,15881,17550,-1183,21.7
TRUE,TRUE,2,TRUE,18595,21025,5236,23.7,FALSE,0,FALSE,13359,15478,-5236,19.9
FALSE,FALSE,0,FALSE,15096,17840,-915,22.8,TRUE,0,FALSE,16011,18875,915,23.9
TRUE,FALSE,0,FALSE,17743,20843,2507,24.7,TRUE,0,FALSE,15236,17407,-2507,18.6
TRUE,TRUE,0,FALSE,17088,18459,-788,21.9,FALSE,2,TRUE,17876,18308,788,22.6
TRUE,FALSE,1,TRUE,17810,19743,3866,24.8,TRUE,0,FALSE,13944,16247,-3866,19.1
TRUE,FALSE,0,FALSE,13954,17057,-936,23.1,TRUE,0,FALSE,14890,17681,936,19.9
TRUE,TRUE,0,FALSE,16300,19402,955,24.4,FALSE,1,TRUE,15345,17569,-955,19.2
FALSE,FALSE,1,FALSE,16096,17359,-581,22.4,TRUE,0,FALSE,16677,17213,581,20.4
FALSE,TRUE,1,TRUE,16331,16667,-2814,22,FALSE,1,FALSE,19145,19290,2814,22
TRUE,TRUE,2,TRUE,16515,18870,1967,25.7,FALSE,0,FALSE,14548,17802,-1967,23.3
TRUE,FALSE,1,TRUE,16860,18682,1245,26.4,TRUE,0,FALSE,15615,17996,-1245,24.8
TRUE,TRUE,0,FALSE,16870,16180,829,21.2,FALSE,1,TRUE,16041,17109,-829,24.5
TRUE,FALSE,0,FALSE,17001,19717,759,24.2,TRUE,0,FALSE,16242,19250,-759,24.2
FALSE,TRUE,0,FALSE,14112,16664,-174,22.3,FALSE,0,FALSE,14286,16699,174,22.6
FALSE,FALSE,1,TRUE,15300,18001,-978,26.6,TRUE,0,FALSE,16278,18850,978,22.8
TRUE,TRUE,1,TRUE,19276,19221,1801,19.2,FALSE,0,FALSE,17475,17003,-1801,21.7
FALSE,TRUE,0,FALSE,15766,16789,-1590,22,FALSE,1,TRUE,17356,17569,1590,23.5
FALSE,TRUE,0,FALSE,15292,18345,-1805,18.7,FALSE,1,TRUE,17097,18849,1805,24.1
FALSE,TRUE,0,FALSE,14321,16217,-1296,20.3,FALSE,1,TRUE,15617,16599,1296,22.6
FALSE,TRUE,0,FALSE,16492,17944,-2847,22,FALSE,2,TRUE,19339,19299,2847,23.7
TRUE,TRUE,1,TRUE,17357,18244,1031,22.2,FALSE,1,FALSE,16326,17415,-1031,20.8
TRUE,TRUE,0,FALSE,17519,17307,1953,21.5,FALSE,0,FALSE,15566,17172,-1953,21.5
TRUE,TRUE,0,FALSE,16139,17770,690,24.5,FALSE,1,TRUE,15449,17326,-690,20.6
FALSE,FALSE,1,TRUE,17088,18568,-793,20.1,TRUE,0,FALSE,17881,17962,793,22.1
TRUE,FALSE,1,TRUE,15609,18083,661,18,TRUE,0,FALSE,14948,17348,-661,19.9
FALSE,TRUE,1,FALSE,18913,19182,3240,22.5,FALSE,1,TRUE,15673,17395,-3240,23.7
TRUE,FALSE,1,TRUE,18054,18465,1859,24.1,TRUE,0,FALSE,16195,17194,-1859,19.7
TRUE,FALSE,1,TRUE,15690,17299,903,21.4,TRUE,0,FALSE,14787,16189,-903,19.9
FALSE,TRUE,0,FALSE,16003,17739,353,22.6,FALSE,1,TRUE,15650,17899,-353,20.9
TRUE,FALSE,0,FALSE,18181,17078,1520,20.2,TRUE,0,FALSE,16661,15968,-1520,16.5
FALSE,FALSE,0,FALSE,15628,17683,-623,22.1,TRUE,1,TRUE,16251,17722,623,22.3
TRUE,TRUE,1,TRUE,18093,17986,2025,21.1,FALSE,0,FALSE,16068,18446,-2025,19.9
TRUE,FALSE,1,FALSE,15607,18678,-315,21.5,TRUE,1,TRUE,15922,17960,315,24.6
TRUE,TRUE,1,TRUE,15164,17404,-1592,21.8,FALSE,0,FALSE,16756,19603,1592,25.5
FALSE,FALSE,0,FALSE,18090,18948,736,23.8,TRUE,0,FALSE,17354,19297,-736,21.3
TRUE,TRUE,1,TRUE,17001,18549,3156,24,FALSE,0,FALSE,13845,16928,-3156,20.6
TRUE,TRUE,0,FALSE,15904,17670,1085,21.3,FALSE,0,FALSE,14819,18226,-1085,22.9
TRUE,FALSE,1,FALSE,18215,19165,3672,23.9,TRUE,1,TRUE,14543,14433,-3672,18.3
TRUE,FALSE,0,FALSE,16177,18401,-126,21.6,TRUE,2,TRUE,16303,17938,126,21.5
FALSE,FALSE,1,TRUE,17087,17225,-988,20.6,TRUE,1,FALSE,18075,18546,988,20.1
TRUE,TRUE,1,FALSE,16594,18973,466,22.4,FALSE,1,TRUE,16128,18040,-466,23.3
FALSE,TRUE,0,FALSE,15101,18673,-1443,24.1,FALSE,1,TRUE,16544,18942,1443,21.7
TRUE,FALSE,1,TRUE,15787,17255,833,20.9,TRUE,0,FALSE,14954,16872,-833,17.9
TRUE,TRUE,1,TRUE,15936,18164,-189,25.5,FALSE,0,FALSE,16125,18873,189,25.2
FALSE,FALSE,0,FALSE,15608,18584,-233,23.4,TRUE,2,TRUE,15841,18564,233,24
TRUE,TRUE,0,FALSE,17226,19315,-193,22.6,FALSE,1,TRUE,17419,18767,193,22.3
FALSE,FALSE,0,FALSE,16972,19143,-1832,19.8,TRUE,1,TRUE,18804,19529,1832,23
TRUE,FALSE,1,FALSE,16421,19037,961,22.4,TRUE,0,FALSE,15460,18188,-961,19.4
FALSE,FALSE,1,FALSE,16664,18036,1047,25.5,TRUE,1,TRUE,15617,18179,-1047,24.7
FALSE,FALSE,0,FALSE,14920,17398,-6000,18.6,TRUE,1,TRUE,20920,21254,6000,24.6
FALSE,FALSE,1,TRUE,18227,19733,3036,24.8,TRUE,0,FALSE,15191,16482,-3036,17.3
TRUE,TRUE,0,FALSE,19885,18684,5422,17.7,FALSE,1,TRUE,14463,15425,-5422,18.2
FALSE,FALSE,0,FALSE,15225,16334,-3230,18,TRUE,1,TRUE,18455,19577,3230,22.7
FALSE,FALSE,1,TRUE,15070,18012,-2692,21.7,TRUE,0,FALSE,17762,19163,2692,22.5
FALSE,FALSE,1,TRUE,16425,18433,-336,23.2,TRUE,0,FALSE,16761,18557,336,19.7
TRUE,TRUE,0,FALSE,17168,17989,1089,23.3,FALSE,1,TRUE,16079,17793,-1089,23.5
TRUE,FALSE,1,TRUE,17822,18329,-775,20.9,TRUE,0,FALSE,18597,17642,775,21.9
FALSE,FALSE,0,FALSE,14055,16334,-4331,20.8,TRUE,1,TRUE,18386,18922,4331,22.6
FALSE,FALSE,1,TRUE,16213,17532,-916,20.8,TRUE,0,FALSE,17129,17049,916,21.5
FALSE,FALSE,0,FALSE,16337,16985,-2529,20.2,TRUE,1,TRUE,18866,19076,2529,21.4
FALSE,TRUE,1,FALSE,15736,18218,705,23.4,FALSE,1,TRUE,15031,18426,-705,25
TRUE,FALSE,1,FALSE,16790,18508,1814,24.2,TRUE,1,TRUE,14976,17889,-1814,18.5
FALSE,TRUE,1,TRUE,16091,17434,-1053,23,FALSE,0,FALSE,17144,18797,1053,24.8
FALSE,FALSE,0,FALSE,14433,15908,-4395,21,TRUE,2,TRUE,18828,19994,4395,21.9
TRUE,TRUE,0,FALSE,17389,18966,3129,23.7,FALSE,1,TRUE,14260,17550,-3129,20.3
FALSE,FALSE,1,FALSE,14475,16283,-4666,20.5,TRUE,1,TRUE,19141,19369,4666,22.4
FALSE,FALSE,1,FALSE,15373,18233,599,26.4,TRUE,0,FALSE,14774,17479,-599,21.2
FALSE,FALSE,0,FALSE,14381,16919,-2528,20.2,TRUE,1,TRUE,16909,17912,2528,19.6
TRUE,TRUE,0,FALSE,17975,18967,1283,24.8,FALSE,1,TRUE,16692,18449,-1283,21.7
TRUE,TRUE,1,TRUE,17459,19021,2929,23.1,FALSE,0,FALSE,14530,17725,-2929,19.1
TRUE,TRUE,1,FALSE,19056,19650,2638,23.2,FALSE,0,FALSE,16418,17227,-2638,20.4
FALSE,FALSE,0,FALSE,14117,16799,-4158,19.9,TRUE,2,TRUE,18275,20251,4158,24.8
FALSE,TRUE,1,FALSE,17191,17872,-355,22.7,FALSE,0,FALSE,17546,19647,355,20.4
TRUE,TRUE,1,TRUE,18585,18660,3161,21.6,FALSE,0,FALSE,15424,16581,-3161,18.5
TRUE,TRUE,2,TRUE,18271,20332,2875,22.4,FALSE,0,FALSE,15396,17154,-2875,21.3
TRUE,TRUE,0,FALSE,17953,18196,3363,21.8,FALSE,1,TRUE,14590,15199,-3363,17.6
FALSE,TRUE,1,TRUE,15645,17261,6,18.4,FALSE,1,FALSE,15639,16238,-6,23
FALSE,FALSE,0,FALSE,14588,17460,-2574,24.1,TRUE,0,FALSE,17162,17864,2574,22.2
TRUE,FALSE,0,FALSE,16152,17881,-428,26,TRUE,2,TRUE,16580,18313,428,23.8
TRUE,TRUE,1,TRUE,17030,18285,1866,21.2,FALSE,0,FALSE,15164,18205,-1866,24.6
TRUE,TRUE,1,FALSE,19204,20520,1902,21.5,FALSE,0,FALSE,17302,17150,-1902,18.3
FALSE,FALSE,0,FALSE,14925,18636,-1375,21.8,TRUE,1,TRUE,16300,19486,1375,22
TRUE,FALSE,2,TRUE,17561,19417,2585,22.2,TRUE,0,FALSE,14976,16127,-2585,22.2
FALSE,FALSE,0,FALSE,15049,16534,-2353,21.1,TRUE,2,TRUE,17402,18584,2353,23.5
FALSE,TRUE,1,TRUE,15523,18159,-279,23.3,FALSE,0,FALSE,15802,18570,279,24.7
FALSE,FALSE,0,FALSE,14910,16907,-2917,22.7,TRUE,2,TRUE,17827,19713,2917,21.6
FALSE,TRUE,0,FALSE,15787,15849,-3783,20,FALSE,1,TRUE,19570,19149,3783,20.1
FALSE,FALSE,0,FALSE,16840,19282,-103,26.4,TRUE,2,TRUE,16943,18423,103,21.9
TRUE,FALSE,1,TRUE,14541,18354,-1345,24,TRUE,0,FALSE,15886,18975,1345,26
TRUE,TRUE,0,FALSE,16273,17751,-1115,19.3,FALSE,1,TRUE,17388,18634,1115,20.8
FALSE,FALSE,0,FALSE,14531,16999,-1711,22.2,TRUE,1,TRUE,16242,19182,1711,23.5
TRUE,TRUE,0,FALSE,17413,17940,1221,22.9,FALSE,0,FALSE,16192,18112,-1221,21.3
FALSE,FALSE,0,FALSE,15622,17546,-2461,24.6,TRUE,1,TRUE,18083,19172,2461,22.8
FALSE,TRUE,2,TRUE,19556,18530,2100,19.8,FALSE,0,FALSE,17456,16974,-2100,18.9
FALSE,TRUE,0,FALSE,16797,18636,823,21.3,FALSE,1,FALSE,15974,15955,-823,15.8
FALSE,FALSE,1,FALSE,15735,17073,-488,22.5,TRUE,1,TRUE,16223,17310,488,20
TRUE,TRUE,1,TRUE,18570,19063,2093,20.6,FALSE,0,FALSE,16477,16912,-2093,21.2
TRUE,TRUE,0,FALSE,17849,18536,3364,22.7,FALSE,1,TRUE,14485,16124,-3364,22.3
TRUE,TRUE,1,TRUE,19364,19292,3356,23.2,FALSE,0,FALSE,16008,17035,-3356,19.8
TRUE,FALSE,0,FALSE,17047,19134,1992,22.6,TRUE,1,TRUE,15055,16586,-1992,22.5
FALSE,TRUE,0,FALSE,16105,17701,-1198,23.7,FALSE,1,FALSE,17303,18534,1198,23
FALSE,FALSE,0,FALSE,15611,17672,-2415,22.2,TRUE,1,TRUE,18026,19764,2415,23.1
TRUE,TRUE,0,FALSE,18766,20059,2265,23.1,FALSE,0,FALSE,16501,17403,-2265,22.5
TRUE,TRUE,1,TRUE,17590,19299,2708,23.1,FALSE,1,FALSE,14882,17393,-2708,22.3
FALSE,TRUE,1,FALSE,15222,16160,-2558,19.2,FALSE,1,TRUE,17780,19038,2558,20.5
FALSE,FALSE,0,FALSE,15537,18116,-294,23.9,TRUE,1,FALSE,15831,18647,294,24.4
TRUE,TRUE,1,TRUE,19265,20085,4692,24.4,FALSE,0,FALSE,14573,16441,-4692,22.1
FALSE,FALSE,1,TRUE,14746,17859,-1222,23.7,TRUE,0,FALSE,15968,18674,1222,24.6
TRUE,FALSE,1,TRUE,15261,15935,-1107,22.7,TRUE,0,FALSE,16368,18829,1107,22.4
FALSE,FALSE,0,FALSE,13465,15462,-3179,19.1,TRUE,1,TRUE,16644,16399,3179,22.6
TRUE,TRUE,1,FALSE,20310,20225,5565,23,FALSE,1,TRUE,14745,15158,-5565,16.9
TRUE,TRUE,0,FALSE,17527,18186,1863,22.7,FALSE,1,TRUE,15664,17722,-1863,23.1
FALSE,TRUE,0,FALSE,15061,15124,-4179,18.3,FALSE,1,FALSE,19240,19655,4179,23.6
TRUE,TRUE,1,TRUE,16765,18366,-923,21.3,FALSE,0,FALSE,17688,18595,923,21.4
FALSE,FALSE,0,FALSE,15018,17474,-1910,20,TRUE,0,FALSE,16928,19255,1910,22.7
TRUE,TRUE,0,FALSE,18205,19871,4061,22.5,FALSE,1,FALSE,14144,16685,-4061,18.7
TRUE,TRUE,0,FALSE,15284,16690,-480,18.7,FALSE,1,TRUE,15764,17297,480,23
FALSE,TRUE,1,TRUE,15026,16386,-2243,20.2,FALSE,0,FALSE,17269,20053,2243,22.9
FALSE,TRUE,0,FALSE,15827,17668,443,21.2,FALSE,1,TRUE,15384,19105,-443,23.2
TRUE,FALSE,0,FALSE,16463,18961,354,22.1,TRUE,0,FALSE,16109,18145,-354,22.5
TRUE,TRUE,0,FALSE,16908,17271,-363,19.6,FALSE,1,TRUE,17271,17462,363,18.7
FALSE,FALSE,1,FALSE,18017,18923,2459,22.8,TRUE,1,TRUE,15558,18089,-2459,22
TRUE,TRUE,1,TRUE,15257,18061,-216,22.1,FALSE,0,FALSE,15473,17179,216,24.4
FALSE,FALSE,0,FALSE,13643,16820,-3585,21.7,TRUE,1,TRUE,17228,20225,3585,26.6
TRUE,FALSE,0,FALSE,14418,16672,-2778,20.6,TRUE,2,TRUE,17196,18846,2778,20.5
FALSE,FALSE,1,TRUE,15999,18592,-2450,24.1,TRUE,0,FALSE,18449,20431,2450,25.5
TRUE,FALSE,0,FALSE,15031,16824,-330,20.2,TRUE,1,FALSE,15361,16966,330,21.5
FALSE,FALSE,1,TRUE,16129,18567,2279,21,TRUE,0,FALSE,13850,15725,-2279,20.5
FALSE,FALSE,0,FALSE,16059,18553,-1694,21.6,TRUE,2,TRUE,17753,18554,1694,23.1
TRUE,FALSE,0,FALSE,17731,18478,709,25.6,TRUE,0,FALSE,17022,17182,-709,22.9
FALSE,FALSE,0,FALSE,15202,16607,-6871,21.9,TRUE,1,TRUE,22073,21722,6871,25.3
TRUE,FALSE,0,FALSE,15786,18637,987,24.6,TRUE,1,TRUE,14799,17384,-987,20
TRUE,TRUE,1,FALSE,16003,17277,145,21.6,FALSE,0,FALSE,15858,18139,-145,24.6
FALSE,FALSE,0,FALSE,13867,15515,-3975,20.6,TRUE,0,FALSE,17842,19747,3975,23.7
TRUE,TRUE,1,TRUE,15792,17609,683,22.8,FALSE,0,FALSE,15109,17363,-683,21
FALSE,FALSE,0,FALSE,14415,17248,-1674,21.5,TRUE,1,TRUE,16089,18020,1674,24.6
TRUE,FALSE,1,TRUE,16665,18534,1630,23.6,TRUE,0,FALSE,15035,16610,-1630,23.5
TRUE,FALSE,0,FALSE,15775,16946,-848,24.9,TRUE,1,TRUE,16623,16950,848,22.5
FALSE,TRUE,1,TRUE,16418,17454,217,23.7,FALSE,0,FALSE,16201,17382,-217,21.6
FALSE,TRUE,0,FALSE,19525,20374,3224,24.2,FALSE,0,FALSE,16301,17574,-3224,18.1
FALSE,FALSE,0,FALSE,14349,16821,-6973,15.9,TRUE,1,TRUE,21322,20526,6973,26.3
FALSE,TRUE,0,FALSE,16480,17339,-1726,22.6,FALSE,1,FALSE,18206,17276,1726,22.9
TRUE,FALSE,2,TRUE,17683,20153,1289,23.7,TRUE,0,FALSE,16394,17551,-1289,20.8
FALSE,TRUE,1,TRUE,16797,17770,-3201,20,FALSE,0,FALSE,19998,20837,3201,23.2
FALSE,TRUE,1,TRUE,14616,16844,-1313,18.3,FALSE,0,FALSE,15929,18320,1313,21.7
TRUE,TRUE,0,FALSE,18622,19365,5269,24.5,FALSE,0,FALSE,13353,15788,-5269,18.9
FALSE,FALSE,0,FALSE,14689,16679,-5354,19.5,TRUE,1,TRUE,20043,20927,5354,24.4
FALSE,FALSE,1,TRUE,17842,18236,-1949,19.4,TRUE,0,FALSE,19791,19310,1949,22.8
TRUE,FALSE,1,TRUE,14756,18676,-1318,23.7,TRUE,0,FALSE,16074,18544,1318,26.6
TRUE,FALSE,1,TRUE,18494,17736,3098,21.2,TRUE,0,FALSE,15396,15051,-3098,18.8
FALSE,FALSE,1,TRUE,13870,15601,-2809,20.2,TRUE,0,FALSE,16679,17624,2809,22.1
FALSE,FALSE,1,TRUE,14409,17030,-108,21.2,TRUE,1,FALSE,14517,17944,108,20
FALSE,FALSE,0,FALSE,15543,17304,-3318,19.7,TRUE,2,TRUE,18861,20283,3318,22.8
FALSE,FALSE,0,FALSE,15740,15862,-4093,17.7,TRUE,1,TRUE,19833,18706,4093,20.8
TRUE,TRUE,0,FALSE,15691,17738,-854,19,FALSE,2,TRUE,16545,18807,854,22.7
TRUE,TRUE,1,FALSE,15314,17245,-1891,20.7,FALSE,0,FALSE,17205,18456,1891,22.6
TRUE,TRUE,0,FALSE,20030,18878,5872,20.5,FALSE,0,FALSE,14158,14423,-5872,17.1
TRUE,TRUE,1,TRUE,18121,19941,3713,25.7,FALSE,1,FALSE,14408,16918,-3713,24.1
TRUE,TRUE,2,TRUE,18625,18897,3149,22.3,FALSE,0,FALSE,15476,16772,-3149,22.7
TRUE,TRUE,0,FALSE,18152,19147,4263,23.3,FALSE,1,FALSE,13889,16194,-4263,20.4
TRUE,TRUE,0,FALSE,17350,18363,2896,23.3,FALSE,0,FALSE,14454,16384,-2896,19.9
TRUE,TRUE,1,TRUE,16363,18353,2216,21.8,FALSE,0,FALSE,14147,17042,-2216,21.1
TRUE,TRUE,1,TRUE,16104,17424,530,17.5,FALSE,0,FALSE,15574,17197,-530,22.7
TRUE,TRUE,1,TRUE,15401,16508,-729,19.5,FALSE,0,FALSE,16130,17397,729,19.1
TRUE,FALSE,1,TRUE,19331,20193,5885,25.4,TRUE,0,FALSE,13446,15541,-5885,16.9
FALSE,TRUE,1,TRUE,17537,19736,2607,19.6,FALSE,0,FALSE,14930,17874,-2607,18.3
FALSE,TRUE,0,FALSE,18379,19031,1952,20.3,FALSE,1,TRUE,16427,17489,-1952,19.6
FALSE,FALSE,0,FALSE,14857,16453,-1726,21,TRUE,1,TRUE,16583,18343,1726,20.3
TRUE,TRUE,0,FALSE,17520,18523,996,22,FALSE,1,TRUE,16524,18407,-996,22.1
FALSE,FALSE,0,FALSE,14837,17437,-4715,20.9,TRUE,2,TRUE,19552,19128,4715,23.9
FALSE,FALSE,0,FALSE,16930,18587,928,23.7,TRUE,1,TRUE,16002,19220,-928,24.1
FALSE,FALSE,0,FALSE,16332,17067,-1514,19.6,TRUE,1,TRUE,17846,17960,1514,21.1
FALSE,FALSE,0,FALSE,15807,18325,-281,23.1,TRUE,0,FALSE,16088,17828,281,23
TRUE,FALSE,1,TRUE,18720,18913,-438,22.2,TRUE,0,FALSE,19158,19582,438,18.6
FALSE,FALSE,0,FALSE,14215,17252,-579,22.8,TRUE,1,TRUE,14794,17631,579,23.3
TRUE,TRUE,0,FALSE,19124,20438,3579,24.4,FALSE,1,TRUE,15545,17759,-3579,19.1
FALSE,FALSE,0,FALSE,14352,17455,-1241,22.2,TRUE,1,FALSE,15593,18500,1241,23.2
TRUE,FALSE,0,FALSE,16784,18136,727,25.2,TRUE,0,FALSE,16057,18702,-727,22.1
TRUE,TRUE,1,TRUE,16328,17945,-972,24.1,FALSE,0,FALSE,17300,19759,972,23.3
FALSE,FALSE,0,FALSE,15318,18578,-1086,20,TRUE,2,TRUE,16404,17932,1086,19.4
TRUE,TRUE,0,FALSE,14896,17240,-2200,20.7,FALSE,2,TRUE,17096,19173,2200,23.5
TRUE,TRUE,1,TRUE,15667,17128,481,20.2,FALSE,0,FALSE,15186,17387,-481,21.9
TRUE,TRUE,1,TRUE,21908,20909,4612,22.7,FALSE,0,FALSE,17296,18032,-4612,19.5
FALSE,TRUE,1,FALSE,16372,17570,1506,23.4,FALSE,1,TRUE,14866,17835,-1506,20
TRUE,TRUE,1,TRUE,15993,16122,2090,18.8,FALSE,0,FALSE,13903,15654,-2090,20.9
FALSE,FALSE,0,FALSE,14469,15329,-2579,13.6,TRUE,1,FALSE,17048,19148,2579,24.4
TRUE,TRUE,1,TRUE,16956,18750,1723,25.9,FALSE,1,FALSE,15233,18010,-1723,26.2
FALSE,TRUE,1,FALSE,16699,18064,559,21.2,FALSE,1,TRUE,16140,18009,-559,19.4
FALSE,FALSE,0,FALSE,14868,16222,-3346,23.7,TRUE,2,TRUE,18214,19375,3346,22.9
FALSE,TRUE,2,TRUE,18281,17856,785,21.8,FALSE,0,FALSE,17496,17044,-785,18.4
FALSE,FALSE,0,FALSE,15144,18640,-439,21.4,TRUE,2,TRUE,15583,17865,439,24.1
FALSE,FALSE,0,FALSE,14135,15854,-4416,18.2,TRUE,1,TRUE,18551,19040,4416,23.1
FALSE,TRUE,0,FALSE,13808,15418,-4523,16.9,FALSE,1,TRUE,18331,19147,4523,21.9
FALSE,FALSE,1,TRUE,15137,15969,-3447,20.6,TRUE,1,FALSE,18584,19293,3447,26.2
TRUE,TRUE,1,TRUE,17247,18201,2145,22.3,FALSE,0,FALSE,15102,17331,-2145,23.1
FALSE,FALSE,0,FALSE,16485,18714,577,24.7,TRUE,1,TRUE,15908,17213,-577,23.6
FALSE,TRUE,1,FALSE,16867,16680,-1883,20.9,FALSE,1,TRUE,18750,17553,1883,22.6
FALSE,FALSE,0,FALSE,14272,15106,-3608,19.4,TRUE,0,FALSE,17880,19394,3608,25.9
FALSE,FALSE,0,FALSE,14282,16446,-4690,18.2,TRUE,1,TRUE,18972,19875,4690,23.5
TRUE,TRUE,0,FALSE,16352,17852,1705,22,FALSE,1,TRUE,14647,17675,-1705,20.2
FALSE,TRUE,0,FALSE,17862,19955,2417,24.2,FALSE,1,TRUE,15445,17854,-2417,20.3
FALSE,TRUE,2,TRUE,16431,17901,617,20.4,FALSE,0,FALSE,15814,17035,-617,23.6
TRUE,TRUE,0,FALSE,17114,19292,2861,25.3,FALSE,1,TRUE,14253,17005,-2861,24.8
TRUE,FALSE,2,TRUE,19003,16349,503,22.6,TRUE,0,FALSE,18500,16571,-503,20.9
FALSE,TRUE,0,FALSE,15451,16217,-1679,18.8,FALSE,2,TRUE,17130,17786,1679,18.8
FALSE,TRUE,1,TRUE,17941,18842,2361,20.5,FALSE,0,FALSE,15580,18072,-2361,24.9
TRUE,TRUE,1,TRUE,19537,20680,4932,24.6,FALSE,0,FALSE,14605,16757,-4932,21.2
TRUE,TRUE,0,FALSE,16863,17496,1310,23.2,FALSE,1,TRUE,15553,17591,-1310,22.7
FALSE,TRUE,1,TRUE,15315,17328,-2314,21.3,FALSE,0,FALSE,17629,19788,2314,23.7
TRUE,FALSE,1,TRUE,15853,17700,-153,20.4,TRUE,0,FALSE,16006,18662,153,24.1
FALSE,TRUE,0,FALSE,14072,16596,-2186,20.7,FALSE,1,TRUE,16258,17689,2186,21
FALSE,FALSE,0,FALSE,17030,16983,-1567,17.6,TRUE,0,FALSE,18597,15107,1567,17.1
FALSE,TRUE,0,FALSE,15617,17606,-2139,19.4,FALSE,1,TRUE,17756,19450,2139,20
TRUE,TRUE,1,TRUE,15634,17475,487,21.3,FALSE,1,FALSE,15147,18093,-487,24.2
TRUE,FALSE,1,FALSE,15493,17405,-860,21.1,TRUE,1,TRUE,16353,17526,860,20.2
FALSE,FALSE,1,TRUE,15959,18751,786,24.4,TRUE,0,FALSE,15173,17596,-786,23.8
FALSE,TRUE,0,FALSE,15945,17784,-1757,22.9,FALSE,2,TRUE,17702,19640,1757,20.9
TRUE,FALSE,0,FALSE,17389,18770,-1067,21.8,TRUE,1,TRUE,18456,19293,1067,23.4
TRUE,TRUE,1,TRUE,17961,19152,3354,20.5,FALSE,0,FALSE,14607,16392,-3354,20.6
FALSE,FALSE,0,FALSE,15744,20593,419,23.4,TRUE,1,TRUE,15325,18803,-419,26.3
FALSE,FALSE,1,TRUE,16657,18425,1131,23.1,TRUE,0,FALSE,15526,16907,-1131,23.3
FALSE,TRUE,1,TRUE,15951,19210,1151,24.7,FALSE,1,FALSE,14800,17457,-1151,23.6
TRUE,FALSE,0,FALSE,15956,17011,-1206,19.1,TRUE,1,TRUE,17162,17974,1206,24.3
FALSE,FALSE,0,FALSE,16184,17808,-1620,23.9,TRUE,0,FALSE,17804,18528,1620,21.8
TRUE,FALSE,0,FALSE,17518,19434,731,21.2,TRUE,1,TRUE,16787,17807,-731,19.2
TRUE,TRUE,0,FALSE,16992,17775,1182,22.7,FALSE,0,FALSE,15810,17355,-1182,20.3
FALSE,FALSE,0,FALSE,14317,17076,-2155,22.4,TRUE,1,FALSE,16472,18427,2155,23.9
TRUE,TRUE,0,FALSE,14935,17972,-792,22,FALSE,0,FALSE,15727,17981,792,22.1
FALSE,TRUE,0,FALSE,14736,16670,-635,23.5,FALSE,0,FALSE,15371,17845,635,23.5
TRUE,TRUE,1,TRUE,18444,18580,3711,22,FALSE,0,FALSE,14733,16286,-3711,23.4
TRUE,TRUE,1,TRUE,17089,18072,2387,23.2,FALSE,0,FALSE,14702,16382,-2387,19.1
TRUE,TRUE,0,FALSE,20036,19646,4060,17.8,FALSE,0,FALSE,15976,16027,-4060,19.2
TRUE,TRUE,1,FALSE,18976,19176,4910,25.9,FALSE,1,TRUE,14066,16603,-4910,22.4
TRUE,TRUE,1,TRUE,15257,16719,-686,23.7,FALSE,0,FALSE,15943,17353,686,20.8
FALSE,TRUE,0,FALSE,16510,17844,1066,23.9,FALSE,0,FALSE,15444,17316,-1066,23.1
TRUE,TRUE,0,FALSE,17754,18653,3880,23.9,FALSE,0,FALSE,13874,15869,-3880,20.4
TRUE,FALSE,0,FALSE,16339,17799,297,20.5,TRUE,0,FALSE,16042,16516,-297,22.5
TRUE,FALSE,0,FALSE,17309,17384,334,23.1,TRUE,1,TRUE,16975,17686,-334,19.1
TRUE,TRUE,1,TRUE,15712,17676,267,21.6,FALSE,0,FALSE,15445,16931,-267,20.3
FALSE,FALSE,1,FALSE,16008,18460,178,21,TRUE,0,FALSE,15830,16961,-178,22.7
TRUE,FALSE,0,FALSE,13772,16974,-845,23.1,TRUE,1,TRUE,14617,17545,845,19.7
FALSE,FALSE,0,FALSE,14301,17009,-2482,17.3,TRUE,1,TRUE,16783,18585,2482,23
FALSE,TRUE,1,FALSE,16682,18002,-1370,18,FALSE,1,TRUE,18052,19271,1370,22.1
TRUE,TRUE,1,TRUE,14849,17502,-3736,22.1,FALSE,1,FALSE,18585,19534,3736,23.2
FALSE,FALSE,0,FALSE,17807,19554,1233,22.9,TRUE,2,TRUE,16574,19218,-1233,19.7
TRUE,TRUE,2,TRUE,18866,20876,3650,21.4,FALSE,0,FALSE,15216,16970,-3650,21.9
FALSE,TRUE,1,TRUE,17828,17917,1767,21.8,FALSE,0,FALSE,16061,17208,-1767,20.2
TRUE,TRUE,1,TRUE,16470,17655,632,21.6,FALSE,0,FALSE,15838,18902,-632,23
FALSE,FALSE,0,FALSE,16865,19606,147,21.2,TRUE,1,TRUE,16718,18473,-147,20.9
FALSE,TRUE,0,FALSE,15353,17812,-2332,18.9,FALSE,0,FALSE,17685,20483,2332,21.7
FALSE,FALSE,0,FALSE,14247,16785,-1179,21.6,TRUE,0,FALSE,15426,17342,1179,19.4
TRUE,TRUE,0,FALSE,18278,17024,2352,19.1,FALSE,0,FALSE,15926,16317,-2352,18.9
FALSE,FALSE,0,FALSE,16068,18240,-932,20.9,TRUE,2,TRUE,17000,18757,932,24
TRUE,TRUE,1,TRUE,15966,17893,1361,23.1,FALSE,0,FALSE,14605,16829,-1361,20.8
TRUE,FALSE,0,FALSE,17860,17673,-268,18.2,TRUE,0,FALSE,18128,17266,268,19.9
FALSE,FALSE,0,FALSE,17517,18612,124,22.8,TRUE,2,TRUE,17393,20138,-124,23.5
FALSE,TRUE,0,FALSE,15815,17429,-721,22.4,FALSE,1,TRUE,16536,18547,721,24.1
FALSE,FALSE,1,TRUE,16519,18850,-1464,20.3,TRUE,0,FALSE,17983,18519,1464,24
TRUE,TRUE,1,FALSE,16977,17852,1753,20.1,FALSE,1,TRUE,15224,17005,-1753,18.6
FALSE,FALSE,0,FALSE,14769,16504,-4374,20.5,TRUE,0,FALSE,19143,19074,4374,20.9
FALSE,TRUE,0,FALSE,17221,18291,194,22.9,FALSE,1,TRUE,17027,17085,-194,21.3
TRUE,TRUE,0,FALSE,18152,18364,-973,19.6,FALSE,0,FALSE,19125,20760,973,23.8
TRUE,FALSE,0,FALSE,17118,19705,1550,22.4,TRUE,1,TRUE,15568,16419,-1550,18.2
TRUE,FALSE,1,TRUE,16923,18443,2504,19.5,TRUE,0,FALSE,14419,15619,-2504,19.9
FALSE,TRUE,0,FALSE,17698,18605,-373,21.8,FALSE,1,TRUE,18071,20131,373,23.3
FALSE,FALSE,0,FALSE,13889,16133,-4479,20,TRUE,0,FALSE,18368,18829,4479,23.9
FALSE,FALSE,0,FALSE,15218,17342,-2789,22.7,TRUE,1,TRUE,18007,18853,2789,24.8
FALSE,TRUE,1,TRUE,15876,18504,525,22.8,FALSE,0,FALSE,15351,18210,-525,22.7
FALSE,FALSE,1,TRUE,14476,16263,-4094,20.1,TRUE,0,FALSE,18570,19583,4094,25.2
TRUE,TRUE,1,FALSE,18730,20389,5229,23.2,FALSE,1,TRUE,13501,15253,-5229,18.1
FALSE,TRUE,0,FALSE,14788,17212,-516,21.2,FALSE,1,TRUE,15304,17325,516,21.2
TRUE,TRUE,1,FALSE,17257,17553,-429,18.9,FALSE,1,TRUE,17686,18251,429,22.3
FALSE,FALSE,1,TRUE,16755,18760,695,26.3,TRUE,0,FALSE,16060,17074,-695,22.5
FALSE,FALSE,0,FALSE,17160,18631,750,24,TRUE,0,FALSE,16410,17327,-750,23
TRUE,FALSE,1,FALSE,17949,17918,1076,23.4,TRUE,0,FALSE,16873,18763,-1076,21.4
FALSE,FALSE,0,FALSE,15585,17639,-3559,22.4,TRUE,0,FALSE,19144,18958,3559,21.6
TRUE,FALSE,1,TRUE,18055,17444,3332,21.2,TRUE,0,FALSE,14723,14533,-3332,18.6
FALSE,TRUE,0,FALSE,17406,18922,1104,24,FALSE,1,TRUE,16302,18739,-1104,20.7
FALSE,FALSE,0,FALSE,18633,18367,-1428,24.6,TRUE,2,TRUE,20061,18800,1428,22.3
TRUE,FALSE,0,FALSE,17564,18892,1156,23.2,TRUE,0,FALSE,16408,17976,-1156,21.1
FALSE,TRUE,0,FALSE,17944,18559,1319,25.5,FALSE,1,TRUE,16625,18518,-1319,23.4
FALSE,FALSE,0,FALSE,15888,18305,-1157,23.9,TRUE,1,FALSE,17045,18356,1157,21.6
FALSE,FALSE,1,TRUE,16650,18077,-1968,19.9,TRUE,0,FALSE,18618,18546,1968,22.4
FALSE,TRUE,0,FALSE,17892,18021,479,19,FALSE,0,FALSE,17413,17969,-479,22.1
TRUE,TRUE,0,FALSE,15708,17721,-564,22.6,FALSE,1,TRUE,16272,19583,564,24.3
TRUE,TRUE,0,FALSE,19324,19019,3110,22.6,FALSE,1,TRUE,16214,17478,-3110,20.6
FALSE,TRUE,0,FALSE,16425,16635,-964,20.7,FALSE,0,FALSE,17389,18074,964,18.9
FALSE,TRUE,1,FALSE,16993,18944,1140,24.1,FALSE,1,TRUE,15853,19475,-1140,23.1
FALSE,FALSE,0,FALSE,14752,17935,-2181,22.8,TRUE,1,TRUE,16933,19228,2181,25.2
FALSE,FALSE,0,FALSE,14675,17184,-3911,20.7,TRUE,2,TRUE,18586,19912,3911,25.4
TRUE,TRUE,0,FALSE,16907,18072,1697,16.5,FALSE,1,TRUE,15210,17947,-1697,24.2
FALSE,FALSE,0,FALSE,14384,17020,-6124,23.7,TRUE,1,TRUE,20508,21063,6124,25.2
FALSE,FALSE,0,FALSE,16060,17844,-1603,21.3,TRUE,1,TRUE,17663,18978,1603,22.7
FALSE,TRUE,0,FALSE,15484,18326,-930,23.2,FALSE,1,TRUE,16414,18141,930,24.9
FALSE,FALSE,0,FALSE,15064,14203,-5181,14.1,TRUE,2,TRUE,20245,19275,5181,24
TRUE,TRUE,0,FALSE,18775,18390,2666,23,FALSE,1,FALSE,16109,17990,-2666,21.5
TRUE,TRUE,2,TRUE,17665,19907,4520,25.8,FALSE,0,FALSE,13145,14177,-4520,21
TRUE,TRUE,0,FALSE,17379,20465,1524,26.5,FALSE,1,TRUE,15855,18394,-1524,26.8
FALSE,TRUE,1,FALSE,16266,17958,-622,22.4,FALSE,1,TRUE,16888,19236,622,23.1
FALSE,FALSE,0,FALSE,16260,17081,-2025,19.7,TRUE,1,FALSE,18285,18855,2025,19.3
FALSE,FALSE,0,FALSE,14313,16259,-2276,21.2,TRUE,1,TRUE,16589,18451,2276,21.7
TRUE,FALSE,0,FALSE,15397,17958,908,24.7,TRUE,2,TRUE,14489,18037,-908,22.1
TRUE,TRUE,0,FALSE,16275,17390,1606,22.4,FALSE,0,FALSE,14669,16775,-1606,20.8
FALSE,TRUE,0,FALSE,18026,17839,726,19.8,FALSE,0,FALSE,17300,18294,-726,18.6
FALSE,TRUE,0,FALSE,13415,16177,-5048,21.5,FALSE,1,TRUE,18463,20408,5048,26.4
FALSE,FALSE,1,TRUE,16635,17795,544,21.5,TRUE,0,FALSE,16091,17037,-544,19.4
FALSE,FALSE,0,FALSE,14114,17618,-1313,22.9,TRUE,2,TRUE,15427,17624,1313,25
FALSE,FALSE,2,TRUE,15975,17545,-33,22.2,TRUE,0,FALSE,16008,18104,33,21.4
FALSE,FALSE,0,FALSE,14606,16104,-4405,17.3,TRUE,1,TRUE,19011,19408,4405,19.3
TRUE,FALSE,1,TRUE,19134,20399,3440,22.7,TRUE,0,FALSE,15694,18200,-3440,20.9
FALSE,TRUE,0,FALSE,15209,17965,-325,20.1,FALSE,0,FALSE,15534,17956,325,24.6
TRUE,TRUE,1,FALSE,16512,18547,-1314,20.7,FALSE,1,TRUE,17826,19574,1314,24.6
FALSE,FALSE,1,FALSE,15707,16687,-1724,22.5,TRUE,1,TRUE,17431,18202,1724,20.2
TRUE,FALSE,1,TRUE,17886,19530,3854,22.4,TRUE,0,FALSE,14032,16544,-3854,19.3
TRUE,TRUE,1,TRUE,15620,17974,234,22.5,FALSE,0,FALSE,15386,18292,-234,22.7
FALSE,TRUE,1,TRUE,16275,17526,-4202,19.9,FALSE,0,FALSE,20477,21372,4202,24.8
TRUE,FALSE,1,FALSE,17308,16585,832,20.9,TRUE,1,TRUE,16476,17089,-832,18.3
FALSE,FALSE,0,FALSE,13875,16214,-1207,21.2,TRUE,0,FALSE,15082,17756,1207,22.7
TRUE,FALSE,1,TRUE,20721,18605,4453,24.7,TRUE,0,FALSE,16268,17309,-4453,20.6
TRUE,TRUE,1,TRUE,16955,17434,1306,19.1,FALSE,0,FALSE,15649,16395,-1306,20
FALSE,TRUE,0,FALSE,16099,17169,-1063,20,FALSE,1,TRUE,17162,18196,1063,21.5
TRUE,TRUE,1,FALSE,19569,19298,5148,20.3,FALSE,1,TRUE,14421,16990,-5148,17.9
TRUE,TRUE,1,TRUE,20932,19304,4217,23.3,FALSE,0,FALSE,16715,17920,-4217,18.8
TRUE,TRUE,2,TRUE,20983,19590,5372,22,FALSE,0,FALSE,15611,14964,-5372,15.6
FALSE,TRUE,0,FALSE,15871,17242,-752,22.4,FALSE,2,TRUE,16623,19006,752,22.8
TRUE,TRUE,0,FALSE,17938,17865,2161,21.9,FALSE,1,TRUE,15777,16134,-2161,19.5
TRUE,TRUE,2,TRUE,20685,21642,7761,27.9,FALSE,0,FALSE,12924,15824,-7761,20.1
TRUE,TRUE,1,FALSE,18045,20275,2647,22.7,FALSE,0,FALSE,15398,17071,-2647,20.3
TRUE,FALSE,2,TRUE,16985,19175,986,24.1,TRUE,0,FALSE,15999,17981,-986,26.7
TRUE,FALSE,1,FALSE,14106,15716,-2393,20,TRUE,1,TRUE,16499,16720,2393,18.6
FALSE,TRUE,1,TRUE,15474,17407,-347,20.3,FALSE,0,FALSE,15821,18541,347,22.4
TRUE,FALSE,1,FALSE,16434,18330,-435,23.5,TRUE,1,TRUE,16869,17756,435,27
FALSE,FALSE,2,TRUE,14885,17810,-4790,19.2,TRUE,0,FALSE,19675,19936,4790,23.2
TRUE,TRUE,1,TRUE,19527,20653,5525,23.7,FALSE,0,FALSE,14002,17186,-5525,21.1
FALSE,FALSE,0,FALSE,16685,17126,17,22.3,TRUE,1,TRUE,16668,18306,-17,17.5
FALSE,FALSE,1,FALSE,19868,19587,2782,20.1,TRUE,1,TRUE,17086,15039,-2782,15.7
FALSE,FALSE,0,FALSE,16017,17022,-58,18.2,TRUE,1,TRUE,16075,17009,58,22.8
FALSE,FALSE,0,FALSE,13557,16944,-2637,21.3,TRUE,1,TRUE,16194,18822,2637,24.8
TRUE,TRUE,1,FALSE,17779,20127,3206,26.8,FALSE,0,FALSE,14573,17866,-3206,22.5
TRUE,FALSE,1,TRUE,19133,19406,4531,20,TRUE,0,FALSE,14602,16428,-4531,21.1
FALSE,TRUE,1,TRUE,14304,15110,-2083,19.9,FALSE,0,FALSE,16387,17659,2083,23.6
TRUE,FALSE,0,FALSE,14339,17922,-1327,23.4,TRUE,1,TRUE,15666,18747,1327,24.1
TRUE,TRUE,1,TRUE,17101,16986,359,19.4,FALSE,0,FALSE,16742,18700,-359,19.7
TRUE,TRUE,1,FALSE,14731,16242,-2272,22.3,FALSE,1,TRUE,17003,19024,2272,22
TRUE,TRUE,1,TRUE,17766,18700,-680,22.9,FALSE,0,FALSE,18446,19403,680,24.3
FALSE,TRUE,1,TRUE,16747,18330,482,20.2,FALSE,0,FALSE,16265,19000,-482,22.5
FALSE,TRUE,2,TRUE,16074,16408,-3268,18.5,FALSE,0,FALSE,19342,20865,3268,20.6
TRUE,TRUE,1,TRUE,17488,18635,1902,22,FALSE,0,FALSE,15586,17668,-1902,19.3
FALSE,FALSE,0,FALSE,12698,15550,-3784,19.5,TRUE,1,TRUE,16482,19569,3784,22.2
TRUE,FALSE,0,FALSE,17264,19660,2474,23,TRUE,0,FALSE,14790,17166,-2474,23
FALSE,TRUE,0,FALSE,14516,17011,-3678,21.8,FALSE,1,TRUE,18194,20245,3678,24.6
FALSE,TRUE,0,FALSE,17666,19438,2537,24.1,FALSE,1,TRUE,15129,17605,-2537,23.4
TRUE,TRUE,1,TRUE,16521,17693,1490,20.3,FALSE,0,FALSE,15031,16232,-1490,21.6
FALSE,FALSE,1,TRUE,15880,17975,-3840,19.9,TRUE,1,FALSE,19720,20810,3840,23.9
TRUE,TRUE,1,TRUE,17020,17178,1377,18.5,FALSE,0,FALSE,15643,17851,-1377,23.2
TRUE,TRUE,1,TRUE,18021,19353,4957,24.6,FALSE,0,FALSE,13064,14913,-4957,18.2
FALSE,FALSE,0,FALSE,16334,18034,-1337,24.5,TRUE,2,TRUE,17671,19140,1337,24.5
TRUE,FALSE,0,FALSE,13979,16912,-2871,20.3,TRUE,1,TRUE,16850,19339,2871,24.3
FALSE,FALSE,0,FALSE,15006,18694,-1271,23,TRUE,0,FALSE,16277,19060,1271,26.4
TRUE,FALSE,0,FALSE,15696,18895,-1163,24.3,TRUE,1,FALSE,16859,18914,1163,24.6
FALSE,TRUE,0,FALSE,15946,16836,-833,17,FALSE,1,FALSE,16779,17768,833,23
FALSE,FALSE,0,FALSE,15548,17564,-2686,21.5,TRUE,1,TRUE,18234,19601,2686,21.2
TRUE,TRUE,1,TRUE,15942,19003,486,23.2,FALSE,0,FALSE,15456,18138,-486,24.2
TRUE,TRUE,0,FALSE,15727,18760,1441,26.4,FALSE,0,FALSE,14286,18287,-1441,21.1
FALSE,FALSE,0,FALSE,16772,16548,192,22.8,TRUE,2,TRUE,16580,18044,-192,23.4
FALSE,FALSE,1,FALSE,17820,20320,3462,23.4,TRUE,1,TRUE,14358,17360,-3462,20.5
FALSE,TRUE,0,FALSE,16440,17567,-892,23.8,FALSE,1,TRUE,17332,17822,892,20.6
TRUE,TRUE,2,TRUE,19890,18304,3290,21.4,FALSE,0,FALSE,16600,16906,-3290,21.4
TRUE,FALSE,0,FALSE,15936,18595,254,23.4,TRUE,1,TRUE,15682,18455,-254,20.5
FALSE,FALSE,0,FALSE,16065,17606,-1823,19.3,TRUE,1,TRUE,17888,19755,1823,23.4
TRUE,TRUE,1,FALSE,16385,17307,962,21.5,FALSE,1,TRUE,15423,18953,-962,26.1
FALSE,TRUE,1,TRUE,15315,17144,-2478,21,FALSE,0,FALSE,17793,19280,2478,23.1
TRUE,FALSE,0,FALSE,15610,19049,-99,24.6,TRUE,0,FALSE,15709,18322,99,23.4
TRUE,TRUE,0,FALSE,14650,16684,-2003,19.2,FALSE,0,FALSE,16653,18295,2003,19.5
FALSE,TRUE,1,FALSE,16209,18146,316,25.4,FALSE,1,TRUE,15893,18743,-316,23.7
FALSE,TRUE,0,FALSE,16254,17374,-908,20,FALSE,0,FALSE,17162,19180,908,22.7
FALSE,FALSE,0,FALSE,15881,17927,-1943,21.4,TRUE,1,TRUE,17824,19509,1943,21.6
TRUE,FALSE,0,FALSE,17554,16706,-1548,22.7,TRUE,2,TRUE,19102,18694,1548,22.5
FALSE,FALSE,0,FALSE,14329,16330,-1966,21.1,TRUE,1,TRUE,16295,19921,1966,21.7
TRUE,FALSE,1,TRUE,15712,17969,-169,22.1,TRUE,0,FALSE,15881,17687,169,23.5
FALSE,FALSE,0,FALSE,16121,16956,-1587,16.9,TRUE,1,TRUE,17708,18534,1587,22.1
FALSE,FALSE,1,TRUE,14471,17810,-355,24.1,TRUE,0,FALSE,14826,18210,355,23.2
TRUE,TRUE,0,FALSE,14797,16703,-1576,19.5,FALSE,1,TRUE,16373,18423,1576,25.9
FALSE,TRUE,0,FALSE,15692,16690,482,20.6,FALSE,1,FALSE,15210,18743,-482,23.5
TRUE,TRUE,1,TRUE,18271,19689,938,22.3,FALSE,1,FALSE,17333,19508,-938,20.4
FALSE,FALSE,0,FALSE,14928,18640,-360,22.9,TRUE,1,TRUE,15288,18309,360,21.3
TRUE,TRUE,0,FALSE,15835,17352,-1973,21.7,FALSE,0,FALSE,17808,18849,1973,23.6
TRUE,TRUE,1,FALSE,19598,18704,4864,24.2,FALSE,0,FALSE,14734,16766,-4864,20.4
TRUE,FALSE,1,TRUE,16664,18875,2543,24.4,TRUE,0,FALSE,14121,17910,-2543,20.4
TRUE,TRUE,1,FALSE,15826,17062,-2296,19.6,FALSE,1,TRUE,18122,18739,2296,24.3
FALSE,TRUE,0,FALSE,16517,18263,954,21.6,FALSE,1,TRUE,15563,17693,-954,21.6
FALSE,FALSE,1,FALSE,16888,18334,1063,22.5,TRUE,1,TRUE,15825,18725,-1063,23.1
TRUE,TRUE,1,TRUE,21872,19671,7404,22.5,FALSE,0,FALSE,14468,14515,-7404,16.9
TRUE,TRUE,1,TRUE,17828,19155,3642,24.2,FALSE,0,FALSE,14186,15305,-3642,17.9
TRUE,TRUE,0,FALSE,16535,17913,-847,19.9,FALSE,1,TRUE,17382,17902,847,22.7
TRUE,FALSE,0,FALSE,16194,17871,376,23.8,TRUE,2,TRUE,15818,18065,-376,21.5
FALSE,TRUE,2,TRUE,15304,17175,-1469,19.5,FALSE,0,FALSE,16773,17059,1469,23.8
FALSE,TRUE,1,FALSE,14931,17257,1295,21.5,FALSE,1,TRUE,13636,17337,-1295,23
FALSE,FALSE,0,FALSE,15175,16256,-1243,17,TRUE,1,TRUE,16418,17485,1243,21.9
TRUE,FALSE,1,TRUE,15089,17882,-3426,21.9,TRUE,0,FALSE,18515,20636,3426,22.7
TRUE,TRUE,0,FALSE,19057,19088,2455,23.6,FALSE,0,FALSE,16602,17148,-2455,22.6
TRUE,FALSE,0,FALSE,17198,19868,1926,23.3,TRUE,0,FALSE,15272,17749,-1926,21.9
FALSE,FALSE,1,TRUE,14206,17591,-2865,21,TRUE,0,FALSE,17071,19457,2865,24.8
FALSE,TRUE,1,TRUE,15303,16803,-1154,20.9,FALSE,0,FALSE,16457,18432,1154,20.7
TRUE,FALSE,0,FALSE,15257,16021,-1860,19.1,TRUE,1,TRUE,17117,16741,1860,21.1
TRUE,TRUE,1,TRUE,17643,17308,2331,22.6,FALSE,0,FALSE,15312,17283,-2331,19.3
TRUE,FALSE,0,FALSE,14649,17790,-444,22.9,TRUE,1,FALSE,15093,18667,444,24.7
FALSE,FALSE,1,TRUE,15101,16888,-3014,18.7,TRUE,0,FALSE,18115,17245,3014,25.2
TRUE,TRUE,0,FALSE,18288,18800,4377,22.3,FALSE,0,FALSE,13911,17081,-4377,22
TRUE,TRUE,0,FALSE,17357,20069,2030,23.6,FALSE,0,FALSE,15327,18658,-2030,25.2
TRUE,FALSE,0,FALSE,16101,19176,884,26.6,TRUE,1,TRUE,15217,18148,-884,23.6
FALSE,FALSE,0,FALSE,16864,18758,-1406,21.9,TRUE,0,FALSE,18270,19764,1406,19.5
FALSE,FALSE,0,FALSE,14470,15760,-4259,17.5,TRUE,1,TRUE,18729,20022,4259,24.6
TRUE,TRUE,1,TRUE,18027,19090,3909,25.2,FALSE,0,FALSE,14118,17152,-3909,21.9
TRUE,TRUE,1,TRUE,18920,19580,2339,23.8,FALSE,0,FALSE,16581,18955,-2339,22
FALSE,FALSE,1,FALSE,15521,16916,-1187,20.2,TRUE,1,TRUE,16708,17630,1187,21.9
TRUE,TRUE,0,FALSE,15579,16638,-1314,19.8,FALSE,1,TRUE,16893,17204,1314,21.5
TRUE,TRUE,0,FALSE,18602,20068,123,20,FALSE,1,FALSE,18479,18755,-123,22.6
FALSE,FALSE,0,FALSE,15325,16317,-2964,19.2,TRUE,2,TRUE,18289,18904,2964,20.8
FALSE,FALSE,0,FALSE,15161,16945,-7089,19.6,TRUE,0,FALSE,22250,19760,7089,23.7
FALSE,TRUE,0,FALSE,17818,19558,2534,23.8,FALSE,0,FALSE,15284,17828,-2534,22.3
FALSE,FALSE,0,FALSE,14066,16007,-6966,17.8,TRUE,1,FALSE,21032,20730,6966,24.6
FALSE,FALSE,0,FALSE,16143,17759,-3283,21.2,TRUE,0,FALSE,19426,18341,3283,19.4
FALSE,TRUE,0,FALSE,15431,17705,-3460,21.4,FALSE,1,TRUE,18891,20094,3460,23.3
FALSE,TRUE,1,FALSE,16815,18326,10,20.7,FALSE,0,FALSE,16805,18103,-10,24.1
TRUE,FALSE,1,FALSE,17060,19600,2207,24.2,TRUE,1,TRUE,14853,16764,-2207,21.9
FALSE,FALSE,0,FALSE,15341,17802,-2310,20.4,TRUE,1,TRUE,17651,19406,2310,22
FALSE,TRUE,2,TRUE,17012,19316,1456,23,FALSE,0,FALSE,15556,17883,-1456,22
TRUE,TRUE,1,FALSE,17805,17597,1446,21.8,FALSE,1,TRUE,16359,18948,-1446,21.2
FALSE,FALSE,0,FALSE,16425,17934,-4561,20.5,TRUE,1,TRUE,20986,19769,4561,27.1
FALSE,TRUE,1,TRUE,17804,16151,-612,16.8,FALSE,0,FALSE,18416,17170,612,17.1
FALSE,FALSE,0,FALSE,14449,16336,-1979,22,TRUE,1,TRUE,16428,16674,1979,18.6
TRUE,TRUE,0,FALSE,17687,18169,1484,20.3,FALSE,0,FALSE,16203,18193,-1484,21.6
FALSE,TRUE,0,FALSE,18471,19497,3252,22.5,FALSE,1,TRUE,15219,17193,-3252,20.1
TRUE,FALSE,1,TRUE,16245,17547,-1051,20.6,TRUE,0,FALSE,17296,16794,1051,20.6
TRUE,FALSE,1,TRUE,15054,16819,-2018,20.9,TRUE,0,FALSE,17072,18164,2018,16.9
TRUE,TRUE,0,FALSE,17216,17264,1462,20.7,FALSE,0,FALSE,15754,15974,-1462,16.5
TRUE,FALSE,0,FALSE,14997,17191,-3401,21.8,TRUE,2,TRUE,18398,19370,3401,21.9
TRUE,FALSE,0,FALSE,14804,17613,-1645,23.9,TRUE,1,TRUE,16449,18689,1645,24.5
FALSE,TRUE,1,FALSE,15645,18594,929,22.7,FALSE,1,TRUE,14716,17499,-929,20.5
FALSE,FALSE,0,FALSE,15365,17435,-2450,22.1,TRUE,0,FALSE,17815,18585,2450,23.3
FALSE,TRUE,0,FALSE,17524,16577,-293,20.9,FALSE,1,TRUE,17817,18432,293,21.1
TRUE,TRUE,0,FALSE,18324,19267,4545,19.9,FALSE,0,FALSE,13779,15553,-4545,19.5
TRUE,TRUE,2,TRUE,17140,18226,597,22.1,FALSE,0,FALSE,16543,17351,-597,22.6
TRUE,TRUE,0,FALSE,17756,18384,1975,21.1,FALSE,0,FALSE,15781,17415,-1975,21
FALSE,FALSE,1,TRUE,19094,19076,1693,19.6,TRUE,0,FALSE,17401,17789,-1693,21.4
FALSE,FALSE,1,FALSE,15963,18713,-985,21.8,TRUE,1,TRUE,16948,18806,985,26.2
TRUE,TRUE,2,TRUE,21266,19884,7427,23.1,FALSE,0,FALSE,13839,13326,-7427,12.9
TRUE,TRUE,0,FALSE,17692,18587,1018,20.3,FALSE,1,TRUE,16674,17268,-1018,20.1
FALSE,FALSE,1,TRUE,14562,15997,-1857,20.6,TRUE,0,FALSE,16419,17973,1857,21.4
FALSE,FALSE,0,FALSE,15881,16662,-3438,21.5,TRUE,1,TRUE,19319,19236,3438,22.2
FALSE,TRUE,0,FALSE,17649,17906,1579,20.7,FALSE,0,FALSE,16070,17328,-1579,20.9
FALSE,FALSE,1,TRUE,14358,16468,-3071,20.3,TRUE,1,FALSE,17429,18735,3071,24.2
FALSE,TRUE,0,FALSE,17828,18836,1042,22.9,FALSE,0,FALSE,16786,18867,-1042,23.1
TRUE,TRUE,0,FALSE,17495,19387,1871,17.8,FALSE,0,FALSE,15624,16490,-1871,22.7
FALSE,FALSE,0,FALSE,15519,18382,-546,25.6,TRUE,1,TRUE,16065,17304,546,22.7
FALSE,TRUE,0,FALSE,15365,17502,-528,25,FALSE,1,TRUE,15893,18632,528,25.9
FALSE,FALSE,0,FALSE,15582,16182,-1780,19,TRUE,1,FALSE,17362,17560,1780,22.9
FALSE,TRUE,1,TRUE,15054,16861,-387,22.3,FALSE,0,FALSE,15441,17586,387,21
FALSE,FALSE,0,FALSE,15052,16956,-2077,20.4,TRUE,1,TRUE,17129,19413,2077,24.2
FALSE,FALSE,0,FALSE,15608,16536,-1690,19.7,TRUE,0,FALSE,17298,19479,1690,22
TRUE,TRUE,2,TRUE,16578,18186,-987,22,FALSE,0,FALSE,17565,18927,987,20.6
TRUE,FALSE,0,FALSE,16361,17937,-2902,22.5,TRUE,1,TRUE,19263,19133,2902,23.1
TRUE,FALSE,0,FALSE,14709,16206,-2923,20.9,TRUE,2,TRUE,17632,17285,2923,23.2
FALSE,TRUE,1,TRUE,17457,18205,1495,22.5,FALSE,0,FALSE,15962,18618,-1495,24.8
FALSE,FALSE,0,FALSE,14179,16052,-4927,20.5,TRUE,1,TRUE,19106,20002,4927,23
TRUE,FALSE,0,FALSE,16294,18342,-18,21.4,TRUE,0,FALSE,16312,18090,18,22.9
FALSE,FALSE,0,FALSE,15392,18126,-1045,23.8,TRUE,2,TRUE,16437,17720,1045,20.5
FALSE,TRUE,1,TRUE,15534,16209,-2212,20.4,FALSE,0,FALSE,17746,17757,2212,21.5
TRUE,TRUE,0,FALSE,17462,18011,1323,21,FALSE,0,FALSE,16139,16017,-1323,21.5
FALSE,FALSE,0,FALSE,17346,19356,-220,19.7,TRUE,0,FALSE,17566,17929,220,18.6
TRUE,TRUE,0,FALSE,16248,18185,2086,23.9,FALSE,1,TRUE,14162,16788,-2086,24.1
TRUE,TRUE,0,FALSE,15218,16539,-828,21.1,FALSE,0,FALSE,16046,16118,828,20.6
TRUE,TRUE,0,FALSE,20329,20692,4227,26.4,FALSE,0,FALSE,16102,16800,-4227,17.4
FALSE,FALSE,1,TRUE,17235,17249,1177,19.6,TRUE,0,FALSE,16058,17940,-1177,23.2
FALSE,FALSE,2,TRUE,17433,17931,263,22.1,TRUE,0,FALSE,17170,17589,-263,20.6
FALSE,FALSE,0,FALSE,15480,19018,-816,24.3,TRUE,1,TRUE,16296,19045,816,27.8
TRUE,TRUE,1,TRUE,17850,19943,1097,23.8,FALSE,0,FALSE,16753,18029,-1097,22.4
TRUE,TRUE,0,FALSE,16590,19121,1057,21,FALSE,1,TRUE,15533,17826,-1057,22.7
TRUE,TRUE,2,TRUE,17706,18096,145,21.4,FALSE,0,FALSE,17561,19198,-145,22.1
TRUE,FALSE,1,FALSE,18972,19388,3559,23.1,TRUE,0,FALSE,15413,17161,-3559,18.9
FALSE,FALSE,0,FALSE,16530,18808,-1726,20.5,TRUE,1,TRUE,18256,19075,1726,23.8
TRUE,FALSE,1,TRUE,14911,18362,-626,23.8,TRUE,0,FALSE,15537,17467,626,23
TRUE,TRUE,1,TRUE,20543,20964,6529,23.3,FALSE,0,FALSE,14014,16480,-6529,16.1
TRUE,TRUE,2,TRUE,21437,20067,7370,22.9,FALSE,0,FALSE,14067,14613,-7370,13.3
TRUE,TRUE,1,TRUE,15185,18437,-419,23.1,FALSE,1,FALSE,15604,18865,419,24.1
FALSE,FALSE,0,FALSE,15275,17812,-701,21.7,TRUE,1,TRUE,15976,17466,701,21.4
TRUE,TRUE,1,TRUE,18581,17855,4279,22.9,FALSE,0,FALSE,14302,15948,-4279,23.9
TRUE,TRUE,1,TRUE,17072,18825,-164,20.5,FALSE,1,FALSE,17236,17974,164,24.4
FALSE,TRUE,1,TRUE,15758,16364,-882,19,FALSE,0,FALSE,16640,18124,882,25.3
FALSE,FALSE,0,FALSE,15144,17285,-2283,22.4,TRUE,1,TRUE,17427,19254,2283,25.9
TRUE,FALSE,1,TRUE,15742,18562,-896,24.4,TRUE,0,FALSE,16638,19854,896,25.2
FALSE,TRUE,0,FALSE,15161,16711,-3312,18.7,FALSE,1,FALSE,18473,19830,3312,22.3
FALSE,FALSE,0,FALSE,16554,18076,-505,21.6,TRUE,1,FALSE,17059,18656,505,19.3
FALSE,FALSE,1,TRUE,14384,15955,-3388,19.9,TRUE,0,FALSE,17772,18980,3388,25.6
TRUE,TRUE,0,FALSE,17183,17906,1100,20.8,FALSE,1,TRUE,16083,17736,-1100,16.6
FALSE,TRUE,0,FALSE,15165,17462,-1995,21.8,FALSE,0,FALSE,17160,18656,1995,25.1
TRUE,FALSE,0,FALSE,16747,18099,-1391,21.4,TRUE,1,TRUE,18138,18115,1391,18.9
FALSE,TRUE,0,FALSE,16625,18202,-810,22.6,FALSE,0,FALSE,17435,18932,810,23.4
FALSE,FALSE,0,FALSE,15738,16964,-1769,21.5,TRUE,1,TRUE,17507,18823,1769,18.5
FALSE,FALSE,2,TRUE,16326,18447,1165,23.2,TRUE,0,FALSE,15161,17703,-1165,23.1
FALSE,FALSE,0,FALSE,15334,18085,-2564,20.4,TRUE,0,FALSE,17898,18120,2564,22.7
FALSE,TRUE,1,FALSE,18490,16745,479,21.5,FALSE,1,TRUE,18011,17403,-479,23
FALSE,TRUE,0,FALSE,15542,16959,-2118,18.8,FALSE,1,TRUE,17660,19007,2118,23.8
FALSE,TRUE,0,FALSE,15409,17883,-729,24,FALSE,0,FALSE,16138,18783,729,25
FALSE,TRUE,0,FALSE,16205,15951,-3719,17.1,FALSE,1,TRUE,19924,19646,3719,21.6
TRUE,FALSE,1,FALSE,16836,17998,-52,22.8,TRUE,0,FALSE,16888,18299,52,18.6
TRUE,FALSE,1,TRUE,14862,18359,9,23.7,TRUE,1,FALSE,14853,18531,-9,19.9
TRUE,TRUE,1,TRUE,17971,19666,523,20.9,FALSE,0,FALSE,17448,19735,-523,23.7
TRUE,FALSE,1,TRUE,15689,18377,673,21.1,TRUE,0,FALSE,15016,16696,-673,21
TRUE,FALSE,0,FALSE,15751,17685,926,25.2,TRUE,0,FALSE,14825,17357,-926,21.5
FALSE,TRUE,0,FALSE,17535,17282,-400,20,FALSE,1,TRUE,17935,18966,400,21.1
TRUE,TRUE,0,FALSE,16419,19867,1783,27.6,FALSE,1,TRUE,14636,18447,-1783,25.7
TRUE,FALSE,0,FALSE,13757,16461,-1752,22,TRUE,0,FALSE,15509,18207,1752,23.8
TRUE,FALSE,1,TRUE,18491,19416,3517,23.7,TRUE,0,FALSE,14974,16535,-3517,21.1
TRUE,FALSE,0,FALSE,15536,17282,-680,19,TRUE,1,TRUE,16216,16872,680,21.5
TRUE,TRUE,2,TRUE,16817,19506,3021,23.7,FALSE,0,FALSE,13796,17120,-3021,21.4
TRUE,TRUE,2,TRUE,16683,18169,-73,21.3,FALSE,0,FALSE,16756,17836,73,21.3
FALSE,TRUE,1,TRUE,17161,18145,1577,20.6,FALSE,0,FALSE,15584,18195,-1577,21.4
FALSE,FALSE,0,FALSE,14815,17728,-2116,22.6,TRUE,1,FALSE,16931,19884,2116,23.7
TRUE,TRUE,0,FALSE,18180,18464,2575,19,FALSE,1,TRUE,15605,17010,-2575,20.3
FALSE,TRUE,0,FALSE,16993,19908,1886,23,FALSE,0,FALSE,15107,18220,-1886,23
FALSE,FALSE,0,FALSE,14023,15096,-4659,18.7,TRUE,1,TRUE,18682,18364,4659,22.5
TRUE,FALSE,0,FALSE,16256,17771,-862,24.7,TRUE,1,TRUE,17118,18177,862,20
FALSE,FALSE,0,FALSE,14462,15785,-360,19.7,TRUE,1,FALSE,14822,17533,360,20.9
TRUE,TRUE,2,TRUE,15825,17561,460,22.5,FALSE,0,FALSE,15365,18668,-460,21.8
TRUE,TRUE,1,TRUE,17616,18517,1790,23.5,FALSE,0,FALSE,15826,17297,-1790,23.1
TRUE,FALSE,1,TRUE,14322,17759,-1970,23.6,TRUE,1,FALSE,16292,18936,1970,22.2
TRUE,FALSE,1,FALSE,16033,17303,1073,21.1,TRUE,1,TRUE,14960,17200,-1073,22.5
TRUE,TRUE,0,FALSE,14887,16190,-1725,21.4,FALSE,1,TRUE,16612,18194,1725,24.2
TRUE,TRUE,0,FALSE,18688,18316,2936,19.9,FALSE,2,TRUE,15752,17173,-2936,20.7
TRUE,FALSE,0,FALSE,15074,17596,-2054,21.4,TRUE,2,TRUE,17128,18327,2054,21.1
FALSE,FALSE,0,FALSE,14647,17841,-2084,18.5,TRUE,2,TRUE,16731,18692,2084,25.1
TRUE,FALSE,0,FALSE,15678,18321,-394,22.1,TRUE,0,FALSE,16072,17155,394,23
FALSE,FALSE,0,FALSE,13627,15650,-3366,20.6,TRUE,1,TRUE,16993,17472,3366,20.5
TRUE,TRUE,2,TRUE,18890,19533,4237,23.6,FALSE,0,FALSE,14653,17195,-4237,22.6
TRUE,FALSE,0,FALSE,13636,16872,-3455,19,TRUE,0,FALSE,17091,19277,3455,21.7
TRUE,TRUE,0,FALSE,19339,18982,5578,19.7,FALSE,0,FALSE,13761,15535,-5578,17.9
FALSE,TRUE,0,FALSE,15473,17268,-130,21.9,FALSE,0,FALSE,15603,17691,130,22.1
FALSE,FALSE,0,FALSE,14535,16967,-2491,18.2,TRUE,1,TRUE,17026,18738,2491,24.1
FALSE,TRUE,1,FALSE,14752,17234,-2406,23.9,FALSE,1,TRUE,17158,19920,2406,21.8
TRUE,TRUE,1,TRUE,14323,16834,-2546,18.4,FALSE,1,FALSE,16869,19376,2546,24.3
FALSE,TRUE,0,FALSE,15890,15995,237,17.8,FALSE,1,TRUE,15653,17302,-237,20.2
TRUE,FALSE,0,FALSE,18028,16592,411,17.9,TRUE,2,TRUE,17617,15517,-411,17.6
TRUE,TRUE,0,FALSE,15352,15672,-1702,19.3,FALSE,1,TRUE,17054,17162,1702,19.1
TRUE,FALSE,1,TRUE,17306,18073,2170,23.7,TRUE,0,FALSE,15136,16690,-2170,21.8
FALSE,TRUE,0,FALSE,15380,17373,-2064,19.3,FALSE,0,FALSE,17444,20012,2064,24.2
FALSE,FALSE,1,TRUE,15376,16496,-733,22.5,TRUE,0,FALSE,16109,17280,733,20.1
TRUE,TRUE,1,TRUE,16815,17824,683,23.5,FALSE,1,FALSE,16132,18032,-683,17.9
TRUE,FALSE,0,FALSE,15364,18063,-946,21,TRUE,1,TRUE,16310,17433,946,22.9
FALSE,TRUE,0,FALSE,16199,18624,512,20.5,FALSE,0,FALSE,15687,17766,-512,21.8
TRUE,FALSE,0,FALSE,17539,20178,686,18.9,TRUE,0,FALSE,16853,19413,-686,20.8
FALSE,FALSE,1,FALSE,16781,17736,-1611,18,TRUE,1,TRUE,18392,19360,1611,18.8
TRUE,FALSE,0,FALSE,17819,18112,811,23.2,TRUE,0,FALSE,17008,17736,-811,22.2
TRUE,TRUE,2,TRUE,21927,20604,5263,25,FALSE,0,FALSE,16664,17391,-5263,17.4
FALSE,FALSE,0,FALSE,16621,19161,-249,23.1,TRUE,1,TRUE,16870,17741,249,20.3
TRUE,FALSE,1,TRUE,19865,18655,2819,22.5,TRUE,0,FALSE,17046,17361,-2819,21
TRUE,TRUE,0,FALSE,17208,18748,87,19.7,FALSE,0,FALSE,17121,18313,-87,22.2
FALSE,FALSE,1,TRUE,13631,16334,-3839,22,TRUE,1,FALSE,17470,19652,3839,23.3
TRUE,TRUE,0,FALSE,18588,18890,2824,22.9,FALSE,0,FALSE,15764,17544,-2824,21.4
FALSE,FALSE,1,TRUE,15173,17549,-2159,18.6,TRUE,0,FALSE,17332,18829,2159,22.7
TRUE,FALSE,0,FALSE,17188,19429,326,25,TRUE,0,FALSE,16862,18266,-326,21.9
FALSE,FALSE,0,FALSE,15511,15296,-4775,17.1,TRUE,1,TRUE,20286,19376,4775,23.7
FALSE,FALSE,0,FALSE,15642,15825,-3811,21.4,TRUE,1,TRUE,19453,18932,3811,21
FALSE,TRUE,1,TRUE,15620,18429,896,18.7,FALSE,0,FALSE,14724,17033,-896,22.7
TRUE,FALSE,0,FALSE,15577,16572,-1218,19.7,TRUE,2,TRUE,16795,18100,1218,23.9
FALSE,FALSE,0,FALSE,14689,16533,-3089,19.5,TRUE,1,TRUE,17778,18684,3089,21.9
FALSE,FALSE,0,FALSE,14758,17522,-1277,24.5,TRUE,2,TRUE,16035,18879,1277,22.3
TRUE,TRUE,1,TRUE,20028,20153,5885,22.9,FALSE,0,FALSE,14143,15459,-5885,16
TRUE,TRUE,1,FALSE,22212,19473,8977,25.7,FALSE,0,FALSE,13235,14062,-8977,16.1
TRUE,FALSE,0,FALSE,15858,17780,-1050,21.5,TRUE,0,FALSE,16908,17258,1050,21.3
FALSE,TRUE,0,FALSE,16109,19122,-1599,23.7,FALSE,2,TRUE,17708,18790,1599,24.8
TRUE,FALSE,0,FALSE,15381,18597,-758,22.2,TRUE,0,FALSE,16139,18284,758,19.4
FALSE,FALSE,0,FALSE,14680,17305,-1413,22.2,TRUE,1,FALSE,16093,18034,1413,23.4
TRUE,TRUE,2,TRUE,18504,19524,1011,22.6,FALSE,0,FALSE,17493,19044,-1011,18.7
FALSE,TRUE,0,FALSE,15911,17640,428,21.9,FALSE,1,TRUE,15483,16625,-428,23.4
TRUE,TRUE,0,FALSE,18340,18170,3206,25,FALSE,0,FALSE,15134,16733,-3206,18
TRUE,TRUE,1,TRUE,17008,18943,2135,19.7,FALSE,0,FALSE,14873,17290,-2135,20.5
FALSE,FALSE,0,FALSE,16760,18264,-1302,21.7,TRUE,1,TRUE,18062,18191,1302,19.9
TRUE,FALSE,0,FALSE,16669,19026,565,26.6,TRUE,1,TRUE,16104,18751,-565,23.8
TRUE,TRUE,0,FALSE,17771,20856,1958,21.7,FALSE,1,TRUE,15813,17716,-1958,23.9
FALSE,TRUE,0,FALSE,17773,18937,4257,23.6,FALSE,0,FALSE,13516,16035,-4257,20.4
TRUE,TRUE,1,TRUE,18217,16663,1674,19,FALSE,0,FALSE,16543,17311,-1674,19.2
TRUE,FALSE,1,TRUE,15408,17993,-928,20.9,TRUE,0,FALSE,16336,19746,928,23.7
FALSE,TRUE,0,FALSE,16360,16497,-75,21.8,FALSE,0,FALSE,16435,16353,75,20.7
FALSE,FALSE,0,FALSE,13141,16162,-4046,20.2,TRUE,1,FALSE,17187,18939,4046,21.4
FALSE,FALSE,0,FALSE,13860,16225,-4138,19.5,TRUE,1,FALSE,17998,20017,4138,22.9
FALSE,FALSE,0,FALSE,15995,17109,-3535,17.2,TRUE,1,TRUE,19530,18308,3535,22
FALSE,FALSE,0,FALSE,14442,16650,-4719,20.2,TRUE,1,TRUE,19161,18779,4719,22.5
TRUE,FALSE,2,TRUE,20125,20117,5900,22.6,TRUE,0,FALSE,14225,14929,-5900,17.9
FALSE,TRUE,1,TRUE,16542,19007,1818,22.7,FALSE,0,FALSE,14724,17015,-1818,23.4
TRUE,FALSE,0,FALSE,13943,17306,-3461,22.9,TRUE,2,TRUE,17404,18659,3461,24.4
TRUE,TRUE,1,TRUE,16836,16495,-1521,21.5,FALSE,0,FALSE,18357,18591,1521,21.5
TRUE,TRUE,1,TRUE,17631,17645,1328,19.9,FALSE,0,FALSE,16303,16602,-1328,18.8
TRUE,FALSE,0,FALSE,16765,16518,911,18.1,TRUE,1,TRUE,15854,16794,-911,18.2
TRUE,TRUE,1,FALSE,18001,19477,2111,23.3,FALSE,1,TRUE,15890,18087,-2111,22.8
TRUE,FALSE,0,FALSE,19580,18977,935,20.1,TRUE,0,FALSE,18645,16780,-935,17.9
FALSE,FALSE,0,FALSE,14774,16999,-3032,21.4,TRUE,2,TRUE,17806,19815,3032,21.5
TRUE,TRUE,1,TRUE,17525,17738,-425,20.2,FALSE,0,FALSE,17950,18795,425,26.4
TRUE,FALSE,0,FALSE,19280,19831,2365,24,TRUE,0,FALSE,16915,17779,-2365,21.1
TRUE,FALSE,1,TRUE,17929,20365,3140,23.3,TRUE,1,FALSE,14789,17001,-3140,20.1
TRUE,FALSE,0,FALSE,15988,17843,-779,21.5,TRUE,0,FALSE,16767,19680,779,23.5
TRUE,TRUE,1,TRUE,17214,18566,1690,20,FALSE,0,FALSE,15524,17250,-1690,16.2
TRUE,FALSE,2,TRUE,15897,18168,1433,18.8,TRUE,0,FALSE,14464,17646,-1433,21.5
TRUE,FALSE,1,TRUE,18539,18188,3466,25.3,TRUE,1,FALSE,15073,16663,-3466,22.2
TRUE,TRUE,2,TRUE,18132,17869,1947,21.2,FALSE,0,FALSE,16185,17733,-1947,21.9
TRUE,TRUE,2,TRUE,21382,20346,6624,24.6,FALSE,0,FALSE,14758,15481,-6624,18.5
TRUE,TRUE,1,TRUE,17011,17776,2659,19.4,FALSE,0,FALSE,14352,15019,-2659,20.1
TRUE,TRUE,1,TRUE,20206,19702,6275,22.1,FALSE,0,FALSE,13931,14913,-6275,18.7
TRUE,TRUE,2,TRUE,17673,19727,1369,20.8,FALSE,0,FALSE,16304,16971,-1369,21.6
TRUE,TRUE,1,FALSE,16983,17424,422,18.3,FALSE,1,TRUE,16561,17732,-422,20
FALSE,FALSE,0,FALSE,15139,18041,-2281,21.6,TRUE,1,TRUE,17420,18083,2281,24.4
TRUE,TRUE,2,TRUE,18132,19522,1722,23.2,FALSE,0,FALSE,16410,18008,-1722,21.1
FALSE,FALSE,1,TRUE,15867,17723,-1595,18.6,TRUE,0,FALSE,17462,19371,1595,25.3
TRUE,FALSE,1,TRUE,15931,17539,-730,22.2,TRUE,0,FALSE,16661,17790,730,21.3
TRUE,TRUE,1,FALSE,17610,17779,-1168,21.2,FALSE,1,TRUE,18778,18453,1168,22.9
TRUE,TRUE,0,FALSE,17495,18537,2546,20.8,FALSE,0,FALSE,14949,16609,-2546,21.1
FALSE,FALSE,0,FALSE,16230,19157,-839,22.8,TRUE,2,TRUE,17069,19990,839,23.9
FALSE,FALSE,0,FALSE,14496,16623,-2317,23,TRUE,2,TRUE,16813,17953,2317,22.3
FALSE,TRUE,1,FALSE,16008,17798,-904,21.6,FALSE,0,FALSE,16912,17976,904,25.7
FALSE,FALSE,0,FALSE,16923,17782,-673,22.4,TRUE,1,TRUE,17596,17214,673,19.9
TRUE,TRUE,1,TRUE,19462,19955,4444,23.9,FALSE,0,FALSE,15018,17142,-4444,20.9
FALSE,FALSE,0,FALSE,16482,17266,-1243,22.9,TRUE,0,FALSE,17725,17870,1243,19.4
TRUE,TRUE,1,FALSE,15592,17700,-2078,21.8,FALSE,0,FALSE,17670,19206,2078,20.5
FALSE,TRUE,1,TRUE,17268,15979,-952,19.4,FALSE,1,FALSE,18220,17316,952,21.4
FALSE,FALSE,0,FALSE,15167,16733,-2132,19.5,TRUE,0,FALSE,17299,17821,2132,21.5
FALSE,FALSE,1,TRUE,15847,17480,-1015,20.3,TRUE,1,FALSE,16862,18875,1015,25.6
FALSE,TRUE,1,FALSE,16333,18737,517,20.4,FALSE,1,TRUE,15816,18152,-517,23.4
TRUE,FALSE,0,FALSE,16032,17171,-2222,22,TRUE,1,TRUE,18254,18423,2222,22.5
TRUE,FALSE,1,TRUE,15762,18318,-208,21.6,TRUE,0,FALSE,15970,18671,208,22.1
FALSE,FALSE,0,FALSE,14749,17146,-2513,20,TRUE,0,FALSE,17262,20565,2513,24.6
TRUE,TRUE,1,FALSE,15405,17336,-601,21.5,FALSE,1,TRUE,16006,19301,601,24.9
TRUE,FALSE,1,TRUE,16775,18235,1753,22.1,TRUE,0,FALSE,15022,15932,-1753,21.3
FALSE,TRUE,1,TRUE,14667,18007,-751,20.2,FALSE,0,FALSE,15418,19236,751,23.9
TRUE,TRUE,1,FALSE,17409,18063,1430,24.1,FALSE,1,TRUE,15979,17956,-1430,17.3
TRUE,TRUE,1,TRUE,15706,17219,-469,22.8,FALSE,0,FALSE,16175,18456,469,22.9
TRUE,TRUE,1,TRUE,16466,16716,-1099,18.8,FALSE,0,FALSE,17565,18034,1099,23.2
TRUE,FALSE,0,FALSE,20190,19713,5553,20,TRUE,1,TRUE,14637,15798,-5553,14.9
TRUE,TRUE,0,FALSE,17408,19121,2091,20.4,FALSE,0,FALSE,15317,17762,-2091,22.7
FALSE,FALSE,1,TRUE,15591,17848,-1951,22.8,TRUE,0,FALSE,17542,19423,1951,23.6
TRUE,TRUE,1,TRUE,16410,18288,96,21.1,FALSE,0,FALSE,16314,18312,-96,20.3
FALSE,FALSE,0,FALSE,17854,18784,1762,21.9,TRUE,1,FALSE,16092,16407,-1762,20.2
TRUE,TRUE,1,FALSE,17243,19173,3082,23.3,FALSE,0,FALSE,14161,17813,-3082,22.2
TRUE,TRUE,1,TRUE,16987,18514,2608,18.9,FALSE,0,FALSE,14379,15127,-2608,17.2
FALSE,TRUE,0,FALSE,14818,16417,-1460,20.4,FALSE,0,FALSE,16278,18831,1460,23.1
TRUE,TRUE,1,TRUE,18633,19659,3784,23.2,FALSE,0,FALSE,14849,17082,-3784,20.9
FALSE,TRUE,0,FALSE,17566,17314,-2053,20.2,FALSE,2,TRUE,19619,19098,2053,21.4
FALSE,FALSE,0,FALSE,14956,16196,-2020,19.8,TRUE,0,FALSE,16976,18912,2020,24.6
FALSE,FALSE,1,TRUE,18206,19094,1137,22.4,TRUE,0,FALSE,17069,19186,-1137,22
FALSE,TRUE,0,FALSE,15758,16369,-1561,20.4,FALSE,0,FALSE,17319,17947,1561,21.3
FALSE,FALSE,0,FALSE,15632,18155,-598,26.8,TRUE,2,TRUE,16230,19440,598,23.8
FALSE,FALSE,0,FALSE,16278,16530,-1829,18.1,TRUE,1,TRUE,18107,18198,1829,21.2
TRUE,TRUE,1,TRUE,17131,18732,2036,21.5,FALSE,0,FALSE,15095,16841,-2036,18.8
TRUE,TRUE,1,TRUE,16795,18177,-1381,20.3,FALSE,0,FALSE,18176,19084,1381,22.1
TRUE,TRUE,1,TRUE,19070,17872,2247,21,FALSE,0,FALSE,16823,16505,-2247,20.5
TRUE,TRUE,1,TRUE,15993,18392,-800,22.7,FALSE,0,FALSE,16793,18320,800,24.3
FALSE,TRUE,0,FALSE,15715,16563,-826,18.8,FALSE,1,FALSE,16541,17542,826,23.7
TRUE,TRUE,1,TRUE,18583,18852,4280,20.4,FALSE,0,FALSE,14303,16171,-4280,20.2
FALSE,TRUE,1,TRUE,16848,16664,-973,20,FALSE,0,FALSE,17821,19355,973,21.4
TRUE,TRUE,1,TRUE,17903,19715,1970,20.6,FALSE,0,FALSE,15933,17716,-1970,23.4
TRUE,FALSE,1,FALSE,14724,16522,-1858,19.5,TRUE,1,TRUE,16582,17998,1858,22.5
FALSE,FALSE,0,FALSE,16371,16354,-1867,20.1,TRUE,1,TRUE,18238,18356,1867,19
TRUE,TRUE,2,TRUE,16571,14758,-684,19.2,FALSE,0,FALSE,17255,17159,684,18.7
TRUE,TRUE,0,FALSE,15445,17126,-3056,22.5,FALSE,1,TRUE,18501,20064,3056,22.1
FALSE,TRUE,0,FALSE,13980,15464,-4330,18.1,FALSE,0,FALSE,18310,19811,4330,22.8
TRUE,FALSE,0,FALSE,17984,18165,-1348,17.8,TRUE,1,TRUE,19332,18060,1348,21
TRUE,FALSE,0,FALSE,17588,18523,1800,23.8,TRUE,1,TRUE,15788,17810,-1800,19.2
FALSE,TRUE,0,FALSE,16326,18838,509,22.2,FALSE,1,TRUE,15817,18243,-509,23.1
FALSE,FALSE,0,FALSE,17610,17644,1883,23.3,TRUE,0,FALSE,15727,16671,-1883,21.2
FALSE,TRUE,0,FALSE,17238,17944,894,20.9,FALSE,0,FALSE,16344,17947,-894,18.7
FALSE,FALSE,1,TRUE,15602,16415,-3060,20.6,TRUE,0,FALSE,18662,19352,3060,23.8
FALSE,FALSE,0,FALSE,15615,17025,-3370,18.8,TRUE,1,FALSE,18985,19804,3370,25
FALSE,TRUE,1,TRUE,15138,16193,-452,19.1,FALSE,0,FALSE,15590,17253,452,20.6
TRUE,TRUE,1,TRUE,18021,19358,1790,25.3,FALSE,0,FALSE,16231,17594,-1790,23.7
FALSE,TRUE,1,FALSE,15063,17160,790,22.7,FALSE,1,TRUE,14273,18315,-790,21.7
TRUE,TRUE,1,TRUE,17561,17813,545,21.5,FALSE,1,FALSE,17016,17402,-545,21.8
TRUE,FALSE,1,FALSE,17696,19541,3518,25.7,TRUE,1,TRUE,14178,17038,-3518,23.9
TRUE,TRUE,2,TRUE,16548,18505,780,22.6,FALSE,0,FALSE,15768,17982,-780,22.6
FALSE,TRUE,1,TRUE,14610,17048,-758,20.6,FALSE,0,FALSE,15368,18358,758,24.9
TRUE,TRUE,0,FALSE,20604,18469,4565,19.4,FALSE,1,TRUE,16039,15837,-4565,20.2
FALSE,TRUE,1,TRUE,17698,19290,726,20.6,FALSE,0,FALSE,16972,18186,-726,22.9
FALSE,TRUE,0,FALSE,15021,16981,-1254,20.7,FALSE,2,TRUE,16275,17937,1254,24.9
FALSE,FALSE,0,FALSE,15226,17102,-1207,21,TRUE,0,FALSE,16433,17320,1207,21.5
FALSE,TRUE,1,FALSE,17064,18451,1167,26.3,FALSE,1,TRUE,15897,19887,-1167,21.4
FALSE,TRUE,0,FALSE,15221,17418,-179,26.6,FALSE,1,TRUE,15400,17881,179,24
FALSE,TRUE,1,FALSE,17972,19155,2363,20.6,FALSE,0,FALSE,15609,17841,-2363,22.6
TRUE,FALSE,0,FALSE,18151,19393,847,22.7,TRUE,0,FALSE,17304,17787,-847,22.6
TRUE,TRUE,1,TRUE,19773,20507,5622,24,FALSE,0,FALSE,14151,16543,-5622,20.3
TRUE,TRUE,0,FALSE,16262,18089,467,23.5,FALSE,0,FALSE,15795,17239,-467,22.8
FALSE,TRUE,1,TRUE,17044,17819,-115,20,FALSE,0,FALSE,17159,17678,115,20.9
TRUE,TRUE,0,FALSE,17562,19532,3512,21.3,FALSE,1,TRUE,14050,17371,-3512,21.5
FALSE,FALSE,0,FALSE,14364,16898,-2845,20.4,TRUE,1,TRUE,17209,18359,2845,20.8
TRUE,TRUE,0,FALSE,17855,18853,4076,21.1,FALSE,1,TRUE,13779,15857,-4076,21.1
TRUE,TRUE,2,TRUE,15874,16649,-1806,19.5,FALSE,0,FALSE,17680,19056,1806,22.8
TRUE,FALSE,0,FALSE,16881,18851,-216,22.8,TRUE,0,FALSE,17097,18550,216,23.3
FALSE,TRUE,1,FALSE,18060,18502,1635,19.2,FALSE,0,FALSE,16425,18086,-1635,20.4
FALSE,FALSE,0,FALSE,15106,16691,-3081,20.1,TRUE,0,FALSE,18187,17927,3081,19.2
TRUE,TRUE,0,FALSE,16454,19703,2711,24.1,FALSE,0,FALSE,13743,17010,-2711,21.1
TRUE,TRUE,1,TRUE,18078,18559,5354,24.7,FALSE,0,FALSE,12724,13864,-5354,16.6
FALSE,FALSE,0,FALSE,15300,17024,-188,21.2,TRUE,0,FALSE,15488,17559,188,23.2
TRUE,TRUE,2,TRUE,18919,20248,3983,25.2,FALSE,0,FALSE,14936,16873,-3983,23
TRUE,TRUE,1,FALSE,15565,17312,-1185,25.1,FALSE,1,TRUE,16750,19714,1185,26.7
TRUE,TRUE,1,TRUE,18553,18514,4260,20.4,FALSE,0,FALSE,14293,17092,-4260,21
TRUE,FALSE,0,FALSE,16639,19375,835,26.9,TRUE,1,TRUE,15804,17869,-835,21.6
TRUE,TRUE,0,FALSE,18273,18951,2879,21.1,FALSE,0,FALSE,15394,16429,-2879,19.5
TRUE,TRUE,0,FALSE,16560,18074,-407,20.3,FALSE,1,TRUE,16967,19331,407,22.3
FALSE,FALSE,0,FALSE,13742,12556,-5705,12.3,TRUE,1,TRUE,19447,17920,5705,21.8
FALSE,FALSE,1,TRUE,17525,19083,1270,22.1,TRUE,0,FALSE,16255,18718,-1270,21.8
FALSE,TRUE,1,TRUE,15123,17144,-3204,21,FALSE,1,FALSE,18327,17923,3204,21.6
FALSE,FALSE,0,FALSE,14686,15538,-3927,18.4,TRUE,1,FALSE,18613,18745,3927,26.2
TRUE,FALSE,1,TRUE,16957,17656,78,21.5,TRUE,0,FALSE,16879,16998,-78,20.7
TRUE,FALSE,0,FALSE,16796,19731,1789,27.6,TRUE,0,FALSE,15007,17631,-1789,23.2
FALSE,TRUE,0,FALSE,18592,19027,1577,21.2,FALSE,2,TRUE,17015,18349,-1577,23.3
FALSE,FALSE,0,FALSE,16411,17513,590,17.6,TRUE,0,FALSE,15821,16511,-590,20.8
FALSE,TRUE,0,FALSE,15730,16849,-384,22.3,FALSE,1,TRUE,16114,18257,384,22
TRUE,FALSE,1,TRUE,16302,18728,315,25.6,TRUE,1,FALSE,15987,18061,-315,22.4
FALSE,TRUE,1,FALSE,15447,16928,580,21.7,FALSE,1,TRUE,14867,17961,-580,22.8
TRUE,TRUE,1,FALSE,17299,17431,1870,22.3,FALSE,1,TRUE,15429,18160,-1870,22.6
TRUE,FALSE,2,TRUE,17500,18340,3308,22.9,TRUE,0,FALSE,14192,16226,-3308,21.5
FALSE,FALSE,1,TRUE,15659,19051,-2542,21,TRUE,1,FALSE,18201,17917,2542,23.3
FALSE,FALSE,0,FALSE,16286,17910,369,22.3,TRUE,0,FALSE,15917,17349,-369,19.6
FALSE,TRUE,1,TRUE,15335,17847,187,23.9,FALSE,0,FALSE,15148,18801,-187,24.8
FALSE,FALSE,2,TRUE,17744,19502,1109,23.7,TRUE,0,FALSE,16635,18767,-1109,23.1
TRUE,TRUE,1,TRUE,17592,19457,1572,21.3,FALSE,1,FALSE,16020,17323,-1572,21.1
FALSE,FALSE,1,TRUE,15732,17644,-2080,20.1,TRUE,1,FALSE,17812,17846,2080,20.2
FALSE,TRUE,0,FALSE,16544,17851,-2929,22.2,FALSE,1,TRUE,19473,19582,2929,22.7
TRUE,FALSE,0,FALSE,18913,18431,1441,21.5,TRUE,1,TRUE,17472,17509,-1441,20
TRUE,FALSE,0,FALSE,16757,18596,873,22.5,TRUE,0,FALSE,15884,16402,-873,20.5
TRUE,TRUE,0,FALSE,16152,18347,-633,21.2,FALSE,1,TRUE,16785,18849,633,19.6
FALSE,TRUE,1,FALSE,14505,18312,-838,22.4,FALSE,1,TRUE,15343,18905,838,25.3
TRUE,TRUE,0,FALSE,15575,17478,-1098,23.6,FALSE,0,FALSE,16673,17207,1098,24.5
FALSE,TRUE,1,FALSE,18187,19397,1909,25.7,FALSE,1,TRUE,16278,18387,-1909,24.8
TRUE,TRUE,1,FALSE,16674,18357,-1577,22.3,FALSE,0,FALSE,18251,19073,1577,20.9
FALSE,FALSE,1,TRUE,16028,16233,-728,18.7,TRUE,0,FALSE,16756,16841,728,18.4
FALSE,TRUE,0,FALSE,16157,17878,142,22.1,FALSE,1,TRUE,16015,16663,-142,19.9
FALSE,FALSE,0,FALSE,15773,18578,-2069,22.8,TRUE,1,TRUE,17842,18600,2069,22.2
TRUE,TRUE,0,FALSE,17262,18608,1673,24.8,FALSE,2,TRUE,15589,17408,-1673,19.7
FALSE,FALSE,1,TRUE,14367,15957,-5085,19.2,TRUE,0,FALSE,19452,19193,5085,24.9
TRUE,FALSE,1,TRUE,15387,17708,337,17.4,TRUE,0,FALSE,15050,16362,-337,21.3
TRUE,FALSE,1,TRUE,15326,18992,-233,22.6,TRUE,0,FALSE,15559,17023,233,22.2
TRUE,TRUE,0,FALSE,16867,18904,920,21.9,FALSE,1,TRUE,15947,17416,-920,21
TRUE,TRUE,1,TRUE,14162,17402,-1078,20.1,FALSE,0,FALSE,15240,16710,1078,24
FALSE,FALSE,1,TRUE,16253,18163,-17,21.2,TRUE,0,FALSE,16270,19334,17,24.3
FALSE,FALSE,1,TRUE,14041,16529,-4377,22.9,TRUE,0,FALSE,18418,20852,4377,23.4
TRUE,TRUE,0,FALSE,18051,19471,2563,24.7,FALSE,0,FALSE,15488,16561,-2563,23.3
TRUE,TRUE,0,FALSE,16441,18447,1254,24.4,FALSE,0,FALSE,15187,18047,-1254,21.8
FALSE,FALSE,1,TRUE,16157,18679,-521,23.9,TRUE,0,FALSE,16678,18582,521,25.5
FALSE,TRUE,1,FALSE,19793,19966,3387,24.3,FALSE,1,TRUE,16406,18512,-3387,23.9
TRUE,FALSE,1,TRUE,16284,19396,-496,19.7,TRUE,0,FALSE,16780,18792,496,20.9
FALSE,FALSE,0,FALSE,15617,17334,-3516,20.2,TRUE,1,FALSE,19133,20011,3516,23.7
TRUE,TRUE,1,TRUE,17261,18583,1579,20.6,FALSE,0,FALSE,15682,16968,-1579,18.4
FALSE,TRUE,1,TRUE,17385,18439,-747,18.5,FALSE,0,FALSE,18132,19221,747,21.4
TRUE,FALSE,0,FALSE,20134,19414,2445,18.3,TRUE,0,FALSE,17689,17647,-2445,22.1
TRUE,FALSE,1,TRUE,14867,17875,-178,20.5,TRUE,0,FALSE,15045,17137,178,24.5
FALSE,TRUE,0,FALSE,15312,16387,-1844,20.3,FALSE,0,FALSE,17156,18609,1844,22.7
TRUE,FALSE,2,TRUE,14815,18140,-980,24.6,TRUE,0,FALSE,15795,19628,980,25.9
FALSE,TRUE,1,FALSE,17511,20020,2795,25.3,FALSE,1,TRUE,14716,17318,-2795,24.4
FALSE,FALSE,0,FALSE,17157,17475,-2095,20,TRUE,0,FALSE,19252,19571,2095,20.6
FALSE,TRUE,0,FALSE,18714,18333,801,19.9,FALSE,0,FALSE,17913,18071,-801,18.2
TRUE,TRUE,1,TRUE,17136,18329,-506,22.4,FALSE,0,FALSE,17642,19029,506,21.8
TRUE,FALSE,0,FALSE,16966,19266,705,22.8,TRUE,1,TRUE,16261,16690,-705,19.8
TRUE,FALSE,0,FALSE,16948,18437,707,22.2,TRUE,0,FALSE,16241,17306,-707,22.1
TRUE,TRUE,0,FALSE,17552,19684,2098,23.3,FALSE,2,TRUE,15454,17500,-2098,23.6
TRUE,TRUE,0,FALSE,17941,17529,1680,20.6,FALSE,0,FALSE,16261,16275,-1680,21.5
FALSE,TRUE,0,FALSE,16334,15901,-300,21.8,FALSE,1,TRUE,16634,17838,300,22.4
FALSE,FALSE,0,FALSE,13342,15464,-6540,17.7,TRUE,2,TRUE,19882,20236,6540,23.4
TRUE,TRUE,1,TRUE,18014,19778,1388,23.8,FALSE,0,FALSE,16626,18805,-1388,22.5
FALSE,FALSE,0,FALSE,15114,17597,-1158,21.9,TRUE,2,TRUE,16272,18878,1158,23.1
FALSE,FALSE,1,FALSE,18234,17526,1619,20.5,TRUE,0,FALSE,16615,18101,-1619,20.9
FALSE,TRUE,1,TRUE,16061,18335,-299,22.8,FALSE,0,FALSE,16360,17881,299,22.5
FALSE,FALSE,0,FALSE,15828,17834,1176,21.8,TRUE,1,TRUE,14652,17071,-1176,21.8
FALSE,FALSE,0,FALSE,15767,18720,-943,23.3,TRUE,1,TRUE,16710,18580,943,24.9
FALSE,FALSE,1,TRUE,16460,18464,-1449,20.2,TRUE,1,FALSE,17909,19241,1449,23.6
FALSE,FALSE,0,FALSE,16138,17604,-1531,21.7,TRUE,0,FALSE,17669,19879,1531,22.8
FALSE,FALSE,1,TRUE,16482,17043,-672,22.9,TRUE,1,FALSE,17154,17378,672,19
FALSE,TRUE,0,FALSE,15656,16766,-384,23,FALSE,1,TRUE,16040,18796,384,23.3
FALSE,TRUE,1,FALSE,17281,20413,2485,21.9,FALSE,1,TRUE,14796,17479,-2485,20.7
TRUE,TRUE,1,TRUE,18195,20319,4197,25.2,FALSE,1,FALSE,13998,17212,-4197,18.7
FALSE,FALSE,0,FALSE,14054,17175,-1744,20.5,TRUE,1,TRUE,15798,18730,1744,23.2
FALSE,TRUE,0,FALSE,17191,17401,654,18.8,FALSE,1,TRUE,16537,16923,-654,19.1
TRUE,FALSE,1,TRUE,19226,20579,4389,22.8,TRUE,0,FALSE,14837,15167,-4389,21.7
TRUE,TRUE,1,TRUE,18705,19808,3692,21,FALSE,0,FALSE,15013,15780,-3692,21.9
TRUE,FALSE,1,TRUE,16057,17977,172,23.1,TRUE,1,FALSE,15885,18255,-172,24.2
FALSE,FALSE,0,FALSE,15722,17153,-488,22.4,TRUE,1,TRUE,16210,17251,488,19.2
FALSE,FALSE,0,FALSE,15513,17308,-1791,20.3,TRUE,2,TRUE,17304,16801,1791,22.5
FALSE,FALSE,0,FALSE,14964,17465,-3225,19.6,TRUE,2,TRUE,18189,19170,3225,24.9
TRUE,TRUE,1,TRUE,16678,16861,2367,19.6,FALSE,0,FALSE,14311,17110,-2367,21.9
FALSE,TRUE,0,FALSE,18238,16827,1797,18.9,FALSE,1,TRUE,16441,17550,-1797,19
FALSE,TRUE,0,FALSE,16758,17743,-1356,24.3,FALSE,0,FALSE,18114,18807,1356,20.7
TRUE,FALSE,0,FALSE,16545,19148,-207,23.5,TRUE,1,TRUE,16752,19399,207,23.5
FALSE,FALSE,1,TRUE,14843,16207,-2691,17.6,TRUE,1,FALSE,17534,17985,2691,19.9
TRUE,FALSE,2,TRUE,17459,18810,3734,22.6,TRUE,0,FALSE,13725,16067,-3734,19.8
FALSE,FALSE,0,FALSE,15878,16090,567,18.7,TRUE,0,FALSE,15311,16879,-567,22
FALSE,FALSE,1,TRUE,14462,17760,-892,21.3,TRUE,0,FALSE,15354,18578,892,24
FALSE,FALSE,0,FALSE,14788,15674,-3231,19.4,TRUE,1,TRUE,18019,18684,3231,22
TRUE,FALSE,0,FALSE,17871,18848,1591,24.3,TRUE,1,TRUE,16280,16947,-1591,19.7
FALSE,FALSE,0,FALSE,18080,18120,1998,21.9,TRUE,0,FALSE,16082,17548,-1998,22.5
FALSE,FALSE,0,FALSE,13268,15564,-7839,17,TRUE,2,TRUE,21107,18897,7839,25.3
TRUE,TRUE,1,TRUE,18291,18572,3222,23.5,FALSE,0,FALSE,15069,17560,-3222,23.2
TRUE,FALSE,1,TRUE,16795,19215,1715,23.8,TRUE,1,FALSE,15080,17667,-1715,25.4
FALSE,FALSE,0,FALSE,13602,15564,-5088,17,TRUE,1,TRUE,18690,18173,5088,23.1
TRUE,FALSE,1,FALSE,19162,17841,1082,19.6,TRUE,1,TRUE,18080,17827,-1082,20.3
TRUE,TRUE,0,FALSE,17253,18869,1887,21.8,FALSE,1,TRUE,15366,18350,-1887,23.3
TRUE,TRUE,0,FALSE,19713,18607,2795,21.7,FALSE,0,FALSE,16918,17608,-2795,17.7
FALSE,FALSE,0,FALSE,15675,16501,549,21.8,TRUE,1,TRUE,15126,16277,-549,17
TRUE,FALSE,0,FALSE,15691,18589,96,23.7,TRUE,0,FALSE,15595,18123,-96,22.1
FALSE,FALSE,0,FALSE,15008,16888,-1015,21.4,TRUE,1,TRUE,16023,18639,1015,20.8
TRUE,TRUE,1,TRUE,16867,18156,2474,23.2,FALSE,0,FALSE,14393,17141,-2474,23
TRUE,FALSE,1,TRUE,17104,18350,-111,22.3,TRUE,1,FALSE,17215,17288,111,20.1
FALSE,TRUE,1,TRUE,17731,18132,1375,23.2,FALSE,0,FALSE,16356,18023,-1375,20.6
FALSE,FALSE,0,FALSE,13751,17182,-2507,19.9,TRUE,1,TRUE,16258,18749,2507,26.9
FALSE,TRUE,1,TRUE,15544,17440,201,21.7,FALSE,0,FALSE,15343,18419,-201,21.4
FALSE,FALSE,1,FALSE,18057,18682,3152,23.1,TRUE,0,FALSE,14905,16578,-3152,21.1
FALSE,TRUE,0,FALSE,16321,19044,120,22.7,FALSE,1,TRUE,16201,19541,-120,21.6
TRUE,TRUE,0,FALSE,17394,17390,1377,19.9,FALSE,2,TRUE,16017,17611,-1377,21.8
TRUE,TRUE,1,FALSE,17622,19582,3071,23,FALSE,0,FALSE,14551,16939,-3071,22
TRUE,TRUE,1,TRUE,20127,19673,6148,25.1,FALSE,0,FALSE,13979,16132,-6148,19.6
TRUE,TRUE,1,TRUE,15800,17445,295,20.9,FALSE,1,FALSE,15505,16654,-295,20.6
TRUE,TRUE,0,FALSE,15723,17400,451,24.2,FALSE,0,FALSE,15272,16243,-451,23.4
TRUE,FALSE,0,FALSE,16544,17758,732,19.6,TRUE,1,TRUE,15812,17478,-732,19.9
FALSE,FALSE,0,FALSE,17758,17663,920,23.3,TRUE,1,TRUE,16838,18049,-920,21.4
FALSE,FALSE,0,FALSE,15890,15649,-2039,19.9,TRUE,1,TRUE,17929,17946,2039,22.3
FALSE,FALSE,0,FALSE,14646,16931,-5036,21.9,TRUE,2,TRUE,19682,19179,5036,26.2
FALSE,FALSE,1,TRUE,16898,17791,-540,21.1,TRUE,0,FALSE,17438,16461,540,19
FALSE,FALSE,1,FALSE,17524,18124,-1319,20.3,TRUE,1,TRUE,18843,18964,1319,22.3
TRUE,TRUE,0,FALSE,16541,17099,2555,23.1,FALSE,0,FALSE,13986,14976,-2555,14.6
FALSE,TRUE,1,TRUE,14566,13119,-2663,16.4,FALSE,0,FALSE,17229,15697,2663,20.9
TRUE,TRUE,1,FALSE,15929,18680,17,25,FALSE,1,TRUE,15912,18636,-17,20.3
FALSE,TRUE,0,FALSE,15866,17209,-859,20.7,FALSE,0,FALSE,16725,18395,859,24.5
FALSE,TRUE,0,FALSE,16126,18201,61,21.7,FALSE,1,TRUE,16065,17081,-61,20.3
TRUE,TRUE,1,FALSE,15620,18558,-1761,23.9,FALSE,1,TRUE,17381,18943,1761,24.3
TRUE,FALSE,1,TRUE,17524,18949,1076,18.5,TRUE,0,FALSE,16448,17667,-1076,20.9
TRUE,TRUE,0,FALSE,18746,19066,2198,22.5,FALSE,1,TRUE,16548,17711,-2198,20.4
FALSE,TRUE,0,FALSE,17187,18178,626,21.3,FALSE,0,FALSE,16561,18080,-626,23.1
TRUE,FALSE,1,TRUE,15181,17084,911,21.6,TRUE,0,FALSE,14270,16635,-911,22.3
TRUE,TRUE,0,FALSE,19563,19145,4666,22,FALSE,0,FALSE,14897,14857,-4666,15.5
TRUE,FALSE,2,TRUE,19197,18709,1167,22.2,TRUE,0,FALSE,18030,19140,-1167,21.9
FALSE,FALSE,0,FALSE,14803,17434,-2454,17.7,TRUE,1,TRUE,17257,18871,2454,21.9
FALSE,FALSE,1,FALSE,13508,15002,-3580,16,TRUE,1,TRUE,17088,17969,3580,19.3
FALSE,TRUE,0,FALSE,18978,21014,4185,26.2,FALSE,0,FALSE,14793,17637,-4185,20.5
TRUE,FALSE,0,FALSE,16627,18254,1899,24.7,TRUE,1,TRUE,14728,17946,-1899,23.1
TRUE,FALSE,0,FALSE,15562,17869,-435,22.5,TRUE,1,TRUE,15997,18296,435,19.6
FALSE,FALSE,1,TRUE,14717,16410,-3025,20.5,TRUE,1,FALSE,17742,18233,3025,21.1
FALSE,FALSE,0,FALSE,16213,18890,-3035,20.8,TRUE,2,TRUE,19248,18702,3035,21.7
FALSE,TRUE,0,FALSE,16922,17511,118,19.1,FALSE,1,TRUE,16804,18043,-118,19.3
FALSE,FALSE,0,FALSE,17094,18539,1004,22,TRUE,1,TRUE,16090,17093,-1004,21.1
TRUE,FALSE,1,TRUE,17232,17777,725,21.2,TRUE,0,FALSE,16507,17151,-725,19.1
TRUE,TRUE,1,TRUE,19529,19979,3316,24.2,FALSE,0,FALSE,16213,17947,-3316,19.7
FALSE,TRUE,0,FALSE,15684,17100,-1400,20.3,FALSE,1,TRUE,17084,17744,1400,20.8
TRUE,FALSE,1,TRUE,16352,19028,1824,25,TRUE,0,FALSE,14528,17824,-1824,23.9
FALSE,TRUE,1,FALSE,16782,19622,817,23.8,FALSE,1,TRUE,15965,19272,-817,23.5
TRUE,TRUE,0,FALSE,17514,17672,3170,23.6,FALSE,0,FALSE,14344,15688,-3170,17.5
FALSE,FALSE,0,FALSE,17332,18724,-6,22.6,TRUE,2,TRUE,17338,17720,6,18.8
TRUE,TRUE,0,FALSE,18951,17892,2896,20.4,FALSE,0,FALSE,16055,16562,-2896,19.6
TRUE,TRUE,1,TRUE,18039,18984,4991,23.6,FALSE,0,FALSE,13048,15620,-4991,19.3
FALSE,FALSE,1,FALSE,14487,17499,-2639,22.9,TRUE,1,TRUE,17126,18452,2639,22.7
TRUE,FALSE,2,TRUE,18398,19201,2087,23.4,TRUE,0,FALSE,16311,18551,-2087,22.6
TRUE,FALSE,1,FALSE,15007,17592,-1933,25.1,TRUE,1,TRUE,16940,17577,1933,21.5
FALSE,TRUE,1,TRUE,16117,19109,2975,22.1,FALSE,0,FALSE,13142,15132,-2975,18.2
FALSE,TRUE,0,FALSE,17457,18210,2783,25.1,FALSE,2,TRUE,14674,16607,-2783,19
FALSE,TRUE,1,TRUE,15716,17691,-1555,23.5,FALSE,1,FALSE,17271,18716,1555,23.7
TRUE,FALSE,1,TRUE,15980,17313,-2565,20.7,TRUE,1,FALSE,18545,18906,2565,23.5
FALSE,FALSE,1,TRUE,15364,18462,-673,23.3,TRUE,0,FALSE,16037,18510,673,20.6
TRUE,TRUE,1,FALSE,19082,20858,4012,24.4,FALSE,0,FALSE,15070,17778,-4012,23
TRUE,TRUE,1,TRUE,15671,17411,-981,20.5,FALSE,0,FALSE,16652,18405,981,21.9
FALSE,FALSE,0,FALSE,14321,16982,-4557,20.8,TRUE,0,FALSE,18878,20553,4557,26
FALSE,FALSE,0,FALSE,15903,17896,811,20.6,TRUE,0,FALSE,15092,17655,-811,19.9
TRUE,TRUE,0,FALSE,20828,19032,6375,25,FALSE,0,FALSE,14453,15083,-6375,16.4
TRUE,FALSE,1,TRUE,17442,18411,557,21.9,TRUE,0,FALSE,16885,16558,-557,19
TRUE,FALSE,1,FALSE,20617,19936,3183,24,TRUE,1,TRUE,17434,18615,-3183,23.5
TRUE,FALSE,0,FALSE,13691,16957,-1148,22.9,TRUE,0,FALSE,14839,17775,1148,22.1
FALSE,FALSE,1,FALSE,14909,17001,-447,20.8,TRUE,0,FALSE,15356,16325,447,19.7
FALSE,FALSE,0,FALSE,16372,16747,53,23,TRUE,1,TRUE,16319,16795,-53,18.6
FALSE,FALSE,1,TRUE,17134,17579,-840,17.1,TRUE,0,FALSE,17974,16630,840,21.4
TRUE,TRUE,1,FALSE,15648,17420,1187,21.6,FALSE,1,TRUE,14461,17135,-1187,21.5
TRUE,FALSE,1,TRUE,16279,18734,-1753,22.6,TRUE,0,FALSE,18032,19829,1753,25.3
TRUE,FALSE,0,FALSE,17251,19522,-172,22.5,TRUE,0,FALSE,17423,17909,172,22.4
TRUE,TRUE,1,TRUE,17330,18821,777,22.6,FALSE,0,FALSE,16553,17241,-777,19.5
TRUE,TRUE,1,TRUE,17655,18905,1906,20.8,FALSE,0,FALSE,15749,17536,-1906,22.1
TRUE,FALSE,0,FALSE,17258,17683,2310,21.6,TRUE,0,FALSE,14948,15737,-2310,17.6
FALSE,FALSE,0,FALSE,13729,14661,-1213,18,TRUE,2,TRUE,14942,14937,1213,16.1
TRUE,FALSE,1,FALSE,18555,20361,2488,24.6,TRUE,1,TRUE,16067,17639,-2488,18.5
TRUE,FALSE,1,FALSE,17025,19492,1399,21.4,TRUE,0,FALSE,15626,16876,-1399,18.1
TRUE,FALSE,0,FALSE,17528,18106,1376,21.6,TRUE,1,TRUE,16152,17088,-1376,21.7
TRUE,TRUE,1,TRUE,15829,17888,265,20.5,FALSE,1,FALSE,15564,17647,-265,20.4
FALSE,FALSE,1,FALSE,16135,18177,-1782,23.4,TRUE,1,TRUE,17917,19488,1782,26.4
TRUE,TRUE,1,TRUE,15781,17957,-535,22.1,FALSE,0,FALSE,16316,18648,535,24
FALSE,TRUE,0,FALSE,16533,17850,-727,19.8,FALSE,1,TRUE,17260,18525,727,22.4
TRUE,TRUE,1,TRUE,18270,19486,3805,23.8,FALSE,0,FALSE,14465,16324,-3805,19.9
TRUE,TRUE,1,TRUE,19673,21261,5797,20.9,FALSE,0,FALSE,13876,16805,-5797,21.8
TRUE,TRUE,0,FALSE,17628,18793,3539,23.1,FALSE,0,FALSE,14089,15841,-3539,19.5
TRUE,FALSE,1,FALSE,16375,17469,-3183,17.7,TRUE,0,FALSE,19558,19353,3183,23.6
FALSE,FALSE,0,FALSE,14533,17818,-4033,19.8,TRUE,1,TRUE,18566,19668,4033,22
FALSE,TRUE,0,FALSE,16067,17256,-1176,19,FALSE,2,TRUE,17243,17927,1176,22
TRUE,TRUE,2,TRUE,14740,16655,-1402,20.1,FALSE,0,FALSE,16142,18950,1402,23.3
FALSE,TRUE,0,FALSE,16560,18547,761,22.5,FALSE,1,TRUE,15799,17717,-761,22.5
FALSE,TRUE,0,FALSE,16979,17700,1038,22.8,FALSE,1,TRUE,15941,17246,-1038,17.4
FALSE,FALSE,0,FALSE,14081,15129,-6402,20.7,TRUE,1,TRUE,20483,19318,6402,23.3
FALSE,FALSE,0,FALSE,13511,14048,-5427,16.4,TRUE,1,TRUE,18938,18607,5427,23.9
FALSE,TRUE,0,FALSE,17951,17922,-194,22.6,FALSE,0,FALSE,18145,17491,194,22.7
TRUE,FALSE,0,FALSE,14202,16773,-2263,21.2,TRUE,1,TRUE,16465,18170,2263,24
FALSE,FALSE,1,FALSE,18291,17873,1693,20.8,TRUE,0,FALSE,16598,15894,-1693,18
FALSE,FALSE,1,FALSE,15599,16288,-2231,21.9,TRUE,1,TRUE,17830,17145,2231,21.4
TRUE,TRUE,1,TRUE,18265,20351,3362,23.7,FALSE,0,FALSE,14903,16477,-3362,18.7
TRUE,FALSE,1,FALSE,18888,18915,2840,20.4,TRUE,1,TRUE,16048,17123,-2840,20.5
FALSE,FALSE,0,FALSE,16422,17598,-2606,20.6,TRUE,1,TRUE,19028,20762,2606,24.3
TRUE,FALSE,0,FALSE,18090,18642,1884,21.6,TRUE,0,FALSE,16206,17190,-1884,19
TRUE,TRUE,1,TRUE,17602,19787,2849,25.1,FALSE,0,FALSE,14753,17862,-2849,19.6
TRUE,FALSE,0,FALSE,13991,16073,-3756,20.3,TRUE,0,FALSE,17747,19353,3756,25.6
TRUE,FALSE,1,TRUE,17389,18459,2577,22.1,TRUE,1,FALSE,14812,15871,-2577,21.8
TRUE,FALSE,1,TRUE,15586,18599,-1777,22.9,TRUE,0,FALSE,17363,18547,1777,24.4
FALSE,FALSE,1,FALSE,15279,18355,-1526,23.6,TRUE,1,TRUE,16805,19437,1526,23.6
TRUE,TRUE,1,TRUE,17016,18560,338,21,FALSE,0,FALSE,16678,18792,-338,21.2
TRUE,FALSE,0,FALSE,16171,18471,-758,24,TRUE,0,FALSE,16929,17551,758,20.8
TRUE,TRUE,1,TRUE,19127,19350,5062,25.3,FALSE,1,FALSE,14065,17354,-5062,21.5
FALSE,TRUE,2,TRUE,17962,17698,3367,19.1,FALSE,0,FALSE,14595,15735,-3367,18.5
FALSE,FALSE,1,TRUE,14580,16446,-4591,20.3,TRUE,0,FALSE,19171,18066,4591,24.1
FALSE,TRUE,1,FALSE,15716,19033,121,25.1,FALSE,1,TRUE,15595,18769,-121,25.5
FALSE,FALSE,0,FALSE,13962,16214,-1635,21.5,TRUE,1,FALSE,15597,17681,1635,19.3
TRUE,TRUE,1,TRUE,18519,18891,4756,26,FALSE,0,FALSE,13763,15329,-4756,19.6
TRUE,TRUE,2,TRUE,18557,19603,3848,23.5,FALSE,0,FALSE,14709,16899,-3848,20
TRUE,TRUE,0,FALSE,16793,19426,463,23.3,FALSE,1,TRUE,16330,19151,-463,22.4
FALSE,FALSE,1,FALSE,19169,19642,3305,23.5,TRUE,1,TRUE,15864,17056,-3305,21.5
TRUE,TRUE,1,TRUE,19933,18730,2473,21.9,FALSE,0,FALSE,17460,18165,-2473,20
FALSE,FALSE,1,TRUE,16391,18597,153,23.3,TRUE,0,FALSE,16238,17884,-153,23.6
TRUE,TRUE,1,TRUE,17340,19234,3125,22.9,FALSE,0,FALSE,14215,17450,-3125,21.9
TRUE,TRUE,0,FALSE,19861,18934,2352,22,FALSE,2,TRUE,17509,18801,-2352,18.3
FALSE,FALSE,2,TRUE,16273,18638,-454,24.6,TRUE,0,FALSE,16727,18615,454,20.4
FALSE,FALSE,1,FALSE,15595,17384,-1840,20.6,TRUE,1,TRUE,17435,19786,1840,24.2
FALSE,TRUE,2,TRUE,17429,17332,900,20.9,FALSE,0,FALSE,16529,18134,-900,21.7
FALSE,TRUE,0,FALSE,16524,18962,96,24.5,FALSE,2,TRUE,16428,18983,-96,25.7
FALSE,FALSE,0,FALSE,15293,16350,-2004,22.6,TRUE,1,FALSE,17297,17757,2004,22.7
FALSE,FALSE,0,FALSE,13988,15917,-2761,17.4,TRUE,1,TRUE,16749,18102,2761,24.2
TRUE,TRUE,1,TRUE,15557,17180,-633,23.4,FALSE,0,FALSE,16190,18503,633,20.6
FALSE,FALSE,0,FALSE,15227,17701,-1558,23.1,TRUE,2,TRUE,16785,19483,1558,24.4
FALSE,TRUE,1,TRUE,16378,16837,393,17.8,FALSE,0,FALSE,15985,17892,-393,22.7
FALSE,FALSE,1,TRUE,16007,17830,-873,20.4,TRUE,0,FALSE,16880,17522,873,21.5
TRUE,TRUE,2,TRUE,17937,18340,1063,22.7,FALSE,0,FALSE,16874,17787,-1063,22.6
FALSE,FALSE,0,FALSE,13537,15367,-3752,20.8,TRUE,1,TRUE,17289,18716,3752,24.2
FALSE,TRUE,1,TRUE,17907,19438,1550,23.1,FALSE,0,FALSE,16357,16926,-1550,19.2
FALSE,TRUE,0,FALSE,16053,18228,611,21.6,FALSE,1,TRUE,15442,17847,-611,20.8
TRUE,FALSE,0,FALSE,16616,19302,-616,24,TRUE,1,TRUE,17232,18574,616,23.4
TRUE,FALSE,2,TRUE,16367,16065,151,20.2,TRUE,0,FALSE,16216,14784,-151,20.1
TRUE,TRUE,0,FALSE,17494,18057,1518,20.5,FALSE,1,TRUE,15976,18062,-1518,19.9
TRUE,TRUE,2,TRUE,17704,19789,1241,20,FALSE,0,FALSE,16463,17373,-1241,23
TRUE,TRUE,0,FALSE,17817,17747,780,18.8,FALSE,0,FALSE,17037,17673,-780,21.2
TRUE,TRUE,0,FALSE,17940,16927,-2725,16.2,FALSE,1,TRUE,20665,20495,2725,25.2
FALSE,TRUE,1,FALSE,16988,18153,37,22.3,FALSE,1,TRUE,16951,19058,-37,21.6
TRUE,FALSE,1,TRUE,17661,17077,815,23.3,TRUE,0,FALSE,16846,16487,-815,19.1
TRUE,FALSE,0,FALSE,15755,19845,951,22.5,TRUE,2,TRUE,14804,17652,-951,19.7
FALSE,FALSE,0,FALSE,15392,16156,-4885,17.5,TRUE,1,FALSE,20277,19267,4885,23.3
FALSE,FALSE,0,FALSE,13925,16354,-4527,19.8,TRUE,1,TRUE,18452,19480,4527,22.9
TRUE,TRUE,1,TRUE,16421,18152,1239,24.1,FALSE,0,FALSE,15182,19203,-1239,21.9
TRUE,TRUE,1,TRUE,14535,16699,-988,23.4,FALSE,1,FALSE,15523,18126,988,24.1
TRUE,TRUE,1,FALSE,17082,18373,2216,22.1,FALSE,1,TRUE,14866,16793,-2216,20.8
FALSE,TRUE,2,TRUE,15711,17255,-101,20.8,FALSE,0,FALSE,15812,18575,101,21
TRUE,TRUE,1,FALSE,16087,19195,225,22.4,FALSE,1,TRUE,15862,18371,-225,20.8
FALSE,FALSE,0,FALSE,13358,15566,-4737,19.9,TRUE,1,TRUE,18095,19166,4737,25.3
TRUE,TRUE,1,TRUE,18438,18924,3742,21.2,FALSE,0,FALSE,14696,15695,-3742,18.4
FALSE,TRUE,1,TRUE,14485,17287,-1866,22,FALSE,0,FALSE,16351,19172,1866,25.3
TRUE,TRUE,1,TRUE,16222,18746,1997,24.1,FALSE,0,FALSE,14225,17186,-1997,23.4
FALSE,TRUE,0,FALSE,14624,17333,-2794,22.5,FALSE,0,FALSE,17418,19957,2794,23.1
TRUE,TRUE,1,TRUE,17568,16755,1236,20.6,FALSE,0,FALSE,16332,15737,-1236,18.3
FALSE,TRUE,1,TRUE,15198,17316,-13,23.5,FALSE,1,FALSE,15211,19108,13,20.7
TRUE,TRUE,0,FALSE,16313,17824,1128,24,FALSE,0,FALSE,15185,17326,-1128,22
FALSE,TRUE,0,FALSE,16560,19116,-529,23.5,FALSE,1,TRUE,17089,19170,529,22.3
FALSE,FALSE,0,FALSE,15693,17777,-486,21,TRUE,1,TRUE,16179,17914,486,21.6
TRUE,TRUE,0,FALSE,16403,18111,-1445,21.8,FALSE,1,FALSE,17848,18847,1445,21
FALSE,FALSE,0,FALSE,13720,16815,-2727,23,TRUE,1,TRUE,16447,20937,2727,26.3
FALSE,TRUE,1,TRUE,16599,16723,1036,20.1,FALSE,0,FALSE,15563,17386,-1036,25.1
FALSE,FALSE,0,FALSE,15364,17090,-799,19.8,TRUE,0,FALSE,16163,17678,799,24.2
FALSE,FALSE,0,FALSE,14978,16243,-4413,14.7,TRUE,2,TRUE,19391,18236,4413,23.7
FALSE,TRUE,1,FALSE,16970,17984,-153,23.6,FALSE,1,TRUE,17123,17905,153,22.3
FALSE,FALSE,0,FALSE,16851,17931,-2286,20.1,TRUE,0,FALSE,19137,18907,2286,19.9
FALSE,FALSE,0,FALSE,14893,17322,-1002,20.3,TRUE,1,TRUE,15895,17700,1002,23.3
TRUE,TRUE,2,TRUE,21893,21511,7125,24.3,FALSE,0,FALSE,14768,17854,-7125,17.6
TRUE,FALSE,1,TRUE,15574,17788,840,23,TRUE,0,FALSE,14734,17592,-840,20.3
TRUE,FALSE,1,FALSE,18155,19429,468,23.1,TRUE,1,TRUE,17687,18871,-468,19.4
TRUE,FALSE,1,TRUE,16469,18105,248,19.2,TRUE,0,FALSE,16221,17523,-248,22.5
FALSE,FALSE,0,FALSE,13983,15892,-3832,21.4,TRUE,2,TRUE,17815,19216,3832,27.6
TRUE,TRUE,1,TRUE,22472,20870,8284,25.1,FALSE,0,FALSE,14188,16216,-8284,20.2
TRUE,TRUE,0,FALSE,16807,19637,1295,22.2,FALSE,1,TRUE,15512,18470,-1295,23.7
TRUE,FALSE,1,TRUE,14996,15901,-3331,18.8,TRUE,1,FALSE,18327,19365,3331,21.8
TRUE,FALSE,2,TRUE,17477,18070,1049,18.6,TRUE,0,FALSE,16428,17259,-1049,22.8
FALSE,TRUE,1,TRUE,15810,16837,-1305,19.3,FALSE,0,FALSE,17115,18860,1305,18.9
FALSE,FALSE,0,FALSE,13980,15030,-3739,19.3,TRUE,2,TRUE,17719,18571,3739,24.6
TRUE,TRUE,2,TRUE,15726,17245,-252,20.3,FALSE,0,FALSE,15978,17168,252,21.2
FALSE,FALSE,0,FALSE,15153,18629,-809,19.1,TRUE,1,TRUE,15962,18218,809,21.6
FALSE,TRUE,0,FALSE,14695,17431,-2062,22.8,FALSE,1,TRUE,16757,18897,2062,24.6
FALSE,FALSE,1,TRUE,16106,18323,-84,20.7,TRUE,0,FALSE,16190,17753,84,20.7
TRUE,TRUE,0,FALSE,16493,18450,628,23.1,FALSE,1,TRUE,15865,18693,-628,21.2
TRUE,FALSE,0,FALSE,17099,19592,1344,22.5,TRUE,1,TRUE,15755,17513,-1344,23.8
FALSE,FALSE,1,TRUE,15211,17951,-3848,22.5,TRUE,1,FALSE,19059,20042,3848,23.8
FALSE,TRUE,1,TRUE,16643,18300,1515,21.5,FALSE,0,FALSE,15128,17710,-1515,20.7
FALSE,FALSE,0,FALSE,16581,18360,462,19.8,TRUE,0,FALSE,16119,16634,-462,20
TRUE,TRUE,1,TRUE,17953,18823,1058,19,FALSE,0,FALSE,16895,17627,-1058,20.6
FALSE,TRUE,0,FALSE,16112,17371,-554,19.7,FALSE,1,TRUE,16666,17854,554,20.6
TRUE,TRUE,0,FALSE,15637,16107,-460,20.1,FALSE,0,FALSE,16097,16949,460,21.8
FALSE,TRUE,0,FALSE,15977,18136,-1130,20.6,FALSE,1,TRUE,17107,18483,1130,23
FALSE,FALSE,1,FALSE,13932,14927,-3919,19.7,TRUE,0,FALSE,17851,18062,3919,20.5
TRUE,FALSE,0,FALSE,16206,17669,-677,22.1,TRUE,1,TRUE,16883,17736,677,24.5
FALSE,TRUE,0,FALSE,16163,16772,-819,19,FALSE,0,FALSE,16982,18698,819,22.5
TRUE,FALSE,1,TRUE,15296,16908,733,18.7,TRUE,0,FALSE,14563,16098,-733,20.4
TRUE,FALSE,0,FALSE,15966,18157,-847,20.9,TRUE,1,TRUE,16813,18424,847,20.3
FALSE,TRUE,0,FALSE,15555,19704,737,21.4,FALSE,1,TRUE,14818,18610,-737,23.5
TRUE,FALSE,1,TRUE,16041,18214,1891,23.3,TRUE,0,FALSE,14150,17611,-1891,21.4
FALSE,FALSE,0,FALSE,15239,16561,-3130,19.4,TRUE,1,TRUE,18369,19009,3130,23.6
TRUE,TRUE,1,TRUE,17049,17343,147,18,FALSE,0,FALSE,16902,18768,-147,19.3
TRUE,TRUE,1,TRUE,17492,18028,687,21.9,FALSE,0,FALSE,16805,17465,-687,22.4
FALSE,FALSE,0,FALSE,14370,16473,-3180,22.8,TRUE,1,TRUE,17550,19669,3180,21.1
FALSE,FALSE,0,FALSE,17543,18967,-144,24.6,TRUE,2,TRUE,17687,19834,144,22.5
FALSE,FALSE,1,TRUE,13570,15970,-6374,19.5,TRUE,1,FALSE,19944,20391,6374,26.2
FALSE,TRUE,0,FALSE,15948,17169,-947,22.2,FALSE,2,TRUE,16895,18209,947,24.8
TRUE,FALSE,0,FALSE,14339,15064,-3074,19.7,TRUE,0,FALSE,17413,17675,3074,23.3
TRUE,TRUE,1,TRUE,20084,17621,2098,17.5,FALSE,0,FALSE,17986,16471,-2098,18.2
TRUE,FALSE,0,FALSE,15375,17114,-1270,20,TRUE,1,TRUE,16645,19477,1270,27.3
TRUE,FALSE,0,FALSE,14313,15407,-2089,19.4,TRUE,1,TRUE,16402,17682,2089,24.3
TRUE,TRUE,0,FALSE,17786,19149,3404,23.3,FALSE,0,FALSE,14382,16636,-3404,20.6
TRUE,TRUE,1,FALSE,16657,18154,-206,21,FALSE,1,TRUE,16863,19630,206,24.8
TRUE,TRUE,2,TRUE,15994,18356,1396,23.5,FALSE,0,FALSE,14598,15987,-1396,16.6
FALSE,TRUE,0,FALSE,14352,15070,-2475,15.3,FALSE,1,TRUE,16827,18678,2475,22.7
TRUE,FALSE,0,FALSE,15589,17960,-2111,20.3,TRUE,1,TRUE,17700,19345,2111,26.2
FALSE,FALSE,0,FALSE,17544,18246,-375,21.3,TRUE,1,TRUE,17919,18793,375,23
FALSE,TRUE,1,TRUE,16447,16299,-1942,20.8,FALSE,0,FALSE,18389,18961,1942,23.9
TRUE,FALSE,1,TRUE,15883,17317,-426,23.5,TRUE,0,FALSE,16309,17640,426,23.8
FALSE,FALSE,1,TRUE,15693,16140,-2794,17.7,TRUE,0,FALSE,18487,18828,2794,23.7
FALSE,TRUE,0,FALSE,13737,15314,-7218,17.4,FALSE,1,TRUE,20955,21167,7218,25
FALSE,TRUE,0,FALSE,17019,19372,1175,23.6,FALSE,2,TRUE,15844,18409,-1175,23.1
FALSE,TRUE,0,FALSE,15029,17571,-1420,23,FALSE,1,TRUE,16449,18986,1420,22.2
FALSE,TRUE,0,FALSE,16643,18042,-265,23.2,FALSE,1,TRUE,16908,18914,265,22.2
TRUE,TRUE,0,FALSE,15198,16245,-797,22.6,FALSE,1,TRUE,15995,16777,797,18
TRUE,FALSE,1,TRUE,18625,18540,3201,23.1,TRUE,1,FALSE,15424,16540,-3201,19.1
FALSE,TRUE,0,FALSE,15030,16763,-632,20.4,FALSE,1,TRUE,15662,16088,632,19.2
TRUE,TRUE,0,FALSE,18347,19605,2493,25.1,FALSE,1,TRUE,15854,17779,-2493,23.3
TRUE,FALSE,1,FALSE,18458,20320,3158,27,TRUE,1,TRUE,15300,17726,-3158,20.2
FALSE,FALSE,0,FALSE,16228,16832,-1127,19.1,TRUE,2,TRUE,17355,18328,1127,20.4
FALSE,TRUE,0,FALSE,16880,17998,-296,19.5,FALSE,0,FALSE,17176,17126,296,24.6
TRUE,FALSE,0,FALSE,14144,16975,-1473,22.8,TRUE,1,TRUE,15617,17004,1473,22.8
FALSE,TRUE,0,FALSE,16056,17480,810,19.8,FALSE,1,TRUE,15246,17382,-810,19.2
TRUE,FALSE,0,FALSE,17444,18454,-180,19.7,TRUE,2,TRUE,17624,18556,180,20.4
TRUE,FALSE,0,FALSE,14716,17855,-839,21.9,TRUE,1,TRUE,15555,17792,839,21.5
TRUE,FALSE,1,FALSE,16443,19348,1030,26.1,TRUE,1,TRUE,15413,18434,-1030,23.5
TRUE,FALSE,1,TRUE,14507,17455,-885,20.7,TRUE,0,FALSE,15392,17275,885,20.6
FALSE,TRUE,1,TRUE,17974,15423,186,18.2,FALSE,1,FALSE,17788,16164,-186,18.8
FALSE,FALSE,0,FALSE,15279,17220,-3702,20.6,TRUE,2,TRUE,18981,18471,3702,23.7
TRUE,TRUE,1,FALSE,18837,20066,3479,24.6,FALSE,1,TRUE,15358,17409,-3479,22.2
FALSE,TRUE,0,FALSE,14291,15475,-4991,21.2,FALSE,2,TRUE,19282,19001,4991,21.6
FALSE,TRUE,1,TRUE,15290,16843,-2543,19.5,FALSE,0,FALSE,17833,17381,2543,21.5
TRUE,TRUE,0,FALSE,17687,19488,1729,19.7,FALSE,0,FALSE,15958,17182,-1729,19.4
FALSE,TRUE,0,FALSE,15742,17327,-1964,22.8,FALSE,1,TRUE,17706,20431,1964,24.1
FALSE,FALSE,1,TRUE,13942,17704,-1231,21.9,TRUE,0,FALSE,15173,18612,1231,24.8
FALSE,FALSE,0,FALSE,16452,17916,-445,22,TRUE,0,FALSE,16897,17775,445,21.2
FALSE,FALSE,1,TRUE,16123,18987,857,23.5,TRUE,0,FALSE,15266,18026,-857,20.2
FALSE,TRUE,0,FALSE,14725,16460,-2959,20,FALSE,0,FALSE,17684,19186,2959,21.3
FALSE,TRUE,0,FALSE,17151,17562,-1593,14.9,FALSE,0,FALSE,18744,18719,1593,21.2
FALSE,FALSE,0,FALSE,14616,18564,-1441,24.2,TRUE,1,TRUE,16057,18509,1441,20.7
TRUE,TRUE,1,TRUE,15862,17599,-292,22,FALSE,0,FALSE,16154,18039,292,22.4
FALSE,FALSE,0,FALSE,19139,17648,814,18,TRUE,0,FALSE,18325,17566,-814,20.3
TRUE,FALSE,1,TRUE,18409,18255,225,21.2,TRUE,1,FALSE,18184,18471,-225,24.2
TRUE,TRUE,0,FALSE,18236,17468,2481,20.7,FALSE,0,FALSE,15755,15998,-2481,18.4
FALSE,TRUE,0,FALSE,16991,18186,1116,24.2,FALSE,0,FALSE,15875,17136,-1116,24.8
FALSE,TRUE,0,FALSE,14270,15513,-3519,21.5,FALSE,1,TRUE,17789,19788,3519,24.1
FALSE,TRUE,0,FALSE,17802,17107,1124,18.3,FALSE,1,TRUE,16678,16049,-1124,19
TRUE,TRUE,1,FALSE,17340,18431,2486,21.5,FALSE,0,FALSE,14854,16283,-2486,22.3
FALSE,TRUE,2,TRUE,18959,19473,3373,24.4,FALSE,0,FALSE,15586,17689,-3373,22.1
FALSE,FALSE,0,FALSE,14809,17625,-2595,23.2,TRUE,0,FALSE,17404,19542,2595,24.5
TRUE,FALSE,0,FALSE,16900,17296,-590,16.8,TRUE,0,FALSE,17490,16769,590,18.6
TRUE,TRUE,0,FALSE,16647,18161,3257,21.4,FALSE,0,FALSE,13390,16023,-3257,19.7
TRUE,TRUE,1,FALSE,17149,18751,2610,25.7,FALSE,1,TRUE,14539,17035,-2610,20.3
FALSE,FALSE,0,FALSE,16855,18568,-1297,22.1,TRUE,1,TRUE,18152,19424,1297,22.9
TRUE,TRUE,0,FALSE,17838,18262,-482,23,FALSE,1,FALSE,18320,17594,482,20.2
TRUE,TRUE,1,FALSE,16730,17556,-1237,18,FALSE,1,TRUE,17967,16803,1237,19.6
FALSE,FALSE,1,FALSE,16948,17462,-5335,18.1,TRUE,1,TRUE,22283,18464,5335,25.3
TRUE,TRUE,1,TRUE,13946,16402,-1896,21.1,FALSE,0,FALSE,15842,18618,1896,23.2
TRUE,TRUE,0,FALSE,16144,18236,1594,19.9,FALSE,1,TRUE,14550,17759,-1594,25.7
TRUE,TRUE,0,FALSE,18248,19067,1989,23.1,FALSE,1,TRUE,16259,17961,-1989,21.5
TRUE,FALSE,1,FALSE,18710,20305,3467,21,TRUE,0,FALSE,15243,16347,-3467,19.3
FALSE,TRUE,1,FALSE,14733,17627,-2267,22.4,FALSE,1,TRUE,17000,20173,2267,24.4
FALSE,TRUE,0,FALSE,15386,16591,-1739,18.8,FALSE,1,FALSE,17125,17417,1739,22.2
FALSE,FALSE,0,FALSE,15812,17291,-950,22.7,TRUE,1,TRUE,16762,17231,950,23.3
FALSE,FALSE,0,FALSE,15553,18934,-1449,24.4,TRUE,0,FALSE,17002,19283,1449,25
FALSE,FALSE,0,FALSE,16549,18284,611,20.5,TRUE,1,TRUE,15938,16942,-611,20.3
TRUE,TRUE,1,FALSE,16348,17866,-720,22.5,FALSE,1,TRUE,17068,19074,720,24.8
FALSE,FALSE,1,FALSE,16115,18971,516,23.7,TRUE,0,FALSE,15599,16486,-516,21.3
TRUE,TRUE,0,FALSE,17814,18330,2154,25.2,FALSE,1,FALSE,15660,18305,-2154,19.7
FALSE,TRUE,0,FALSE,16884,19682,-1474,22,FALSE,1,TRUE,18358,19861,1474,22.8
FALSE,FALSE,0,FALSE,16038,16019,-3674,20.9,TRUE,2,TRUE,19712,19117,3674,20.5
TRUE,FALSE,0,FALSE,18198,17647,1549,22,TRUE,0,FALSE,16649,18201,-1549,22
FALSE,FALSE,0,FALSE,15827,17607,-2683,24.5,TRUE,1,TRUE,18510,19990,2683,23.4
TRUE,FALSE,0,FALSE,16421,18708,267,22.4,TRUE,1,TRUE,16154,18760,-267,24.1
TRUE,TRUE,0,FALSE,18107,18643,1417,21,FALSE,0,FALSE,16690,18151,-1417,19.9
TRUE,TRUE,1,FALSE,18821,19339,4074,25.9,FALSE,0,FALSE,14747,16497,-4074,18.9
FALSE,FALSE,1,TRUE,16063,17688,-1571,19.2,TRUE,0,FALSE,17634,18818,1571,26
TRUE,TRUE,1,FALSE,19376,19330,2068,24.1,FALSE,0,FALSE,17308,18172,-2068,20.4
FALSE,TRUE,0,FALSE,18345,18508,1959,21.8,FALSE,2,TRUE,16386,17609,-1959,19.8
TRUE,FALSE,0,FALSE,16239,17856,36,20,TRUE,0,FALSE,16203,16757,-36,21.5
TRUE,TRUE,0,FALSE,17596,19125,2031,21.1,FALSE,1,FALSE,15565,18009,-2031,23
TRUE,TRUE,1,FALSE,16655,17121,1054,21.4,FALSE,1,TRUE,15601,17188,-1054,21.4
TRUE,TRUE,0,FALSE,17623,19660,724,23.3,FALSE,1,TRUE,16899,18392,-724,22.3
FALSE,FALSE,1,TRUE,17326,17581,54,18.8,TRUE,0,FALSE,17272,17902,-54,19.3
TRUE,TRUE,1,TRUE,16628,17323,2050,23,FALSE,0,FALSE,14578,16636,-2050,19.5
TRUE,FALSE,0,FALSE,15863,17012,46,22.1,TRUE,0,FALSE,15817,16131,-46,19.1
TRUE,TRUE,1,FALSE,18698,20094,2078,25.9,FALSE,1,TRUE,16620,18036,-2078,20.7
TRUE,TRUE,0,FALSE,21087,20108,5260,21.5,FALSE,1,TRUE,15827,17475,-5260,19.3
FALSE,FALSE,1,TRUE,15689,17576,-2253,23.6,TRUE,0,FALSE,17942,19374,2253,23.8
TRUE,FALSE,0,FALSE,14795,16396,204,20.8,TRUE,1,TRUE,14591,17848,-204,22.3
TRUE,TRUE,2,TRUE,21747,19828,5742,24.4,FALSE,0,FALSE,16005,16353,-5742,19
FALSE,TRUE,0,FALSE,18103,19519,2683,24.7,FALSE,1,TRUE,15420,17779,-2683,24.1
TRUE,TRUE,2,TRUE,20822,18683,5040,23.7,FALSE,0,FALSE,15782,16002,-5040,18.7
FALSE,FALSE,0,FALSE,15881,17469,76,23.9,TRUE,1,TRUE,15805,17371,-76,24.9
TRUE,FALSE,0,FALSE,17342,19169,811,26.3,TRUE,0,FALSE,16531,17668,-811,19.9
FALSE,TRUE,1,FALSE,16583,18071,2191,24.4,FALSE,1,TRUE,14392,16931,-2191,21.8
TRUE,TRUE,2,TRUE,18544,18246,3046,21.3,FALSE,0,FALSE,15498,17084,-3046,19.8
TRUE,FALSE,0,FALSE,17023,19264,671,25.5,TRUE,0,FALSE,16352,18460,-671,23.1
FALSE,TRUE,0,FALSE,16190,18041,-158,23.4,FALSE,1,TRUE,16348,18108,158,21.7
TRUE,FALSE,0,FALSE,17965,18483,2584,21,TRUE,0,FALSE,15381,16210,-2584,22
TRUE,TRUE,0,FALSE,16932,17955,1059,23.9,FALSE,1,FALSE,15873,17036,-1059,19.2
FALSE,TRUE,0,FALSE,17793,18074,-1761,19.9,FALSE,2,TRUE,19554,18037,1761,20.6
FALSE,TRUE,1,TRUE,18096,17875,1827,21.3,FALSE,1,FALSE,16269,16903,-1827,16.7
FALSE,FALSE,0,FALSE,16317,16985,-2448,20.5,TRUE,1,TRUE,18765,18961,2448,23.8
TRUE,FALSE,1,TRUE,15049,17666,-2088,21.8,TRUE,0,FALSE,17137,18536,2088,24
FALSE,TRUE,1,TRUE,18997,17998,1373,23.7,FALSE,0,FALSE,17624,17941,-1373,22.7
FALSE,TRUE,0,FALSE,17098,18682,1733,22.9,FALSE,1,TRUE,15365,17820,-1733,20.6
TRUE,TRUE,2,TRUE,16459,17550,-335,19,FALSE,0,FALSE,16794,17763,335,20.9
TRUE,FALSE,0,FALSE,18129,20257,2915,25,TRUE,1,TRUE,15214,16998,-2915,19.3
FALSE,FALSE,0,FALSE,14459,16596,-2499,20.2,TRUE,1,TRUE,16958,18466,2499,23.8
TRUE,FALSE,0,FALSE,16373,16941,-1343,23.7,TRUE,1,TRUE,17716,18202,1343,19.5
FALSE,FALSE,1,TRUE,16645,18070,-742,23.1,TRUE,0,FALSE,17387,18820,742,22.3
TRUE,FALSE,1,FALSE,14010,16322,-3047,18.7,TRUE,1,TRUE,17057,16934,3047,21.5
FALSE,FALSE,0,FALSE,14780,17765,-1828,24.9,TRUE,1,TRUE,16608,18911,1828,23
FALSE,TRUE,1,FALSE,16740,18257,-1784,23.4,FALSE,1,TRUE,18524,19146,1784,25.1
FALSE,TRUE,1,TRUE,16812,17939,-260,22.6,FALSE,0,FALSE,17072,18308,260,23.3
FALSE,TRUE,0,FALSE,16667,18043,1465,22.3,FALSE,1,TRUE,15202,17842,-1465,21.8
TRUE,FALSE,0,FALSE,17954,19474,2427,20.1,TRUE,0,FALSE,15527,17109,-2427,22.4
TRUE,TRUE,1,TRUE,19278,19529,4230,22.6,FALSE,0,FALSE,15048,16320,-4230,18.6
FALSE,FALSE,0,FALSE,14784,15775,-3584,17.3,TRUE,0,FALSE,18368,19449,3584,21.1
FALSE,FALSE,0,FALSE,14290,17459,-3260,20.4,TRUE,1,TRUE,17550,18519,3260,22.1
TRUE,TRUE,0,FALSE,16759,17756,988,18.3,FALSE,2,TRUE,15771,17175,-988,19.8
TRUE,FALSE,0,FALSE,16929,19477,1398,23.2,TRUE,0,FALSE,15531,17675,-1398,23.9
FALSE,TRUE,1,FALSE,14839,17590,-986,20.5,FALSE,1,TRUE,15825,19484,986,25
TRUE,TRUE,0,FALSE,16820,17719,439,22.3,FALSE,1,TRUE,16381,18243,-439,21.4
FALSE,TRUE,2,TRUE,18010,20078,2120,22.4,FALSE,0,FALSE,15890,17983,-2120,22.9
FALSE,TRUE,1,TRUE,16409,16448,1642,22.8,FALSE,1,FALSE,14767,17533,-1642,20.4
FALSE,TRUE,1,TRUE,17456,17732,1480,26.1,FALSE,0,FALSE,15976,17011,-1480,20.9
FALSE,FALSE,0,FALSE,17235,19413,750,25.1,TRUE,0,FALSE,16485,18546,-750,23
TRUE,TRUE,1,FALSE,16934,19205,1714,22.8,FALSE,1,TRUE,15220,17836,-1714,22.9
FALSE,TRUE,0,FALSE,15109,18112,-1493,21.3,FALSE,1,TRUE,16602,18494,1493,23
TRUE,TRUE,1,TRUE,16898,17534,599,22.6,FALSE,1,FALSE,16299,17267,-599,20.3
TRUE,TRUE,0,FALSE,19237,18874,981,20.9,FALSE,0,FALSE,18256,18505,-981,23.3
TRUE,FALSE,0,FALSE,16525,17494,67,19.1,TRUE,0,FALSE,16458,17797,-67,22.8
FALSE,TRUE,0,FALSE,14452,15418,-1404,18.6,FALSE,1,TRUE,15856,17714,1404,22.8
TRUE,FALSE,1,TRUE,17463,18601,2337,22.9,TRUE,0,FALSE,15126,16451,-2337,20.4
FALSE,FALSE,0,FALSE,18695,18459,601,22.5,TRUE,0,FALSE,18094,18307,-601,19.9
FALSE,FALSE,1,FALSE,15360,16644,-829,22,TRUE,1,TRUE,16189,17876,829,23.2
TRUE,FALSE,0,FALSE,17626,18770,2511,21.9,TRUE,2,TRUE,15115,15168,-2511,16.2
TRUE,FALSE,0,FALSE,15429,18085,39,23.8,TRUE,1,TRUE,15390,18386,-39,23.8
TRUE,TRUE,1,TRUE,15271,18226,-455,23.6,FALSE,0,FALSE,15726,18993,455,25.8
TRUE,FALSE,2,TRUE,14961,17746,-2377,21,TRUE,0,FALSE,17338,20459,2377,26.9
TRUE,TRUE,0,FALSE,23424,18730,11467,22,FALSE,0,FALSE,11957,10465,-11467,11.7
FALSE,TRUE,0,FALSE,16983,18675,-125,19.8,FALSE,1,TRUE,17108,19154,125,20.8
FALSE,TRUE,0,FALSE,17490,19737,2880,25.9,FALSE,0,FALSE,14610,16706,-2880,21.5
FALSE,TRUE,0,FALSE,18863,18943,2789,19.5,FALSE,0,FALSE,16074,18358,-2789,19.2
TRUE,TRUE,1,TRUE,18259,19685,2254,21.8,FALSE,0,FALSE,16005,18130,-2254,21.5
TRUE,TRUE,1,TRUE,17939,18687,3246,22,FALSE,0,FALSE,14693,18278,-3246,23.5
FALSE,FALSE,1,TRUE,14695,18082,-1766,20,TRUE,0,FALSE,16461,18721,1766,25.9
FALSE,TRUE,1,TRUE,14299,15937,-4376,20.7,FALSE,1,FALSE,18675,19602,4376,20.6
TRUE,FALSE,1,TRUE,17328,19304,2357,22.8,TRUE,0,FALSE,14971,17102,-2357,22.2
TRUE,FALSE,1,TRUE,17299,18277,2079,21.3,TRUE,0,FALSE,15220,16906,-2079,19.3
TRUE,FALSE,1,TRUE,18541,18196,4362,21,TRUE,0,FALSE,14179,15207,-4362,17.6
FALSE,FALSE,0,FALSE,14854,17513,-3330,25,TRUE,1,TRUE,18184,19768,3330,24.8
FALSE,TRUE,2,TRUE,17816,18626,1488,20.9,FALSE,0,FALSE,16328,17534,-1488,22.5
FALSE,FALSE,0,FALSE,17482,18618,-561,23.3,TRUE,0,FALSE,18043,19107,561,22.4
TRUE,FALSE,1,FALSE,19754,18453,1379,22.7,TRUE,1,TRUE,18375,18207,-1379,21.5
TRUE,TRUE,1,TRUE,17928,17767,1250,21.7,FALSE,0,FALSE,16678,17470,-1250,19.2
TRUE,FALSE,1,TRUE,16273,19013,464,23.7,TRUE,1,FALSE,15809,17630,-464,23.5
TRUE,FALSE,0,FALSE,16473,17992,-628,20.4,TRUE,1,TRUE,17101,18574,628,21.8
TRUE,FALSE,0,FALSE,16033,17043,-2746,20.7,TRUE,0,FALSE,18779,17870,2746,20.2
FALSE,TRUE,0,FALSE,18002,17743,-2340,17.8,FALSE,1,TRUE,20342,20094,2340,22
TRUE,TRUE,1,TRUE,19360,19057,3034,23.8,FALSE,0,FALSE,16326,17421,-3034,18.3
FALSE,FALSE,0,FALSE,14777,17674,-1664,23.1,TRUE,1,FALSE,16441,18664,1664,23.6
FALSE,FALSE,0,FALSE,16738,17657,-1428,19.9,TRUE,1,TRUE,18166,18328,1428,20.1
TRUE,TRUE,1,TRUE,17070,18583,1451,22.3,FALSE,0,FALSE,15619,17142,-1451,19.9
FALSE,TRUE,0,FALSE,16995,17908,-1666,21.7,FALSE,1,TRUE,18661,18667,1666,24.3
TRUE,FALSE,1,TRUE,17896,18474,1076,21.5,TRUE,0,FALSE,16820,17186,-1076,22.2
TRUE,FALSE,0,FALSE,15186,18537,-35,23.6,TRUE,0,FALSE,15221,17425,35,23.6
FALSE,TRUE,0,FALSE,17294,19906,2480,24.6,FALSE,0,FALSE,14814,16738,-2480,21.8
TRUE,TRUE,1,TRUE,16443,18538,1717,23.8,FALSE,0,FALSE,14726,18030,-1717,19.7
FALSE,FALSE,0,FALSE,15420,16502,-692,21,TRUE,2,TRUE,16112,17106,692,19.3
TRUE,FALSE,0,FALSE,14979,17553,-1171,23.7,TRUE,0,FALSE,16150,18049,1171,25.1
TRUE,TRUE,1,TRUE,16984,17114,469,20.5,FALSE,1,FALSE,16515,17869,-469,23.3
TRUE,FALSE,1,TRUE,16580,17570,-334,20.7,TRUE,0,FALSE,16914,18973,334,22.8
TRUE,TRUE,1,TRUE,14529,17655,924,24.1,FALSE,1,FALSE,13605,16373,-924,21.5
TRUE,TRUE,0,FALSE,16616,17294,-827,21.8,FALSE,0,FALSE,17443,18275,827,24.3
TRUE,TRUE,1,TRUE,15199,17382,-1631,23.5,FALSE,1,FALSE,16830,18720,1631,20.6
FALSE,FALSE,0,FALSE,16240,18554,-2184,20.5,TRUE,1,TRUE,18424,19852,2184,25
FALSE,TRUE,1,TRUE,15719,16209,-833,17.2,FALSE,0,FALSE,16552,17762,833,20.1
TRUE,TRUE,1,TRUE,17231,17898,-1471,19.3,FALSE,0,FALSE,18702,19708,1471,21.3
TRUE,TRUE,1,TRUE,18945,18620,2542,23.4,FALSE,0,FALSE,16403,18095,-2542,23.1
TRUE,TRUE,1,TRUE,16779,18171,1468,22.4,FALSE,1,FALSE,15311,17976,-1468,21.2
TRUE,FALSE,1,FALSE,17993,20973,2782,25.3,TRUE,1,TRUE,15211,16548,-2782,22.1
FALSE,FALSE,1,FALSE,15782,16191,-2323,18.2,TRUE,1,TRUE,18105,18635,2323,18.5
TRUE,FALSE,1,TRUE,17910,20300,2786,21.1,TRUE,0,FALSE,15124,17103,-2786,17.5
FALSE,FALSE,0,FALSE,17319,18310,2209,25.3,TRUE,2,TRUE,15110,16670,-2209,15.9
TRUE,TRUE,2,TRUE,17788,19185,4961,25.6,FALSE,0,FALSE,12827,15594,-4961,20.2
TRUE,FALSE,1,TRUE,16304,15338,-61,18.2,TRUE,0,FALSE,16365,17076,61,21.9
FALSE,FALSE,1,FALSE,15438,19325,-38,21.3,TRUE,1,TRUE,15476,17310,38,21.8
TRUE,FALSE,0,FALSE,18879,19472,1912,21.9,TRUE,1,TRUE,16967,17786,-1912,19.7
TRUE,TRUE,0,FALSE,16987,18078,2407,23.5,FALSE,2,TRUE,14580,17535,-2407,16.8
TRUE,TRUE,0,FALSE,15740,18504,1078,20.1,FALSE,1,TRUE,14662,16074,-1078,15.8
FALSE,FALSE,1,TRUE,15375,18057,-1489,22,TRUE,0,FALSE,16864,20201,1489,23
FALSE,FALSE,0,FALSE,16658,17588,-2184,19.2,TRUE,1,TRUE,18842,19921,2184,20.2
TRUE,TRUE,0,FALSE,18130,18640,3905,21.6,FALSE,1,TRUE,14225,17134,-3905,17.3
FALSE,FALSE,1,TRUE,13486,16382,-1433,20,TRUE,0,FALSE,14919,16776,1433,24.1
FALSE,FALSE,0,FALSE,13421,17265,-3543,22.1,TRUE,1,TRUE,16964,19002,3543,24.2
FALSE,TRUE,1,TRUE,14587,14862,-3541,17.1,FALSE,0,FALSE,18128,18980,3541,21.8
FALSE,FALSE,0,FALSE,15741,18215,-425,22.4,TRUE,1,TRUE,16166,18499,425,22.8
FALSE,FALSE,0,FALSE,18098,19504,2730,21.2,TRUE,1,TRUE,15368,16436,-2730,21.5
TRUE,FALSE,1,TRUE,18695,19263,4298,24.5,TRUE,1,FALSE,14397,16964,-4298,19
FALSE,TRUE,0,FALSE,15549,18169,-1841,22.8,FALSE,0,FALSE,17390,18526,1841,22.3
TRUE,FALSE,1,TRUE,17951,18502,3022,22.6,TRUE,0,FALSE,14929,15871,-3022,20.9
FALSE,TRUE,1,TRUE,18428,18214,3117,21.8,FALSE,0,FALSE,15311,16469,-3117,25.4
TRUE,TRUE,1,TRUE,16466,18740,2489,20.5,FALSE,0,FALSE,13977,16376,-2489,19.4
TRUE,FALSE,1,TRUE,17056,18608,3515,23.2,TRUE,1,FALSE,13541,16452,-3515,20.8
TRUE,TRUE,1,TRUE,18017,19071,1937,21,FALSE,0,FALSE,16080,18305,-1937,20.9
TRUE,FALSE,0,FALSE,22745,17394,4999,20.5,TRUE,1,TRUE,17746,16300,-4999,17.5
FALSE,FALSE,0,FALSE,13998,17086,-5086,20.7,TRUE,1,TRUE,19084,20370,5086,25.8
FALSE,FALSE,0,FALSE,18012,19569,1194,23.9,TRUE,1,TRUE,16818,17518,-1194,22.1
FALSE,TRUE,0,FALSE,15840,17440,923,21.1,FALSE,1,TRUE,14917,16612,-923,23.5
TRUE,TRUE,2,TRUE,17784,17328,1500,22.3,FALSE,0,FALSE,16284,18596,-1500,23.3
TRUE,FALSE,2,TRUE,18167,18502,2691,22.2,TRUE,0,FALSE,15476,15917,-2691,23.4
TRUE,TRUE,1,TRUE,18795,20241,4498,26,FALSE,0,FALSE,14297,16871,-4498,22.6
TRUE,FALSE,2,TRUE,17999,19381,2711,21.4,TRUE,0,FALSE,15288,17221,-2711,21.3
TRUE,FALSE,1,TRUE,17381,19539,1300,23.4,TRUE,0,FALSE,16081,17756,-1300,22.7
FALSE,FALSE,0,FALSE,14194,14858,-5553,19.5,TRUE,1,FALSE,19747,19084,5553,23.3
FALSE,FALSE,0,FALSE,15732,16582,17,21.8,TRUE,0,FALSE,15715,17596,-17,24.8
TRUE,TRUE,0,FALSE,18335,17921,2498,23.8,FALSE,0,FALSE,15837,17189,-2498,19.4
TRUE,TRUE,1,FALSE,17785,17509,1323,20.2,FALSE,1,TRUE,16462,17326,-1323,18.1
TRUE,FALSE,1,TRUE,16911,19106,2265,21.7,TRUE,0,FALSE,14646,16714,-2265,17.8
TRUE,TRUE,0,FALSE,21442,20440,5956,23.2,FALSE,0,FALSE,15486,15872,-5956,18.5
FALSE,FALSE,0,FALSE,14652,18395,-1075,23.5,TRUE,1,TRUE,15727,18384,1075,23.3
TRUE,FALSE,0,FALSE,16936,17513,-301,21.5,TRUE,1,TRUE,17237,17442,301,18.7
FALSE,TRUE,0,FALSE,15821,17419,-3364,20.8,FALSE,1,FALSE,19185,19409,3364,23
TRUE,FALSE,1,TRUE,17863,19967,3109,25.7,TRUE,0,FALSE,14754,16960,-3109,20.4
TRUE,FALSE,1,TRUE,20300,19812,3309,19.2,TRUE,1,FALSE,16991,17209,-3309,19.4
FALSE,TRUE,0,FALSE,15964,19695,-226,20.6,FALSE,1,TRUE,16190,18723,226,20.8
FALSE,TRUE,1,TRUE,18172,17184,1390,19.1,FALSE,0,FALSE,16782,16747,-1390,18.1
FALSE,FALSE,0,FALSE,15662,16109,-3983,19.1,TRUE,1,TRUE,19645,17893,3983,21.8
FALSE,FALSE,0,FALSE,12863,16182,-5961,17.7,TRUE,1,TRUE,18824,20315,5961,24.4
TRUE,TRUE,1,TRUE,19236,20585,2249,23.1,FALSE,0,FALSE,16987,18105,-2249,21.9
FALSE,TRUE,0,FALSE,16500,18352,-981,24.9,FALSE,2,TRUE,17481,19457,981,19.3
TRUE,FALSE,0,FALSE,15292,17578,-1774,25.2,TRUE,1,TRUE,17066,20154,1774,26.7
TRUE,TRUE,0,FALSE,19677,17356,6581,21.7,FALSE,0,FALSE,13096,13407,-6581,13.2
FALSE,FALSE,0,FALSE,15660,18016,-2602,20.1,TRUE,1,TRUE,18262,18566,2602,19.7
TRUE,FALSE,0,FALSE,15639,17326,-2608,22.7,TRUE,0,FALSE,18247,18652,2608,19.8
TRUE,TRUE,2,TRUE,16746,18699,1066,24.7,FALSE,0,FALSE,15680,19259,-1066,23.9
TRUE,FALSE,0,FALSE,15042,16868,-3052,18.9,TRUE,1,TRUE,18094,17643,3052,20.1
FALSE,FALSE,0,FALSE,13496,16421,-2452,18.6,TRUE,1,TRUE,15948,18843,2452,25.5
FALSE,FALSE,2,TRUE,17421,17858,-1330,21.7,TRUE,0,FALSE,18751,17480,1330,21.7
FALSE,TRUE,0,FALSE,15696,16453,-2942,19.5,FALSE,0,FALSE,18638,18238,2942,21.2
FALSE,FALSE,1,TRUE,15577,17552,-546,22,TRUE,0,FALSE,16123,19022,546,22.9
TRUE,TRUE,1,FALSE,17563,18068,268,19,FALSE,0,FALSE,17295,17279,-268,23.4
FALSE,FALSE,0,FALSE,15387,16280,-501,19.6,TRUE,0,FALSE,15888,17214,501,21
FALSE,TRUE,0,FALSE,14612,16340,-2541,24.2,FALSE,1,TRUE,17153,19892,2541,22
FALSE,TRUE,2,TRUE,17898,19411,942,23.2,FALSE,0,FALSE,16956,18111,-942,24.5
TRUE,FALSE,1,TRUE,18376,18388,653,23.8,TRUE,0,FALSE,17723,17926,-653,20.4
FALSE,FALSE,0,FALSE,17235,18992,2203,21.4,TRUE,1,TRUE,15032,16588,-2203,20.5
FALSE,FALSE,0,FALSE,13736,16381,-3593,18.8,TRUE,2,TRUE,17329,18897,3593,22.7
FALSE,TRUE,0,FALSE,16818,16676,283,18.3,FALSE,1,TRUE,16535,16511,-283,21.9
TRUE,FALSE,0,FALSE,19950,18520,3657,21.2,TRUE,1,TRUE,16293,15234,-3657,15.6
FALSE,FALSE,0,FALSE,16840,18528,793,20.9,TRUE,1,TRUE,16047,18067,-793,23.2
FALSE,FALSE,0,FALSE,13961,14440,-4731,16.8,TRUE,0,FALSE,18692,17257,4731,20.6
FALSE,TRUE,2,TRUE,15404,16706,-1332,20.3,FALSE,0,FALSE,16736,18704,1332,20.4
TRUE,TRUE,1,TRUE,15481,17409,-253,19.1,FALSE,0,FALSE,15734,17298,253,23.4
TRUE,FALSE,1,TRUE,16751,18674,832,23.9,TRUE,0,FALSE,15919,18123,-832,22.5
TRUE,TRUE,1,TRUE,18447,20232,1745,24.3,FALSE,0,FALSE,16702,18466,-1745,24
TRUE,FALSE,0,FALSE,16983,17858,-355,22.7,TRUE,1,TRUE,17338,18418,355,21.8
FALSE,FALSE,1,TRUE,14596,17298,-1883,20.4,TRUE,0,FALSE,16479,18429,1883,25.4
TRUE,TRUE,0,FALSE,16622,19176,2061,23.5,FALSE,0,FALSE,14561,17862,-2061,21.9
TRUE,FALSE,0,FALSE,16730,17780,-828,20.8,TRUE,0,FALSE,17558,19035,828,23.3
FALSE,TRUE,0,FALSE,18073,21032,2364,23.9,FALSE,0,FALSE,15709,18648,-2364,23.3
TRUE,FALSE,1,FALSE,18622,18509,2962,23,TRUE,1,TRUE,15660,17353,-2962,18.1
FALSE,TRUE,2,TRUE,16730,19072,178,19.8,FALSE,0,FALSE,16552,18648,-178,24.5
TRUE,FALSE,0,FALSE,15724,15533,-3798,16.3,TRUE,1,FALSE,19522,17870,3798,22.2
FALSE,FALSE,0,FALSE,16161,16954,-3761,21.3,TRUE,2,TRUE,19922,19429,3761,24.1
FALSE,TRUE,0,FALSE,16175,17305,684,25.3,FALSE,0,FALSE,15491,17779,-684,23.2
FALSE,FALSE,0,FALSE,15355,17119,-2215,20.4,TRUE,2,TRUE,17570,19233,2215,24
TRUE,TRUE,0,FALSE,18504,19016,3446,20.6,FALSE,1,TRUE,15058,17457,-3446,22.1
FALSE,FALSE,1,FALSE,17147,17510,-1546,19.4,TRUE,1,TRUE,18693,18557,1546,24.4
TRUE,FALSE,2,TRUE,16616,19052,1384,25.3,TRUE,0,FALSE,15232,18851,-1384,24.1
TRUE,TRUE,1,TRUE,15471,19583,708,20.6,FALSE,0,FALSE,14763,17743,-708,22.8
FALSE,TRUE,0,FALSE,17075,18691,-1075,23,FALSE,1,TRUE,18150,19851,1075,23.2
FALSE,FALSE,1,FALSE,14519,17122,-3798,22.3,TRUE,1,TRUE,18317,20072,3798,22.6
TRUE,TRUE,1,TRUE,18664,20054,3326,23.3,FALSE,0,FALSE,15338,17053,-3326,21.5
FALSE,FALSE,0,FALSE,14768,17244,-2337,15.7,TRUE,1,TRUE,17105,18402,2337,21.7
TRUE,TRUE,1,TRUE,15859,18955,-898,25,FALSE,0,FALSE,16757,19610,898,19.3
FALSE,FALSE,0,FALSE,19432,19488,2939,23.2,TRUE,0,FALSE,16493,17852,-2939,20.3
TRUE,FALSE,0,FALSE,15412,17502,-3768,21.1,TRUE,2,TRUE,19180,19613,3768,24.6
FALSE,FALSE,0,FALSE,15306,17560,-1171,22,TRUE,0,FALSE,16477,17571,1171,21.1
FALSE,FALSE,0,FALSE,16377,17958,-2167,22.8,TRUE,1,FALSE,18544,19405,2167,21.6
TRUE,TRUE,1,TRUE,16563,18469,498,19.9,FALSE,0,FALSE,16065,18225,-498,20.9
TRUE,TRUE,1,FALSE,18879,19552,4513,22.2,FALSE,0,FALSE,14366,15669,-4513,19.5
FALSE,TRUE,0,FALSE,14656,15475,-4201,18.6,FALSE,1,TRUE,18857,20257,4201,21.6
FALSE,FALSE,0,FALSE,13129,16126,-4800,18.4,TRUE,0,FALSE,17929,17434,4800,21.8
TRUE,FALSE,2,TRUE,16256,17985,2050,21.8,TRUE,0,FALSE,14206,16151,-2050,21.7
FALSE,FALSE,0,FALSE,15179,17410,-657,23.7,TRUE,2,TRUE,15836,17491,657,23.7
TRUE,TRUE,0,FALSE,17384,18045,2245,24.1,FALSE,1,TRUE,15139,17741,-2245,22.3
TRUE,TRUE,1,TRUE,18280,19206,4254,20.9,FALSE,0,FALSE,14026,16147,-4254,20.4
FALSE,TRUE,1,FALSE,18253,19481,1156,20.3,FALSE,0,FALSE,17097,17770,-1156,22.1
FALSE,FALSE,1,TRUE,14722,18209,-455,25.4,TRUE,1,FALSE,15177,18210,455,26.3
TRUE,FALSE,0,FALSE,18593,20037,2277,25.2,TRUE,1,TRUE,16316,18407,-2277,20.3
TRUE,TRUE,1,TRUE,17345,18944,928,23.6,FALSE,0,FALSE,16417,19072,-928,19.8
FALSE,TRUE,1,TRUE,18804,19826,4607,27.2,FALSE,0,FALSE,14197,16851,-4607,19.7
TRUE,FALSE,1,TRUE,15597,18348,200,24.9,TRUE,0,FALSE,15397,17816,-200,20.3
TRUE,TRUE,1,TRUE,16460,17623,1068,22,FALSE,0,FALSE,15392,18359,-1068,20.9
FALSE,TRUE,1,FALSE,16156,18605,1639,23.3,FALSE,1,TRUE,14517,17297,-1639,24.1
TRUE,FALSE,1,FALSE,16463,17675,1305,22.3,TRUE,0,FALSE,15158,16643,-1305,24.4
TRUE,TRUE,1,TRUE,17541,19979,1764,23.2,FALSE,0,FALSE,15777,17393,-1764,20.8
FALSE,FALSE,1,FALSE,15020,16196,-2620,18.2,TRUE,1,TRUE,17640,17233,2620,19.7
TRUE,FALSE,0,FALSE,14687,16647,-2142,21.6,TRUE,1,TRUE,16829,18389,2142,22.3
FALSE,FALSE,0,FALSE,15502,16609,-938,22.7,TRUE,1,TRUE,16440,17338,938,23.9
TRUE,TRUE,0,FALSE,17413,19603,2646,25.7,FALSE,1,TRUE,14767,17298,-2646,21
FALSE,FALSE,1,TRUE,16001,18372,-54,26.5,TRUE,0,FALSE,16055,17756,54,22.3
FALSE,FALSE,1,FALSE,17040,18774,293,22.8,TRUE,1,TRUE,16747,18056,-293,20.4
FALSE,TRUE,1,TRUE,15920,17523,-1138,23.4,FALSE,0,FALSE,17058,18548,1138,23.7
TRUE,FALSE,2,TRUE,17408,17809,360,20.7,TRUE,0,FALSE,17048,17712,-360,19.1
FALSE,FALSE,0,FALSE,16394,18234,-127,25.1,TRUE,1,TRUE,16521,17719,127,19.4
FALSE,TRUE,0,FALSE,13408,16175,-3160,19.2,FALSE,1,TRUE,16568,19274,3160,22.4
TRUE,TRUE,0,FALSE,17697,16356,118,20.8,FALSE,1,TRUE,17579,18400,-118,20
TRUE,FALSE,1,TRUE,15708,17799,-3205,21.9,TRUE,1,FALSE,18913,20286,3205,23.1
TRUE,FALSE,0,FALSE,18409,17925,-206,21.9,TRUE,0,FALSE,18615,17635,206,17.4
FALSE,TRUE,0,FALSE,12622,13759,-6954,18.5,FALSE,2,TRUE,19576,19390,6954,22.8
TRUE,TRUE,0,FALSE,17503,18043,2471,20.4,FALSE,1,TRUE,15032,17216,-2471,21.2
TRUE,FALSE,1,FALSE,16936,18077,-96,23.6,TRUE,1,TRUE,17032,17250,96,21.1
FALSE,FALSE,0,FALSE,14622,18174,-1567,20.6,TRUE,1,TRUE,16189,18887,1567,23.7
TRUE,FALSE,0,FALSE,16266,17825,920,21.3,TRUE,0,FALSE,15346,16727,-920,21
FALSE,FALSE,1,TRUE,15240,17456,-1279,24.3,TRUE,0,FALSE,16519,18578,1279,24.4
TRUE,FALSE,1,FALSE,16911,18891,681,24.7,TRUE,1,TRUE,16230,16844,-681,19.6
FALSE,FALSE,1,FALSE,14055,17109,-3872,20.4,TRUE,0,FALSE,17927,20282,3872,21.4
TRUE,TRUE,2,TRUE,17227,20568,1329,21.8,FALSE,0,FALSE,15898,18943,-1329,20.7
FALSE,TRUE,0,FALSE,15525,16079,-1784,19.8,FALSE,0,FALSE,17309,19017,1784,22.7
FALSE,FALSE,0,FALSE,14199,16214,-7911,16.7,TRUE,1,TRUE,22110,19649,7911,22.3
TRUE,FALSE,1,TRUE,16610,17963,828,26.3,TRUE,0,FALSE,15782,18767,-828,24.3
FALSE,FALSE,0,FALSE,14307,16295,-3418,21.1,TRUE,2,TRUE,17725,20028,3418,23.4
TRUE,TRUE,0,FALSE,16646,18209,2522,23.6,FALSE,1,TRUE,14124,16053,-2522,21
FALSE,FALSE,1,FALSE,15316,17001,-2882,21.5,TRUE,1,TRUE,18198,18424,2882,21.8
TRUE,FALSE,0,FALSE,14834,16539,-2714,19.1,TRUE,1,FALSE,17548,16966,2714,19.8
TRUE,TRUE,1,TRUE,16027,18775,276,23.1,FALSE,0,FALSE,15751,18881,-276,23.9
FALSE,FALSE,0,FALSE,15631,18436,-704,25.2,TRUE,1,TRUE,16335,19464,704,22.9
FALSE,TRUE,1,TRUE,15114,16890,-1210,19.3,FALSE,0,FALSE,16324,18954,1210,21.3
TRUE,TRUE,2,TRUE,16929,19425,1101,26.3,FALSE,0,FALSE,15828,18278,-1101,24.2
TRUE,TRUE,1,TRUE,17828,18635,371,18.4,FALSE,1,FALSE,17457,18121,-371,21.9
FALSE,FALSE,0,FALSE,14062,17156,-2226,21.9,TRUE,2,TRUE,16288,19798,2226,23.8
TRUE,TRUE,1,TRUE,15885,16411,-508,21.3,FALSE,0,FALSE,16393,17674,508,23.5
FALSE,FALSE,0,FALSE,13976,16595,-2971,21.1,TRUE,1,TRUE,16947,18518,2971,23.1
TRUE,FALSE,0,FALSE,16898,18746,734,21.3,TRUE,0,FALSE,16164,16780,-734,20.9
TRUE,FALSE,1,TRUE,16535,19103,956,20.6,TRUE,0,FALSE,15579,16927,-956,19.7
FALSE,TRUE,0,FALSE,16847,17476,1840,22.3,FALSE,1,TRUE,15007,17755,-1840,22.4
FALSE,FALSE,0,FALSE,15937,18739,-2138,21.9,TRUE,1,TRUE,18075,19729,2138,25.4
FALSE,FALSE,0,FALSE,13453,15565,-5403,21.5,TRUE,1,TRUE,18856,20169,5403,23.2
FALSE,FALSE,0,FALSE,17071,17610,-1763,20.5,TRUE,1,TRUE,18834,19794,1763,23.6
FALSE,FALSE,0,FALSE,16224,18247,-294,21.2,TRUE,0,FALSE,16518,17926,294,20.5
TRUE,TRUE,1,TRUE,19776,17806,2806,19.1,FALSE,0,FALSE,16970,18385,-2806,19.7
TRUE,TRUE,1,TRUE,17461,18412,3119,23.5,FALSE,1,FALSE,14342,17516,-3119,22.8
FALSE,FALSE,0,FALSE,16355,17876,-495,19.3,TRUE,1,TRUE,16850,16942,495,19.1
TRUE,TRUE,2,TRUE,17325,20228,2905,23.8,FALSE,0,FALSE,14420,17454,-2905,22.2
TRUE,TRUE,0,FALSE,16391,17744,-842,22.8,FALSE,1,TRUE,17233,18455,842,23.9
TRUE,TRUE,1,FALSE,16938,18241,1881,21.3,FALSE,0,FALSE,15057,17606,-1881,22.4
FALSE,FALSE,0,FALSE,15316,15976,-2883,18.4,TRUE,1,TRUE,18199,19288,2883,19.4
FALSE,FALSE,0,FALSE,12300,14201,-5394,17.1,TRUE,2,TRUE,17694,19238,5394,24.6
FALSE,FALSE,1,FALSE,15373,16348,-4432,21.7,TRUE,1,TRUE,19805,19987,4432,22.6
FALSE,FALSE,0,FALSE,15196,17168,52,26.2,TRUE,1,FALSE,15144,18102,-52,24.6
TRUE,FALSE,1,FALSE,17184,16943,1835,20.6,TRUE,1,TRUE,15349,16550,-1835,21.7
TRUE,TRUE,0,FALSE,16135,16458,173,21.3,FALSE,1,TRUE,15962,15997,-173,19.6
FALSE,FALSE,0,FALSE,14658,16832,-1957,21,TRUE,1,TRUE,16615,16410,1957,20.9
TRUE,TRUE,0,FALSE,15420,16822,-1633,23.5,FALSE,1,FALSE,17053,19740,1633,25.3
TRUE,TRUE,0,FALSE,18130,19442,2635,22,FALSE,0,FALSE,15495,16911,-2635,19.5
TRUE,FALSE,1,TRUE,15119,18281,-326,24.9,TRUE,1,FALSE,15445,18575,326,22.8
TRUE,TRUE,1,TRUE,17101,18332,3157,20.7,FALSE,0,FALSE,13944,16433,-3157,23.9
TRUE,TRUE,0,FALSE,15832,17807,-386,22.5,FALSE,0,FALSE,16218,18582,386,24.4
TRUE,TRUE,1,FALSE,15088,16413,-1685,20.9,FALSE,0,FALSE,16773,19315,1685,23.5
TRUE,TRUE,0,FALSE,16213,18235,1962,24.7,FALSE,1,FALSE,14251,17505,-1962,21.2
TRUE,TRUE,1,FALSE,17300,19249,2298,22.3,FALSE,1,TRUE,15002,17677,-2298,24.8
TRUE,TRUE,0,FALSE,16818,18842,588,21.3,FALSE,1,TRUE,16230,17738,-588,23.2
FALSE,TRUE,0,FALSE,17163,17099,-2880,19,FALSE,0,FALSE,20043,19273,2880,21.3
TRUE,FALSE,1,FALSE,15522,18317,-1071,21.4,TRUE,1,TRUE,16593,18437,1071,24.6
FALSE,FALSE,1,TRUE,16991,17910,-1001,20.5,TRUE,0,FALSE,17992,18735,1001,22.5
TRUE,TRUE,0,FALSE,17556,18073,1253,22,FALSE,0,FALSE,16303,18308,-1253,19.1
TRUE,FALSE,0,FALSE,17359,18731,887,22.5,TRUE,0,FALSE,16472,18385,-887,23.7
FALSE,TRUE,0,FALSE,18849,18593,702,21.6,FALSE,1,TRUE,18147,18589,-702,18.2
TRUE,TRUE,0,FALSE,15260,17024,-1443,20.1,FALSE,1,TRUE,16703,18653,1443,21.2
TRUE,TRUE,0,FALSE,18307,19026,3113,24.4,FALSE,1,TRUE,15194,16742,-3113,21.3
FALSE,TRUE,1,TRUE,15363,15411,-2151,17.1,FALSE,0,FALSE,17514,16263,2151,19.9
FALSE,TRUE,0,FALSE,17543,19187,204,23.6,FALSE,1,TRUE,17339,19531,-204,23.7
TRUE,TRUE,1,TRUE,18513,17991,710,21.3,FALSE,0,FALSE,17803,17703,-710,19.1
TRUE,TRUE,0,FALSE,15913,16789,-483,19.7,FALSE,1,FALSE,16396,16469,483,18.7
TRUE,TRUE,1,TRUE,16605,18407,-643,19.9,FALSE,1,FALSE,17248,17899,643,24.1
FALSE,TRUE,1,TRUE,17641,16803,436,19.9,FALSE,0,FALSE,17205,16465,-436,20.7
TRUE,TRUE,0,FALSE,18564,19783,2005,21.2,FALSE,0,FALSE,16559,17778,-2005,23.6
TRUE,FALSE,0,FALSE,15588,17603,192,22.5,TRUE,2,TRUE,15396,17515,-192,24.1
TRUE,FALSE,1,TRUE,14722,16664,-675,18.7,TRUE,0,FALSE,15397,18680,675,18.5
FALSE,FALSE,0,FALSE,16531,16364,-869,20.2,TRUE,1,TRUE,17400,16037,869,21.9
FALSE,TRUE,1,TRUE,15471,17472,-390,23.3,FALSE,1,FALSE,15861,17974,390,24
TRUE,TRUE,1,FALSE,17271,18144,2369,24.6,FALSE,1,TRUE,14902,15899,-2369,19
TRUE,FALSE,1,TRUE,17351,19306,3251,23.5,TRUE,1,FALSE,14100,16370,-3251,21.3
FALSE,FALSE,1,FALSE,14869,17895,-1642,23.8,TRUE,1,TRUE,16511,18598,1642,22.4
FALSE,TRUE,0,FALSE,16534,17934,-1256,23.1,FALSE,1,FALSE,17790,18778,1256,23.5
TRUE,FALSE,1,FALSE,16226,18754,-1613,22.1,TRUE,1,TRUE,17839,18280,1613,21.5
TRUE,TRUE,1,TRUE,16847,19065,2341,22,FALSE,0,FALSE,14506,16762,-2341,21.4
TRUE,FALSE,0,FALSE,16583,17229,-1635,19.8,TRUE,1,TRUE,18218,19429,1635,21.1
FALSE,TRUE,0,FALSE,15573,18440,66,24.6,FALSE,2,TRUE,15507,18121,-66,23.3
TRUE,TRUE,0,FALSE,17770,19036,995,23.9,FALSE,0,FALSE,16775,16379,-995,15.5
FALSE,FALSE,0,FALSE,15850,18831,1207,23.3,TRUE,1,TRUE,14643,16946,-1207,22.9
TRUE,FALSE,0,FALSE,13756,16900,-3750,23.8,TRUE,2,TRUE,17506,20008,3750,24.4
FALSE,FALSE,0,FALSE,15192,16557,-3240,19.8,TRUE,0,FALSE,18432,18926,3240,25.2
TRUE,TRUE,1,FALSE,17611,18414,1706,22.3,FALSE,1,TRUE,15905,17175,-1706,23.3
TRUE,FALSE,0,FALSE,14796,17144,-2183,20.9,TRUE,1,TRUE,16979,18169,2183,23.6
TRUE,TRUE,2,TRUE,18519,20004,5222,23.5,FALSE,0,FALSE,13297,16535,-5222,18.7
TRUE,FALSE,0,FALSE,15750,18310,755,23.3,TRUE,1,TRUE,14995,18599,-755,24.8
FALSE,FALSE,0,FALSE,15967,17259,-2068,20.5,TRUE,0,FALSE,18035,17223,2068,21
FALSE,TRUE,0,FALSE,16777,18587,295,21.2,FALSE,1,TRUE,16482,17730,-295,21.8
TRUE,TRUE,0,FALSE,17145,17795,2563,20.4,FALSE,1,TRUE,14582,16069,-2563,18.1
TRUE,TRUE,0,FALSE,17309,19092,763,25.3,FALSE,1,TRUE,16546,18067,-763,21.7
TRUE,TRUE,1,TRUE,19219,18673,2346,22.9,FALSE,0,FALSE,16873,16897,-2346,17.7
TRUE,TRUE,0,FALSE,16164,18306,113,22.6,FALSE,1,TRUE,16051,18824,-113,22.3
FALSE,FALSE,1,TRUE,17220,18678,135,20.2,TRUE,0,FALSE,17085,17884,-135,22.8
TRUE,TRUE,2,TRUE,14527,17128,-1063,19.5,FALSE,0,FALSE,15590,17065,1063,21.7
FALSE,FALSE,1,FALSE,14355,17580,59,21.7,TRUE,1,TRUE,14296,16431,-59,20.5
TRUE,TRUE,1,FALSE,18672,19616,3579,24.3,FALSE,1,TRUE,15093,17143,-3579,21.2
TRUE,TRUE,0,FALSE,16481,18268,563,22.1,FALSE,1,TRUE,15918,19395,-563,21.7
FALSE,FALSE,0,FALSE,18376,17877,2595,22.5,TRUE,2,TRUE,15781,17101,-2595,20.1
FALSE,FALSE,0,FALSE,13899,15844,-6134,19.5,TRUE,1,TRUE,20033,22258,6134,23.6
TRUE,TRUE,1,TRUE,16345,17851,1284,23,FALSE,1,FALSE,15061,19465,-1284,20
TRUE,TRUE,1,TRUE,17964,18073,4042,21.6,FALSE,0,FALSE,13922,13105,-4042,17.2
FALSE,FALSE,0,FALSE,14591,17823,-817,23,TRUE,1,TRUE,15408,19112,817,25.3
TRUE,FALSE,2,TRUE,16486,18617,1118,25.6,TRUE,0,FALSE,15368,17746,-1118,22.4
TRUE,TRUE,0,FALSE,16636,18741,1833,22.5,FALSE,1,TRUE,14803,17842,-1833,20.1
TRUE,FALSE,0,FALSE,17585,19376,3052,27,TRUE,0,FALSE,14533,15795,-3052,20
FALSE,FALSE,1,TRUE,16233,17101,-3559,21.6,TRUE,1,FALSE,19792,20924,3559,23.6
FALSE,FALSE,0,FALSE,16830,17100,-1619,20.6,TRUE,1,FALSE,18449,16835,1619,15.8
TRUE,TRUE,1,FALSE,19257,18701,3766,22.4,FALSE,0,FALSE,15491,15700,-3766,18.6
TRUE,TRUE,0,FALSE,16977,18682,1807,23.1,FALSE,1,FALSE,15170,17606,-1807,23.7
TRUE,FALSE,2,TRUE,15517,17441,697,21.5,TRUE,0,FALSE,14820,16490,-697,21.1
FALSE,TRUE,2,TRUE,17810,16753,532,15,FALSE,0,FALSE,17278,17636,-532,25.5
FALSE,FALSE,0,FALSE,15454,16466,-824,21,TRUE,0,FALSE,16278,17442,824,24
TRUE,TRUE,1,TRUE,18048,19291,4294,18.5,FALSE,0,FALSE,13754,16447,-4294,17.6
FALSE,TRUE,1,TRUE,16938,18493,206,22.3,FALSE,1,FALSE,16732,18946,-206,23.4
TRUE,FALSE,0,FALSE,18587,19265,2851,22.3,TRUE,1,TRUE,15736,18125,-2851,22.6
TRUE,FALSE,0,FALSE,13711,15114,-4331,18,TRUE,2,TRUE,18042,18871,4331,21.6
TRUE,TRUE,0,FALSE,17687,18128,4039,23.2,FALSE,0,FALSE,13648,16309,-4039,21.7
FALSE,TRUE,1,FALSE,17170,18330,2241,23.8,FALSE,0,FALSE,14929,17691,-2241,21.4
FALSE,FALSE,0,FALSE,17055,19405,567,23,TRUE,1,TRUE,16488,18151,-567,20.1
FALSE,FALSE,0,FALSE,16760,16804,226,19.3,TRUE,0,FALSE,16534,17761,-226,21.3
FALSE,FALSE,1,TRUE,15680,18107,-3865,19.7,TRUE,0,FALSE,19545,19886,3865,22.3
FALSE,FALSE,0,FALSE,13670,15417,-6282,16.6,TRUE,1,TRUE,19952,19718,6282,23.3
TRUE,FALSE,1,TRUE,20305,19846,3072,23.9,TRUE,0,FALSE,17233,16285,-3072,18.9
TRUE,TRUE,1,TRUE,16209,18162,55,23.1,FALSE,0,FALSE,16154,20080,-55,22.8
TRUE,FALSE,2,TRUE,20860,19749,4299,23.9,TRUE,0,FALSE,16561,16112,-4299,19.2
FALSE,FALSE,1,FALSE,16180,17769,1338,21.7,TRUE,0,FALSE,14842,16730,-1338,21.6
TRUE,TRUE,0,FALSE,17608,18800,2185,21,FALSE,0,FALSE,15423,17845,-2185,23.1
FALSE,FALSE,1,TRUE,17248,16433,-109,18.5,TRUE,0,FALSE,17357,16275,109,19.5
TRUE,FALSE,0,FALSE,17025,18219,1196,21.1,TRUE,1,TRUE,15829,18304,-1196,22.8
FALSE,TRUE,0,FALSE,14451,16229,-3028,22.5,FALSE,1,FALSE,17479,19784,3028,22.3
FALSE,TRUE,0,FALSE,17169,17752,734,21,FALSE,0,FALSE,16435,18717,-734,20.7
FALSE,FALSE,2,TRUE,15908,18702,-1035,20.8,TRUE,0,FALSE,16943,19144,1035,22.9
TRUE,FALSE,0,FALSE,14948,17592,-3669,22.6,TRUE,1,TRUE,18617,20081,3669,25.5
FALSE,FALSE,0,FALSE,16941,17520,-1833,20.3,TRUE,2,TRUE,18774,17913,1833,21
TRUE,TRUE,1,TRUE,18410,18561,714,25.3,FALSE,0,FALSE,17696,18737,-714,23.2
FALSE,FALSE,1,TRUE,15288,18328,-1652,21.8,TRUE,0,FALSE,16940,17862,1652,22.4
FALSE,TRUE,0,FALSE,13446,15362,-4840,20.4,FALSE,2,TRUE,18286,19892,4840,25.8
TRUE,TRUE,1,FALSE,18802,17609,3247,23.6,FALSE,0,FALSE,15555,17033,-3247,20.7
TRUE,TRUE,0,FALSE,16398,17792,1343,23.4,FALSE,1,TRUE,15055,17273,-1343,22.5
FALSE,FALSE,0,FALSE,15778,18381,36,21.9,TRUE,0,FALSE,15742,18706,-36,22
FALSE,FALSE,0,FALSE,14634,18284,-879,21.3,TRUE,1,TRUE,15513,18030,879,24.8
TRUE,FALSE,0,FALSE,14269,15867,-3941,20.3,TRUE,1,TRUE,18210,19490,3941,23.9
FALSE,TRUE,1,TRUE,16031,17016,-987,21.5,FALSE,0,FALSE,17018,18721,987,22.3
FALSE,FALSE,0,FALSE,13817,14829,-3294,16.7,TRUE,1,TRUE,17111,17552,3294,20.6
FALSE,FALSE,1,TRUE,16280,17350,-2198,19.9,TRUE,0,FALSE,18478,18983,2198,18.8
TRUE,FALSE,0,FALSE,14823,17193,-3916,19.3,TRUE,2,TRUE,18739,18593,3916,24.5
TRUE,TRUE,0,FALSE,17174,18159,-1342,18.9,FALSE,1,TRUE,18516,19437,1342,23.8
TRUE,FALSE,1,FALSE,17349,19375,1942,19.7,TRUE,1,TRUE,15407,17717,-1942,22.8
FALSE,FALSE,1,FALSE,13235,15728,-2466,18.7,TRUE,1,TRUE,15701,17177,2466,22.1
FALSE,FALSE,0,FALSE,16231,16805,-1535,17.9,TRUE,1,TRUE,17766,17643,1535,19.2
TRUE,FALSE,2,TRUE,15255,18352,-965,22.8,TRUE,0,FALSE,16220,17694,965,22.3
TRUE,FALSE,0,FALSE,15337,18920,-1676,23.5,TRUE,0,FALSE,17013,19452,1676,22.8
TRUE,TRUE,0,FALSE,18050,17022,2847,22,FALSE,1,TRUE,15203,15463,-2847,17.6
TRUE,TRUE,1,TRUE,15730,18012,1383,24,FALSE,0,FALSE,14347,17352,-1383,22.1
FALSE,FALSE,0,FALSE,14752,17798,-439,23,TRUE,2,TRUE,15191,18781,439,22.2
TRUE,FALSE,0,FALSE,17578,19495,1989,21.3,TRUE,1,TRUE,15589,16995,-1989,21.8
TRUE,FALSE,1,TRUE,15397,17110,-775,22.2,TRUE,0,FALSE,16172,17503,775,19.1
FALSE,TRUE,1,FALSE,17012,17507,872,22.5,FALSE,1,TRUE,16140,17722,-872,21.4
TRUE,TRUE,1,FALSE,14886,18605,762,23.4,FALSE,1,TRUE,14124,17035,-762,20.9
TRUE,TRUE,2,TRUE,19592,19231,3214,23.5,FALSE,0,FALSE,16378,16970,-3214,18.4
FALSE,FALSE,0,FALSE,17550,18791,175,23.7,TRUE,1,TRUE,17375,17802,-175,22.1
TRUE,TRUE,0,FALSE,17106,17550,1138,22.6,FALSE,1,FALSE,15968,16992,-1138,20.2
FALSE,TRUE,1,FALSE,17977,18586,1062,25.5,FALSE,1,TRUE,16915,18141,-1062,20.3
TRUE,TRUE,1,TRUE,16953,19642,2348,24.8,FALSE,0,FALSE,14605,16964,-2348,22.5
FALSE,FALSE,0,FALSE,13550,15932,-4770,18.3,TRUE,1,TRUE,18320,19343,4770,23.6
FALSE,FALSE,0,FALSE,15224,16862,-3595,18.9,TRUE,1,TRUE,18819,18835,3595,22.1
TRUE,TRUE,1,TRUE,18582,19702,3881,24.3,FALSE,0,FALSE,14701,16293,-3881,21.7
TRUE,TRUE,1,FALSE,21202,21701,6577,23.8,FALSE,0,FALSE,14625,17275,-6577,18.8
FALSE,TRUE,2,TRUE,16066,17944,-1247,22.4,FALSE,0,FALSE,17313,17544,1247,22.5
TRUE,FALSE,1,TRUE,18077,17869,1669,23.5,TRUE,0,FALSE,16408,17756,-1669,21.8
FALSE,FALSE,1,TRUE,16042,19220,580,25.5,TRUE,1,FALSE,15462,18511,-580,23.1
TRUE,TRUE,0,FALSE,14781,16316,165,20.9,FALSE,1,TRUE,14616,16049,-165,18.5
FALSE,TRUE,1,FALSE,15904,15750,-1597,19.8,FALSE,1,TRUE,17501,17071,1597,17
TRUE,FALSE,0,FALSE,15281,16663,-736,21.1,TRUE,1,TRUE,16017,18189,736,22.9
FALSE,FALSE,0,FALSE,14795,16491,-3431,19,TRUE,1,TRUE,18226,17511,3431,22.1
TRUE,FALSE,0,FALSE,15065,17306,-2560,23.9,TRUE,2,TRUE,17625,19368,2560,24.2
TRUE,TRUE,2,TRUE,19011,17878,3451,20.1,FALSE,0,FALSE,15560,17676,-3451,22.4
FALSE,TRUE,0,FALSE,16366,18102,1980,23.7,FALSE,1,TRUE,14386,16325,-1980,20.3
TRUE,FALSE,0,FALSE,16709,19029,-629,22.7,TRUE,0,FALSE,17338,18849,629,22.3
TRUE,FALSE,1,FALSE,15798,18818,-361,23.1,TRUE,1,TRUE,16159,18147,361,24.8
TRUE,TRUE,1,TRUE,15239,18919,742,21.8,FALSE,0,FALSE,14497,16015,-742,18.2
TRUE,TRUE,1,TRUE,17287,18312,886,22.4,FALSE,0,FALSE,16401,17628,-886,22.8
TRUE,TRUE,0,FALSE,14788,16201,-166,22.3,FALSE,0,FALSE,14954,17647,166,18.8
TRUE,TRUE,1,TRUE,16736,18814,433,21.7,FALSE,0,FALSE,16303,19137,-433,26.2
FALSE,TRUE,1,TRUE,16876,17943,31,22.3,FALSE,0,FALSE,16845,18415,-31,20.7
FALSE,TRUE,1,TRUE,14563,15835,-3004,19.6,FALSE,0,FALSE,17567,19695,3004,22.9
FALSE,FALSE,0,FALSE,15912,16609,1034,23.6,TRUE,1,TRUE,14878,17582,-1034,16.9
FALSE,FALSE,1,FALSE,16624,18064,1060,20.8,TRUE,1,TRUE,15564,15268,-1060,19
TRUE,TRUE,1,TRUE,19018,19294,3126,20.9,FALSE,0,FALSE,15892,15499,-3126,16.2
TRUE,FALSE,0,FALSE,16682,19047,-257,20.9,TRUE,1,TRUE,16939,17668,257,20.9
FALSE,TRUE,2,TRUE,17249,18964,1095,23.9,FALSE,0,FALSE,16154,18196,-1095,24.7
TRUE,FALSE,0,FALSE,15727,18903,-84,24.7,TRUE,0,FALSE,15811,18682,84,21.6
FALSE,FALSE,0,FALSE,14962,18176,-1672,20.1,TRUE,0,FALSE,16634,20389,1672,23.7
FALSE,TRUE,1,TRUE,17390,19841,1644,23.9,FALSE,1,FALSE,15746,18854,-1644,25
TRUE,TRUE,1,TRUE,16632,17520,-1069,19.1,FALSE,0,FALSE,17701,18107,1069,20.2
TRUE,TRUE,1,TRUE,16706,17948,1352,23.1,FALSE,0,FALSE,15354,18029,-1352,23
FALSE,TRUE,0,FALSE,14969,16983,816,24.6,FALSE,2,TRUE,14153,17440,-816,21.3
TRUE,FALSE,2,TRUE,16630,19373,-159,25.1,TRUE,0,FALSE,16789,19579,159,24.4
FALSE,TRUE,0,FALSE,17037,18710,-1896,24.3,FALSE,1,TRUE,18933,20466,1896,24.3
FALSE,TRUE,0,FALSE,16729,19694,2248,23.1,FALSE,0,FALSE,14481,16531,-2248,20.6
TRUE,TRUE,0,FALSE,16281,17527,128,23.3,FALSE,1,TRUE,16153,17895,-128,22.3
TRUE,TRUE,0,FALSE,16375,18060,1389,22.6,FALSE,2,TRUE,14986,16445,-1389,19.8
TRUE,TRUE,1,TRUE,16849,20518,1116,23.4,FALSE,0,FALSE,15733,17684,-1116,23.7
TRUE,TRUE,1,FALSE,18195,19078,4358,22,FALSE,0,FALSE,13837,14753,-4358,20.7
TRUE,FALSE,0,FALSE,15825,18247,-306,23.5,TRUE,1,TRUE,16131,19200,306,22.7
TRUE,TRUE,0,FALSE,18483,19419,2915,19.9,FALSE,0,FALSE,15568,16896,-2915,20.9
FALSE,FALSE,0,FALSE,18270,18940,1927,23.4,TRUE,2,TRUE,16343,18445,-1927,22.4
FALSE,TRUE,0,FALSE,17372,17545,1491,20.2,FALSE,2,TRUE,15881,16444,-1491,20.6
TRUE,FALSE,0,FALSE,19582,19381,4267,22.8,TRUE,0,FALSE,15315,16617,-4267,20
TRUE,FALSE,0,FALSE,16823,19226,1409,22.6,TRUE,0,FALSE,15414,16459,-1409,18.8
TRUE,FALSE,2,TRUE,18264,20134,2188,23.4,TRUE,0,FALSE,16076,17418,-2188,22.7
FALSE,FALSE,0,FALSE,15142,16713,-3107,21.1,TRUE,1,TRUE,18249,18400,3107,22.2
FALSE,TRUE,1,TRUE,16396,18166,-1640,21.1,FALSE,0,FALSE,18036,19073,1640,25
TRUE,FALSE,0,FALSE,15434,18097,-1806,23.5,TRUE,1,TRUE,17240,18323,1806,22.4
TRUE,TRUE,1,TRUE,18564,18738,4518,23.9,FALSE,0,FALSE,14046,17023,-4518,16.9
FALSE,FALSE,0,FALSE,17304,19455,1127,23.3,TRUE,1,TRUE,16177,17547,-1127,21.1
FALSE,TRUE,0,FALSE,17785,19422,2597,23.8,FALSE,1,TRUE,15188,16691,-2597,19.9
TRUE,TRUE,0,FALSE,17299,17445,2406,23.3,FALSE,0,FALSE,14893,15942,-2406,19.4
FALSE,FALSE,0,FALSE,15528,17206,-3546,23.5,TRUE,0,FALSE,19074,19125,3546,23.8
FALSE,TRUE,0,FALSE,16532,16932,1920,21.3,FALSE,1,TRUE,14612,15792,-1920,15.5
FALSE,TRUE,1,TRUE,16279,18119,1079,22.7,FALSE,0,FALSE,15200,17335,-1079,22.3
TRUE,TRUE,1,TRUE,19245,20286,3108,24.5,FALSE,0,FALSE,16137,17312,-3108,19.4
TRUE,FALSE,0,FALSE,14998,17794,-1431,24.6,TRUE,0,FALSE,16429,17525,1431,23
TRUE,FALSE,1,TRUE,15391,16901,-1595,18.2,TRUE,0,FALSE,16986,17808,1595,20.1
FALSE,TRUE,0,FALSE,18459,17481,1536,22.4,FALSE,1,TRUE,16923,16857,-1536,19.7
FALSE,FALSE,0,FALSE,15535,18068,-1608,21.4,TRUE,2,TRUE,17143,18640,1608,22
TRUE,TRUE,0,FALSE,17226,19043,2955,26.9,FALSE,1,FALSE,14271,16950,-2955,22.4
TRUE,TRUE,1,FALSE,15743,16662,-720,21.2,FALSE,1,TRUE,16463,18195,720,22.9
FALSE,FALSE,0,FALSE,14659,16878,-492,23.3,TRUE,0,FALSE,15151,16789,492,17.5
FALSE,TRUE,1,FALSE,15674,16123,-3579,17.6,FALSE,1,TRUE,19253,19356,3579,20.3
TRUE,TRUE,0,FALSE,20699,19768,7721,24.9,FALSE,0,FALSE,12978,14578,-7721,20
FALSE,TRUE,1,TRUE,17631,18612,3436,20.1,FALSE,1,FALSE,14195,16852,-3436,20.6
TRUE,TRUE,1,TRUE,16282,19492,813,22.5,FALSE,0,FALSE,15469,17579,-813,22.5
FALSE,FALSE,2,TRUE,14249,16596,-3144,22,TRUE,0,FALSE,17393,19831,3144,25.5
FALSE,TRUE,1,TRUE,18159,18557,-48,20.7,FALSE,0,FALSE,18207,18075,48,15.9
FALSE,FALSE,1,TRUE,15666,16073,-2468,20.8,TRUE,1,FALSE,18134,18625,2468,23.1
FALSE,FALSE,0,FALSE,13305,15657,-4849,19.6,TRUE,2,TRUE,18154,20120,4849,27.6
TRUE,TRUE,1,TRUE,16563,18392,1786,21.5,FALSE,0,FALSE,14777,18397,-1786,20.1
TRUE,TRUE,1,TRUE,18339,18855,4128,21.6,FALSE,0,FALSE,14211,16151,-4128,15.8
TRUE,FALSE,0,FALSE,17666,16963,-184,19.3,TRUE,0,FALSE,17850,17798,184,23.4
FALSE,FALSE,1,TRUE,15315,17674,-2881,18.8,TRUE,1,FALSE,18196,18655,2881,23
TRUE,FALSE,0,FALSE,18628,18625,2863,23.9,TRUE,0,FALSE,15765,15993,-2863,20.7
TRUE,FALSE,1,TRUE,17342,18792,2783,24.8,TRUE,0,FALSE,14559,16948,-2783,19.7
FALSE,TRUE,0,FALSE,18000,17798,1157,21,FALSE,0,FALSE,16843,17971,-1157,19
TRUE,FALSE,1,FALSE,15318,17968,-942,23.5,TRUE,1,TRUE,16260,17848,942,26.3
TRUE,TRUE,1,FALSE,17795,19812,1367,23.7,FALSE,1,TRUE,16428,18192,-1367,21.7
FALSE,TRUE,0,FALSE,16351,18380,-2929,23.4,FALSE,1,TRUE,19280,18534,2929,23.3
FALSE,TRUE,1,TRUE,14842,17067,-1992,18.4,FALSE,1,FALSE,16834,18789,1992,20.9
TRUE,TRUE,0,FALSE,15439,18214,567,25,FALSE,1,FALSE,14872,17046,-567,22.5
TRUE,TRUE,1,FALSE,16994,19700,446,22.5,FALSE,1,TRUE,16548,17547,-446,23.4
FALSE,TRUE,0,FALSE,16250,17026,-1661,15.7,FALSE,0,FALSE,17911,18395,1661,24.3
FALSE,FALSE,0,FALSE,14789,16856,-5163,22.1,TRUE,1,TRUE,19952,20281,5163,23.7
TRUE,FALSE,0,FALSE,14830,16901,-572,18.4,TRUE,1,TRUE,15402,17537,572,19.4
FALSE,FALSE,0,FALSE,14252,16567,-4219,22.9,TRUE,2,TRUE,18471,19823,4219,26.8
FALSE,FALSE,1,TRUE,17300,18747,-2604,22.9,TRUE,0,FALSE,19904,20836,2604,21.4
FALSE,FALSE,1,TRUE,17391,18031,-3064,20.2,TRUE,1,FALSE,20455,18568,3064,18
FALSE,FALSE,0,FALSE,15600,16412,-2689,16.9,TRUE,1,TRUE,18289,17978,2689,22.3
TRUE,TRUE,1,TRUE,16134,16880,857,18.3,FALSE,0,FALSE,15277,16858,-857,21
TRUE,FALSE,0,FALSE,18470,19952,3418,23.1,TRUE,0,FALSE,15052,16344,-3418,21.4
FALSE,TRUE,1,TRUE,15298,17728,-1317,23.3,FALSE,0,FALSE,16615,18600,1317,20.4
TRUE,TRUE,1,TRUE,15849,17178,1236,22,FALSE,0,FALSE,14613,16700,-1236,20.2
TRUE,FALSE,1,FALSE,15793,16329,-1254,21.5,TRUE,0,FALSE,17047,16622,1254,18.8
TRUE,TRUE,1,TRUE,14392,17199,337,22.2,FALSE,0,FALSE,14055,17075,-337,19.7
FALSE,FALSE,0,FALSE,15508,17029,-745,19.3,TRUE,1,TRUE,16253,16873,745,25
TRUE,FALSE,1,TRUE,15467,18928,-2524,22.8,TRUE,0,FALSE,17991,19304,2524,25.2
TRUE,FALSE,1,TRUE,19904,18106,2685,17.9,TRUE,0,FALSE,17219,16501,-2685,20.5
TRUE,FALSE,0,FALSE,17206,16783,-621,21.6,TRUE,0,FALSE,17827,17211,621,21.1
FALSE,FALSE,0,FALSE,16600,18623,-335,19.5,TRUE,0,FALSE,16935,18361,335,20.6
TRUE,FALSE,1,TRUE,16154,18329,-773,23.5,TRUE,1,FALSE,16927,17720,773,20.1
FALSE,FALSE,1,TRUE,15218,16410,-2060,19.8,TRUE,0,FALSE,17278,19260,2060,24
TRUE,TRUE,1,FALSE,15135,17507,-2497,17.6,FALSE,1,TRUE,17632,18883,2497,23.1
FALSE,FALSE,0,FALSE,14980,17697,-2958,21,TRUE,1,TRUE,17938,19324,2958,26.8
TRUE,FALSE,1,TRUE,16283,19282,-30,20.6,TRUE,0,FALSE,16313,17855,30,21.7
TRUE,FALSE,0,FALSE,14706,15747,207,20.3,TRUE,0,FALSE,14499,17627,-207,24.2
FALSE,FALSE,1,TRUE,18508,18693,1442,20.5,TRUE,0,FALSE,17066,18371,-1442,22.5
FALSE,TRUE,1,FALSE,18324,18932,2215,22.7,FALSE,0,FALSE,16109,16617,-2215,20.3
FALSE,FALSE,0,FALSE,14969,16183,-4486,20.8,TRUE,0,FALSE,19455,21517,4486,22.2
TRUE,FALSE,1,TRUE,15116,18375,-434,22.8,TRUE,0,FALSE,15550,17702,434,24.6
FALSE,FALSE,0,FALSE,15752,18629,-717,21.7,TRUE,0,FALSE,16469,18621,717,21.8
FALSE,TRUE,1,FALSE,19056,18501,4312,23.3,FALSE,1,TRUE,14744,17501,-4312,21.1
FALSE,FALSE,1,TRUE,16412,18935,980,22.3,TRUE,0,FALSE,15432,17399,-980,23.2
TRUE,TRUE,1,TRUE,17773,19376,2898,23.5,FALSE,0,FALSE,14875,17435,-2898,18.1
FALSE,FALSE,0,FALSE,14710,16797,-1799,22.7,TRUE,1,TRUE,16509,18739,1799,20.4
FALSE,TRUE,0,FALSE,17543,18113,304,19,FALSE,1,TRUE,17239,18415,-304,19.6
TRUE,FALSE,1,TRUE,15981,18320,354,21.9,TRUE,0,FALSE,15627,16855,-354,21.7
FALSE,TRUE,1,FALSE,17570,19555,124,23,FALSE,1,TRUE,17446,18896,-124,21.5
FALSE,FALSE,1,TRUE,14505,17362,-4531,21.6,TRUE,1,FALSE,19036,19687,4531,25.2
FALSE,FALSE,1,FALSE,17618,19203,1000,22.5,TRUE,1,TRUE,16618,18857,-1000,19.9
TRUE,FALSE,1,TRUE,18858,19797,878,21.4,TRUE,0,FALSE,17980,17615,-878,20.4
FALSE,FALSE,0,FALSE,15400,16910,-2564,21.9,TRUE,0,FALSE,17964,18428,2564,22.9
TRUE,TRUE,1,TRUE,17355,17548,1890,20.4,FALSE,0,FALSE,15465,16075,-1890,17.7
FALSE,TRUE,0,FALSE,15999,18110,497,21.1,FALSE,0,FALSE,15502,18853,-497,22.9
TRUE,TRUE,0,FALSE,18262,19248,2537,22.4,FALSE,1,TRUE,15725,16836,-2537,20.8
FALSE,TRUE,1,TRUE,15514,17211,-1640,18.5,FALSE,1,FALSE,17154,19050,1640,23.4
TRUE,TRUE,0,FALSE,16678,17929,1351,20.1,FALSE,1,TRUE,15327,17496,-1351,22.8
FALSE,TRUE,1,TRUE,16660,17964,850,24.1,FALSE,0,FALSE,15810,18062,-850,21.5
TRUE,FALSE,1,TRUE,17392,18794,2865,21.5,TRUE,0,FALSE,14527,16188,-2865,22.5
TRUE,TRUE,1,TRUE,16674,18431,2176,22.1,FALSE,0,FALSE,14498,16692,-2176,21.2
FALSE,TRUE,1,TRUE,15703,17235,-1678,21,FALSE,0,FALSE,17381,19666,1678,20.2
TRUE,TRUE,1,TRUE,16797,19788,2234,26.8,FALSE,0,FALSE,14563,17891,-2234,27.3
TRUE,TRUE,2,TRUE,17606,17803,290,22.7,FALSE,0,FALSE,17316,17326,-290,23.2
TRUE,FALSE,0,FALSE,15993,18112,-1607,22.6,TRUE,1,TRUE,17600,18327,1607,21.7
TRUE,FALSE,0,FALSE,16622,18996,753,20.6,TRUE,1,TRUE,15869,16946,-753,21.3
FALSE,FALSE,0,FALSE,15807,17244,239,22.1,TRUE,1,TRUE,15568,15963,-239,21.3
TRUE,FALSE,1,TRUE,18555,19740,2976,25,TRUE,0,FALSE,15579,18440,-2976,20.7
TRUE,TRUE,2,TRUE,18826,19835,5616,25.9,FALSE,0,FALSE,13210,15919,-5616,18.4
FALSE,FALSE,0,FALSE,14787,16543,-2404,18.5,TRUE,0,FALSE,17191,18556,2404,22.8
TRUE,TRUE,0,FALSE,18675,20603,2125,21.9,FALSE,1,TRUE,16550,18569,-2125,22.2
TRUE,TRUE,1,TRUE,17106,18424,450,23.1,FALSE,1,FALSE,16656,18643,-450,24.1
TRUE,TRUE,0,FALSE,16956,19155,-172,24.2,FALSE,1,TRUE,17128,18561,172,21.3
FALSE,FALSE,0,FALSE,13879,15363,-4267,18.5,TRUE,2,TRUE,18146,18752,4267,23.2
TRUE,FALSE,1,FALSE,15164,17014,-185,21.6,TRUE,1,TRUE,15349,18115,185,23.3
TRUE,TRUE,0,FALSE,16849,19849,2094,24.1,FALSE,0,FALSE,14755,17060,-2094,20.8
TRUE,FALSE,1,FALSE,16914,16785,302,18.4,TRUE,1,TRUE,16612,18743,-302,20.8
FALSE,FALSE,1,TRUE,16728,17494,102,23.1,TRUE,0,FALSE,16626,17429,-102,19.5
TRUE,FALSE,0,FALSE,16694,17192,370,22.7,TRUE,1,TRUE,16324,17100,-370,21.3
FALSE,FALSE,1,TRUE,15826,17837,-1177,23.5,TRUE,0,FALSE,17003,18994,1177,24.2
FALSE,FALSE,1,TRUE,15558,16462,-3180,20.3,TRUE,0,FALSE,18738,19733,3180,21.8
FALSE,FALSE,0,FALSE,14053,16510,-3045,16.9,TRUE,0,FALSE,17098,17320,3045,22.9
FALSE,FALSE,0,FALSE,20887,18795,2049,21.5,TRUE,2,TRUE,18838,18096,-2049,19.1
TRUE,TRUE,1,TRUE,15373,16354,-1323,22.8,FALSE,0,FALSE,16696,17776,1323,21.6
TRUE,TRUE,1,FALSE,17522,18612,2392,25.7,FALSE,0,FALSE,15130,18101,-2392,22.2
TRUE,FALSE,1,TRUE,17088,17650,262,17.9,TRUE,0,FALSE,16826,17879,-262,22.2
FALSE,FALSE,0,FALSE,16968,18303,423,23.1,TRUE,2,TRUE,16545,17985,-423,21.9
TRUE,FALSE,0,FALSE,17987,19698,1810,23.2,TRUE,1,FALSE,16177,17583,-1810,22.2
TRUE,FALSE,1,TRUE,16871,17798,-89,26.3,TRUE,0,FALSE,16960,17942,89,23.2
TRUE,TRUE,1,TRUE,19035,19600,4481,20.7,FALSE,0,FALSE,14554,15728,-4481,18.9
FALSE,FALSE,0,FALSE,13380,14784,-4446,18.8,TRUE,1,TRUE,17826,18487,4446,23.3
TRUE,TRUE,0,FALSE,15834,18253,324,24.8,FALSE,2,TRUE,15510,18827,-324,22
FALSE,FALSE,0,FALSE,15209,16799,-1517,20.8,TRUE,0,FALSE,16726,18130,1517,22.9
TRUE,TRUE,1,TRUE,16426,18180,2063,23.6,FALSE,0,FALSE,14363,17472,-2063,21
FALSE,FALSE,0,FALSE,15358,17610,-3019,21,TRUE,1,TRUE,18377,18458,3019,20.7
FALSE,TRUE,0,FALSE,15894,16813,-399,20.5,FALSE,1,TRUE,16293,17681,399,21.3
TRUE,FALSE,1,TRUE,14092,16918,-1999,20.1,TRUE,0,FALSE,16091,18959,1999,25.7
TRUE,TRUE,1,TRUE,17559,17788,3158,21.7,FALSE,0,FALSE,14401,16270,-3158,18.4
FALSE,FALSE,0,FALSE,15847,17815,647,24.1,TRUE,1,TRUE,15200,18525,-647,22.1
FALSE,FALSE,1,TRUE,15280,16614,-2034,22,TRUE,0,FALSE,17314,17685,2034,22
FALSE,FALSE,0,FALSE,18187,18454,299,22.3,TRUE,1,FALSE,17888,19505,-299,21.5
FALSE,TRUE,1,FALSE,15509,17265,-1335,22,FALSE,1,TRUE,16844,18407,1335,23
TRUE,FALSE,1,TRUE,16319,18982,1589,20.7,TRUE,0,FALSE,14730,17907,-1589,21.5
FALSE,FALSE,1,TRUE,14588,15647,-2627,20.7,TRUE,1,FALSE,17215,19727,2627,22.5
TRUE,FALSE,0,FALSE,16748,16907,-1579,17.8,TRUE,1,TRUE,18327,18622,1579,21.5
TRUE,FALSE,2,TRUE,16516,17456,366,18.4,TRUE,0,FALSE,16150,16860,-366,22.1
FALSE,TRUE,2,TRUE,17256,18265,1177,22.8,FALSE,0,FALSE,16079,18039,-1177,21.7
FALSE,FALSE,1,TRUE,16396,18419,-2,20.4,TRUE,0,FALSE,16398,17553,2,20.2
FALSE,FALSE,0,FALSE,14539,16271,-6139,16.5,TRUE,0,FALSE,20678,20819,6139,22.4
TRUE,FALSE,1,TRUE,14657,17306,-987,20.4,TRUE,0,FALSE,15644,17861,987,24.6
FALSE,FALSE,1,TRUE,18656,19253,42,22.7,TRUE,0,FALSE,18614,18587,-42,21.1
FALSE,TRUE,1,TRUE,16609,16960,-265,21.6,FALSE,0,FALSE,16874,19061,265,22.5
FALSE,FALSE,1,TRUE,15299,16493,-2489,19.6,TRUE,0,FALSE,17788,19321,2489,23.3
TRUE,TRUE,1,TRUE,16942,18645,2032,21.6,FALSE,0,FALSE,14910,16449,-2032,21
FALSE,FALSE,0,FALSE,15365,16848,-136,18.6,TRUE,0,FALSE,15501,17233,136,21.9
FALSE,TRUE,0,FALSE,16052,15330,-1825,15.9,FALSE,1,TRUE,17877,16788,1825,21.3
TRUE,FALSE,0,FALSE,16875,18652,-191,21.4,TRUE,1,TRUE,17066,18119,191,23
TRUE,TRUE,1,TRUE,16623,18555,1792,21.1,FALSE,1,FALSE,14831,19319,-1792,22.3
TRUE,TRUE,2,TRUE,16813,18065,70,20,FALSE,0,FALSE,16743,17557,-70,20.4
FALSE,TRUE,1,TRUE,16763,17386,-1469,22.1,FALSE,0,FALSE,18232,19813,1469,21.4
FALSE,FALSE,0,FALSE,14603,15446,-6185,18.1,TRUE,1,TRUE,20788,17774,6185,19.5
TRUE,TRUE,1,TRUE,18005,19501,2962,21,FALSE,0,FALSE,15043,16458,-2962,18.7
TRUE,FALSE,0,FALSE,15274,17169,-2538,22.8,TRUE,1,TRUE,17812,18900,2538,21.9
FALSE,FALSE,1,TRUE,15216,18663,99,25.1,TRUE,0,FALSE,15117,18837,-99,21.7
TRUE,TRUE,1,TRUE,17756,18394,2510,23.1,FALSE,0,FALSE,15246,17636,-2510,21.8
TRUE,FALSE,1,TRUE,17476,18428,1408,21.9,TRUE,0,FALSE,16068,17471,-1408,23.1
FALSE,TRUE,0,FALSE,18017,18434,2917,20.8,FALSE,0,FALSE,15100,17504,-2917,21
FALSE,TRUE,1,TRUE,15531,17915,-537,19.2,FALSE,0,FALSE,16068,17739,537,19.8
FALSE,TRUE,0,FALSE,14799,16562,-3590,20.7,FALSE,1,TRUE,18389,19841,3590,25.9
TRUE,TRUE,1,TRUE,18009,19630,3026,22.6,FALSE,0,FALSE,14983,17781,-3026,20.5
FALSE,FALSE,0,FALSE,16265,17407,-1195,21.7,TRUE,1,TRUE,17460,18899,1195,24.4
FALSE,FALSE,0,FALSE,15023,17293,-814,22.6,TRUE,1,FALSE,15837,17667,814,23.2
FALSE,TRUE,0,FALSE,17083,17538,67,18.3,FALSE,1,TRUE,17016,18358,-67,22.5
FALSE,FALSE,0,FALSE,15954,16521,-2527,19.2,TRUE,1,TRUE,18481,18714,2527,19.7
FALSE,TRUE,0,FALSE,16892,18225,-44,22.6,FALSE,1,TRUE,16936,17948,44,18.5
TRUE,FALSE,1,FALSE,14583,17525,262,24.4,TRUE,1,TRUE,14321,15882,-262,22.4
FALSE,FALSE,0,FALSE,16802,17626,-1599,24.3,TRUE,0,FALSE,18401,19516,1599,23.7
FALSE,TRUE,0,FALSE,16957,17005,-206,22,FALSE,0,FALSE,17163,18877,206,20.4
FALSE,TRUE,2,TRUE,15817,17992,-27,21.8,FALSE,0,FALSE,15844,18363,27,20.3
FALSE,TRUE,0,FALSE,17219,18160,-1213,24.1,FALSE,0,FALSE,18432,18929,1213,18.3
FALSE,TRUE,1,TRUE,15424,17357,-1933,21.1,FALSE,0,FALSE,17357,20263,1933,25.6
TRUE,TRUE,1,FALSE,16502,17726,342,19.8,FALSE,1,TRUE,16160,18170,-342,19.5
FALSE,FALSE,0,FALSE,16324,17213,-943,19.3,TRUE,1,TRUE,17267,17921,943,17.4
FALSE,FALSE,0,FALSE,14532,17477,-1021,21.7,TRUE,0,FALSE,15553,18916,1021,20.6
FALSE,FALSE,1,FALSE,14644,17550,-1367,22.2,TRUE,0,FALSE,16011,17962,1367,20.1
FALSE,FALSE,1,FALSE,16616,18633,-47,21.1,TRUE,1,TRUE,16663,18315,47,21.9
FALSE,FALSE,0,FALSE,14754,16591,-1769,23,TRUE,0,FALSE,16523,17436,1769,22.4
FALSE,FALSE,0,FALSE,14242,17184,-2954,21.2,TRUE,1,FALSE,17196,18434,2954,24.4
TRUE,FALSE,0,FALSE,17083,18346,2877,22.9,TRUE,1,TRUE,14206,16632,-2877,21.2
TRUE,TRUE,1,TRUE,19716,20456,5656,21.9,FALSE,0,FALSE,14060,17041,-5656,22.2
TRUE,FALSE,1,TRUE,18401,20273,3668,23.6,TRUE,1,FALSE,14733,15764,-3668,19.5
FALSE,TRUE,2,TRUE,17359,18754,1,22.1,FALSE,0,FALSE,17358,18870,-1,22.1
TRUE,FALSE,1,TRUE,17742,18795,2294,20.3,TRUE,0,FALSE,15448,16179,-2294,18.6
TRUE,FALSE,1,TRUE,14431,17984,-940,19.4,TRUE,0,FALSE,15371,18027,940,23.4
TRUE,FALSE,0,FALSE,18125,21102,2828,23.6,TRUE,1,TRUE,15297,18364,-2828,22.7
TRUE,TRUE,0,FALSE,17210,18131,1091,22,FALSE,0,FALSE,16119,17526,-1091,17.8
FALSE,TRUE,0,FALSE,15697,16449,-1237,19.6,FALSE,0,FALSE,16934,16734,1237,20.1
TRUE,FALSE,2,TRUE,14591,15636,-2658,17.7,TRUE,0,FALSE,17249,18964,2658,20.9
FALSE,FALSE,0,FALSE,14488,16390,-3152,19.7,TRUE,1,TRUE,17640,19144,3152,19.6
TRUE,TRUE,0,FALSE,18869,18526,4242,20.6,FALSE,0,FALSE,14627,16178,-4242,16.4
FALSE,TRUE,0,FALSE,16682,18272,598,23.6,FALSE,1,TRUE,16084,17898,-598,23.5
FALSE,FALSE,0,FALSE,15898,14230,-2787,13.1,TRUE,2,TRUE,18685,18447,2787,22.4
FALSE,FALSE,0,FALSE,15485,17335,-2650,19.1,TRUE,1,TRUE,18135,17723,2650,20.1
FALSE,TRUE,0,FALSE,16667,18874,-692,21.3,FALSE,1,TRUE,17359,19861,692,24.5
FALSE,TRUE,0,FALSE,16182,17509,-667,24.5,FALSE,2,TRUE,16849,18555,667,23.4
FALSE,TRUE,1,FALSE,16574,19529,803,23.5,FALSE,1,TRUE,15771,18672,-803,20.4
FALSE,FALSE,0,FALSE,14595,15064,-3619,16.1,TRUE,1,TRUE,18214,19075,3619,22.2
FALSE,FALSE,0,FALSE,18856,19293,3002,23.6,TRUE,2,TRUE,15854,16915,-3002,21.7
FALSE,TRUE,0,FALSE,14826,16636,-3607,18.5,FALSE,1,TRUE,18433,19592,3607,25.7
FALSE,FALSE,0,FALSE,16237,18980,-958,22.2,TRUE,2,TRUE,17195,19441,958,23.2
TRUE,FALSE,2,TRUE,18731,18165,2892,22.5,TRUE,0,FALSE,15839,16752,-2892,20.7
TRUE,TRUE,2,TRUE,15443,18156,-997,22,FALSE,0,FALSE,16440,18382,997,20.7
TRUE,FALSE,1,TRUE,16820,17746,472,22.1,TRUE,0,FALSE,16348,17320,-472,18.5
FALSE,FALSE,1,TRUE,14997,17630,-465,22.9,TRUE,0,FALSE,15462,18431,465,21.9
TRUE,FALSE,1,FALSE,16653,17618,23,22.7,TRUE,0,FALSE,16630,17312,-23,19.3
FALSE,FALSE,1,FALSE,17781,19251,3422,22.8,TRUE,1,TRUE,14359,16980,-3422,21.2
TRUE,TRUE,1,TRUE,17936,18452,3350,21.8,FALSE,0,FALSE,14586,16862,-3350,21.3
TRUE,TRUE,1,TRUE,16769,19760,1316,25.7,FALSE,0,FALSE,15453,18527,-1316,24.1
FALSE,TRUE,0,FALSE,16714,19411,91,22.6,FALSE,0,FALSE,16623,18613,-91,25.2
FALSE,FALSE,0,FALSE,13517,15501,-5338,18.7,TRUE,1,FALSE,18855,20946,5338,24.3
TRUE,FALSE,0,FALSE,15514,18750,-343,21.7,TRUE,1,TRUE,15857,18269,343,20.4
FALSE,FALSE,1,TRUE,16131,17436,874,22.3,TRUE,0,FALSE,15257,16618,-874,21.9
FALSE,TRUE,1,TRUE,15613,17932,-468,21.4,FALSE,0,FALSE,16081,19253,468,23
TRUE,TRUE,1,FALSE,16678,19110,1401,24.8,FALSE,1,TRUE,15277,17370,-1401,23.3
TRUE,TRUE,0,FALSE,17311,18763,2781,25.7,FALSE,0,FALSE,14530,17534,-2781,21.6
TRUE,TRUE,2,TRUE,16703,17483,1051,20.1,FALSE,0,FALSE,15652,16871,-1051,22.8
FALSE,FALSE,0,FALSE,12403,11921,-10329,15.2,TRUE,1,TRUE,22732,20452,10329,23.2
TRUE,TRUE,1,TRUE,15585,16636,-2864,20,FALSE,0,FALSE,18449,20127,2864,22.4
TRUE,FALSE,1,TRUE,16558,18174,241,23.8,TRUE,0,FALSE,16317,18537,-241,22.2
FALSE,TRUE,1,FALSE,18211,19027,1479,20.4,FALSE,1,TRUE,16732,19225,-1479,21.7
FALSE,TRUE,1,TRUE,15990,17803,-1425,19,FALSE,0,FALSE,17415,18871,1425,24.1
TRUE,FALSE,0,FALSE,15147,16605,-4559,18.8,TRUE,1,TRUE,19706,18456,4559,24.1
FALSE,FALSE,2,TRUE,17008,16893,1280,20.3,TRUE,0,FALSE,15728,16523,-1280,24.5
FALSE,TRUE,0,FALSE,15538,16787,-707,20.7,FALSE,0,FALSE,16245,17875,707,20.8
TRUE,TRUE,1,TRUE,17097,18614,620,22,FALSE,0,FALSE,16477,18942,-620,20.7
TRUE,FALSE,0,FALSE,17075,18491,1224,23.4,TRUE,2,TRUE,15851,17866,-1224,22.1
FALSE,FALSE,0,FALSE,16035,18455,-2691,18,TRUE,1,TRUE,18726,20651,2691,24.3
TRUE,TRUE,1,TRUE,17967,18074,3039,24,FALSE,0,FALSE,14928,17362,-3039,21.1
TRUE,TRUE,0,FALSE,17273,18297,381,20.8,FALSE,0,FALSE,16892,16726,-381,18.1
TRUE,TRUE,2,TRUE,14546,17721,305,23.2,FALSE,0,FALSE,14241,18164,-305,20.3
TRUE,FALSE,1,TRUE,14639,17316,-1767,23.7,TRUE,0,FALSE,16406,19396,1767,25.8
FALSE,FALSE,0,FALSE,16882,18988,-1261,19.1,TRUE,0,FALSE,18143,17702,1261,23.8
TRUE,TRUE,0,FALSE,20170,19190,5619,25.7,FALSE,1,TRUE,14551,15684,-5619,19.8
TRUE,TRUE,1,TRUE,20029,20123,6445,21.3,FALSE,0,FALSE,13584,15135,-6445,17.6
TRUE,TRUE,0,FALSE,17260,19375,1463,19.7,FALSE,0,FALSE,15797,18098,-1463,20.3
TRUE,TRUE,0,FALSE,18192,19823,2639,22.1,FALSE,0,FALSE,15553,18112,-2639,23
TRUE,TRUE,0,FALSE,17325,18380,3454,21.7,FALSE,1,TRUE,13871,16131,-3454,19.3
FALSE,FALSE,0,FALSE,16163,18244,-1828,21.8,TRUE,1,FALSE,17991,19654,1828,23.5
FALSE,TRUE,0,FALSE,16039,16809,-2168,17.9,FALSE,1,TRUE,18207,19632,2168,18.5
TRUE,TRUE,1,FALSE,15907,17910,-112,20.6,FALSE,0,FALSE,16019,17183,112,21.1
FALSE,TRUE,1,FALSE,17536,19146,4003,21.1,FALSE,0,FALSE,13533,15891,-4003,20.4
FALSE,TRUE,0,FALSE,18730,18011,175,20.8,FALSE,1,TRUE,18555,18543,-175,21.9
TRUE,TRUE,1,TRUE,16105,18285,2275,22.3,FALSE,0,FALSE,13830,16618,-2275,20.4
TRUE,TRUE,1,TRUE,15843,17751,1301,24.3,FALSE,0,FALSE,14542,16628,-1301,20.5
TRUE,TRUE,1,TRUE,20302,18149,7577,21.2,FALSE,0,FALSE,12725,15786,-7577,16.5
TRUE,FALSE,1,FALSE,20236,18603,6161,25.7,TRUE,1,TRUE,14075,13277,-6161,14.6
TRUE,TRUE,2,TRUE,17869,17341,664,19.3,FALSE,0,FALSE,17205,16826,-664,20.2
FALSE,FALSE,1,FALSE,14499,18406,-3079,20.1,TRUE,1,TRUE,17578,20222,3079,24.5
FALSE,FALSE,0,FALSE,13705,16018,-4651,18.4,TRUE,1,TRUE,18356,19888,4651,22.3
FALSE,FALSE,0,FALSE,13685,16729,-4011,18.2,TRUE,2,TRUE,17696,19000,4011,24.3
TRUE,TRUE,0,FALSE,15366,16496,-2698,20,FALSE,2,TRUE,18064,19465,2698,22.1
FALSE,FALSE,1,FALSE,14175,17400,-1769,23.4,TRUE,1,TRUE,15944,19476,1769,24.9
FALSE,FALSE,1,TRUE,15975,16937,-166,19.7,TRUE,0,FALSE,16141,17274,166,23.1
FALSE,TRUE,0,FALSE,13099,14520,-3521,19.1,FALSE,1,TRUE,16620,18936,3521,24.7
TRUE,TRUE,1,TRUE,15578,19730,611,24.9,FALSE,0,FALSE,14967,18176,-611,24.5
FALSE,TRUE,0,FALSE,14218,15368,-4511,20,FALSE,1,TRUE,18729,19579,4511,21.3
TRUE,TRUE,0,FALSE,15198,18952,-1157,23.1,FALSE,1,TRUE,16355,19036,1157,21.1
TRUE,TRUE,0,FALSE,17474,19214,3295,23.8,FALSE,0,FALSE,14179,16374,-3295,22.9
TRUE,TRUE,1,FALSE,17786,19357,3090,23.5,FALSE,1,TRUE,14696,18349,-3090,21.5
TRUE,TRUE,0,FALSE,17082,19192,2388,22.4,FALSE,1,TRUE,14694,17592,-2388,22.4
FALSE,TRUE,0,FALSE,15711,19278,-204,21,FALSE,1,TRUE,15915,18143,204,22.9
TRUE,FALSE,1,TRUE,16112,18545,451,24,TRUE,0,FALSE,15661,17477,-451,23.6
FALSE,FALSE,0,FALSE,15700,17892,-2943,19,TRUE,2,TRUE,18643,19095,2943,22.5
TRUE,TRUE,0,FALSE,17885,18417,1419,20.9,FALSE,1,TRUE,16466,17860,-1419,18.7
TRUE,TRUE,0,FALSE,15705,17630,856,23,FALSE,1,TRUE,14849,17898,-856,21.9
FALSE,FALSE,0,FALSE,13364,16851,-5088,20.3,TRUE,2,TRUE,18452,20762,5088,25.9
FALSE,FALSE,1,FALSE,17080,18330,-2247,19.6,TRUE,0,FALSE,19327,20268,2247,22.7
TRUE,TRUE,0,FALSE,17395,17215,3298,17,FALSE,0,FALSE,14097,16177,-3298,21
TRUE,FALSE,1,FALSE,17498,19132,744,24,TRUE,0,FALSE,16754,18205,-744,19.9
TRUE,FALSE,0,FALSE,17649,19655,2194,27.6,TRUE,1,TRUE,15455,16971,-2194,22.1
TRUE,TRUE,1,TRUE,18717,20051,4865,24.7,FALSE,0,FALSE,13852,15410,-4865,19.1
TRUE,TRUE,1,TRUE,15736,18719,131,23.1,FALSE,0,FALSE,15605,17338,-131,24.6
FALSE,FALSE,0,FALSE,13800,15275,-4921,16.5,TRUE,1,TRUE,18721,18101,4921,20.8
FALSE,FALSE,0,FALSE,15772,17144,-1502,20.4,TRUE,2,TRUE,17274,17573,1502,22.5
TRUE,TRUE,1,TRUE,16825,19699,389,22.9,FALSE,1,FALSE,16436,18047,-389,19.4
FALSE,TRUE,1,FALSE,17315,18122,1792,22.9,FALSE,1,TRUE,15523,17905,-1792,22.6
FALSE,FALSE,0,FALSE,14144,17041,-1122,20.8,TRUE,1,TRUE,15266,17684,1122,23
TRUE,TRUE,1,TRUE,16328,17531,1192,22.3,FALSE,0,FALSE,15136,16695,-1192,21.9
TRUE,TRUE,0,FALSE,15135,17610,-1161,21.3,FALSE,0,FALSE,16296,19295,1161,25.1
FALSE,FALSE,0,FALSE,17719,18085,618,21.5,TRUE,1,TRUE,17101,18393,-618,21.3
FALSE,TRUE,0,FALSE,16291,16508,-870,18,FALSE,1,TRUE,17161,17856,870,20.7
FALSE,TRUE,1,FALSE,15048,16313,-2099,20.9,FALSE,1,TRUE,17147,19030,2099,23.9
FALSE,FALSE,0,FALSE,14155,16974,-1735,22.6,TRUE,1,TRUE,15890,18760,1735,25.8
FALSE,FALSE,0,FALSE,15102,18032,-5691,17.4,TRUE,2,TRUE,20793,20038,5691,22.6
FALSE,FALSE,0,FALSE,15522,16999,-3819,18.2,TRUE,1,TRUE,19341,19263,3819,22
TRUE,FALSE,1,FALSE,17850,18858,1926,20.4,TRUE,1,TRUE,15924,15129,-1926,16.7
FALSE,TRUE,1,TRUE,16720,16905,-1884,18.1,FALSE,0,FALSE,18604,19790,1884,24.8
TRUE,FALSE,0,FALSE,17321,19677,703,23.8,TRUE,1,TRUE,16618,19200,-703,21.2
TRUE,TRUE,0,FALSE,16672,18698,-521,21,FALSE,1,TRUE,17193,17838,521,25
TRUE,TRUE,1,TRUE,15426,19072,711,23,FALSE,0,FALSE,14715,17827,-711,25.5
TRUE,TRUE,1,TRUE,16404,19029,736,24.6,FALSE,0,FALSE,15668,18010,-736,20.3
TRUE,FALSE,1,TRUE,18293,19481,2685,21.8,TRUE,0,FALSE,15608,18330,-2685,22.8
FALSE,TRUE,1,TRUE,16605,17961,31,20.7,FALSE,0,FALSE,16574,18150,-31,20.7
FALSE,TRUE,0,FALSE,18544,17072,1060,18.2,FALSE,1,TRUE,17484,17065,-1060,17.4
TRUE,TRUE,1,TRUE,18499,17823,3473,21,FALSE,0,FALSE,15026,15011,-3473,20.4
TRUE,TRUE,0,FALSE,16911,17876,1913,22.4,FALSE,1,TRUE,14998,17034,-1913,22.2
TRUE,TRUE,0,FALSE,16963,17857,707,21.2,FALSE,0,FALSE,16256,17127,-707,20
TRUE,TRUE,2,TRUE,17669,20105,2227,21.8,FALSE,0,FALSE,15442,17313,-2227,20.3
FALSE,FALSE,1,TRUE,15875,18029,-2901,19.1,TRUE,0,FALSE,18776,19933,2901,23
FALSE,FALSE,0,FALSE,16273,19371,1161,24.1,TRUE,1,TRUE,15112,16984,-1161,22.4
FALSE,FALSE,1,FALSE,15848,17347,-1845,23.8,TRUE,1,TRUE,17693,17953,1845,22.4
FALSE,FALSE,1,TRUE,15297,17644,-502,20.1,TRUE,0,FALSE,15799,18057,502,20.9
FALSE,FALSE,1,FALSE,16406,17714,-1530,20.8,TRUE,1,TRUE,17936,18702,1530,22.4
FALSE,TRUE,0,FALSE,17509,18038,-2118,23.4,FALSE,1,TRUE,19627,20196,2118,20.9
TRUE,FALSE,1,TRUE,15398,17802,-893,20,TRUE,0,FALSE,16291,17031,893,21.2
FALSE,TRUE,2,TRUE,17431,18061,253,17.8,FALSE,0,FALSE,17178,18182,-253,22.4
TRUE,TRUE,1,TRUE,18968,20401,5344,23.9,FALSE,0,FALSE,13624,16608,-5344,22.5
FALSE,FALSE,1,FALSE,16318,17365,-326,21.8,TRUE,1,TRUE,16644,17050,326,20.9
TRUE,TRUE,0,FALSE,18896,19340,2663,19.8,FALSE,1,TRUE,16233,17803,-2663,20.1
TRUE,TRUE,1,TRUE,15964,17011,-1399,20.4,FALSE,0,FALSE,17363,18738,1399,21.7
FALSE,FALSE,2,TRUE,15924,16695,-903,18.4,TRUE,0,FALSE,16827,17424,903,21.5
FALSE,FALSE,1,TRUE,15190,18507,-2134,21.5,TRUE,1,FALSE,17324,18846,2134,22.7
TRUE,TRUE,1,TRUE,17482,19196,3781,21.6,FALSE,0,FALSE,13701,16012,-3781,22.3
TRUE,TRUE,1,TRUE,14492,16869,-611,21.1,FALSE,0,FALSE,15103,18827,611,23
TRUE,TRUE,0,FALSE,17055,17638,2603,22.5,FALSE,1,TRUE,14452,16533,-2603,23.8
TRUE,TRUE,0,FALSE,14559,17491,-1348,19.1,FALSE,1,FALSE,15907,17501,1348,20.2
FALSE,FALSE,0,FALSE,15838,18031,-2468,20.4,TRUE,1,TRUE,18306,19884,2468,21.9
TRUE,FALSE,0,FALSE,16047,18460,-518,25,TRUE,2,TRUE,16565,18728,518,21.1
FALSE,TRUE,0,FALSE,16513,18896,752,24.1,FALSE,1,TRUE,15761,17750,-752,21.6
FALSE,FALSE,0,FALSE,15445,17280,-1775,22.2,TRUE,1,FALSE,17220,19978,1775,22.8
TRUE,TRUE,0,FALSE,18124,19613,4232,21.3,FALSE,0,FALSE,13892,16165,-4232,20.5
FALSE,FALSE,0,FALSE,14268,15723,-4962,21.3,TRUE,0,FALSE,19230,18107,4962,21.6
TRUE,FALSE,1,FALSE,16000,17778,379,20.6,TRUE,1,TRUE,15621,17372,-379,21.4
FALSE,FALSE,0,FALSE,15040,17558,-2006,18.4,TRUE,0,FALSE,17046,17659,2006,23.6
TRUE,FALSE,1,TRUE,15416,17061,-1342,19.9,TRUE,0,FALSE,16758,17774,1342,24.8
FALSE,TRUE,1,TRUE,17844,18825,1037,23.2,FALSE,0,FALSE,16807,18714,-1037,24.3
FALSE,TRUE,2,TRUE,16455,17798,1844,22.9,FALSE,0,FALSE,14611,16401,-1844,21.3
TRUE,TRUE,1,TRUE,17368,18140,3524,25.2,FALSE,0,FALSE,13844,16054,-3524,19.5
FALSE,FALSE,0,FALSE,16503,19371,2169,21.8,TRUE,1,TRUE,14334,17049,-2169,22
TRUE,TRUE,1,TRUE,15063,16316,-1547,19.8,FALSE,0,FALSE,16610,17365,1547,22.9
TRUE,TRUE,1,TRUE,17733,19290,1995,22.1,FALSE,0,FALSE,15738,16946,-1995,22.5
TRUE,TRUE,0,FALSE,15720,18012,1146,22.4,FALSE,1,TRUE,14574,16572,-1146,21.1
TRUE,FALSE,2,TRUE,16457,17837,1418,22.8,TRUE,0,FALSE,15039,17121,-1418,23.8
TRUE,TRUE,1,TRUE,17526,18287,307,22,FALSE,0,FALSE,17219,18556,-307,22.5
TRUE,FALSE,1,TRUE,17204,19878,803,21.5,TRUE,0,FALSE,16401,17281,-803,21.6
TRUE,TRUE,2,TRUE,16973,19798,2420,27.1,FALSE,0,FALSE,14553,17370,-2420,24.7
FALSE,TRUE,0,FALSE,12713,14245,-2976,19.2,FALSE,2,TRUE,15689,16500,2976,23.7
FALSE,FALSE,0,FALSE,16488,17583,-451,21.7,TRUE,0,FALSE,16939,18784,451,19.6
FALSE,FALSE,0,FALSE,15801,17655,161,20.8,TRUE,0,FALSE,15640,16109,-161,19.7
FALSE,FALSE,0,FALSE,14750,15820,-3688,18.5,TRUE,2,TRUE,18438,19858,3688,18.9
TRUE,FALSE,0,FALSE,17709,17077,-653,21.3,TRUE,0,FALSE,18362,18794,653,19.3
FALSE,FALSE,0,FALSE,15827,17027,-2327,18.1,TRUE,2,TRUE,18154,19277,2327,25.1
FALSE,TRUE,0,FALSE,17482,17024,1875,20.6,FALSE,1,TRUE,15607,17646,-1875,17.9
FALSE,FALSE,0,FALSE,15450,17766,312,20.2,TRUE,2,TRUE,15138,17733,-312,24.3
FALSE,TRUE,1,TRUE,15728,17209,989,20.8,FALSE,0,FALSE,14739,17686,-989,20.8
TRUE,TRUE,1,FALSE,15588,16904,414,20.2,FALSE,1,TRUE,15174,18128,-414,20.7
TRUE,FALSE,1,TRUE,18676,18145,416,21.7,TRUE,0,FALSE,18260,17012,-416,21.1
FALSE,FALSE,0,FALSE,15829,17626,-869,18.5,TRUE,1,TRUE,16698,18440,869,23.1
TRUE,FALSE,1,TRUE,15340,18245,-1031,22.8,TRUE,0,FALSE,16371,18123,1031,22.8
FALSE,TRUE,1,FALSE,17140,18192,-389,20.7,FALSE,1,TRUE,17529,17966,389,20.8
FALSE,FALSE,0,FALSE,14606,17633,-3513,20,TRUE,1,TRUE,18119,19263,3513,22.1
TRUE,FALSE,1,FALSE,17528,20077,2605,25.7,TRUE,1,TRUE,14923,17817,-2605,25.4
FALSE,TRUE,0,FALSE,16035,17246,408,19.3,FALSE,1,TRUE,15627,17081,-408,22.4
FALSE,FALSE,1,TRUE,14559,17148,-4140,19.3,TRUE,0,FALSE,18699,19325,4140,23.6
TRUE,FALSE,1,TRUE,19726,19180,5020,24.6,TRUE,0,FALSE,14706,15395,-5020,19.2
TRUE,FALSE,0,FALSE,16508,18959,616,23,TRUE,0,FALSE,15892,17286,-616,23.8
FALSE,FALSE,0,FALSE,14001,16037,-2744,22.1,TRUE,1,TRUE,16745,17367,2744,24.4
TRUE,FALSE,1,TRUE,15650,17837,-249,22.4,TRUE,1,FALSE,15899,19000,249,25.4
FALSE,TRUE,0,FALSE,16663,18493,-29,22.7,FALSE,1,TRUE,16692,19490,29,22.5
TRUE,TRUE,0,FALSE,17052,17766,1475,24.1,FALSE,1,TRUE,15577,17861,-1475,20.6
FALSE,TRUE,0,FALSE,16242,16365,-2055,20.9,FALSE,0,FALSE,18297,19014,2055,20.2
FALSE,FALSE,0,FALSE,15009,16571,-1806,21.1,TRUE,2,TRUE,16815,17990,1806,22
FALSE,FALSE,0,FALSE,15462,17446,-2237,20.9,TRUE,1,TRUE,17699,18331,2237,25.6
TRUE,FALSE,0,FALSE,16972,19381,1992,22.2,TRUE,1,TRUE,14980,16207,-1992,22.1
TRUE,FALSE,0,FALSE,17005,19366,1973,26.8,TRUE,1,TRUE,15032,18130,-1973,24.1
TRUE,TRUE,0,FALSE,15845,17682,463,22.5,FALSE,0,FALSE,15382,17690,-463,21.4
FALSE,FALSE,0,FALSE,14048,16395,-4004,20.9,TRUE,2,TRUE,18052,19695,4004,23.7
TRUE,TRUE,1,TRUE,15388,15544,-3077,15.3,FALSE,1,FALSE,18465,18704,3077,21.4
FALSE,FALSE,1,TRUE,14622,17798,-2542,17.6,TRUE,0,FALSE,17164,18186,2542,23.8
TRUE,FALSE,1,TRUE,15184,17545,-700,19.9,TRUE,1,FALSE,15884,16639,700,21.5
FALSE,FALSE,0,FALSE,17607,18633,-740,19.5,TRUE,1,TRUE,18347,18237,740,21.4
FALSE,FALSE,0,FALSE,15258,17586,-3222,17.9,TRUE,1,TRUE,18480,19562,3222,24
TRUE,TRUE,1,TRUE,19669,17978,6876,20.7,FALSE,0,FALSE,12793,11443,-6876,14.9
TRUE,TRUE,2,TRUE,17865,19417,2871,25.1,FALSE,0,FALSE,14994,17836,-2871,21.5
FALSE,FALSE,1,FALSE,19206,17896,2422,21.9,TRUE,1,TRUE,16784,16848,-2422,18.1
TRUE,TRUE,1,TRUE,18068,19266,3299,25.2,FALSE,1,FALSE,14769,17463,-3299,20.1
TRUE,TRUE,1,TRUE,17397,18389,751,23.5,FALSE,0,FALSE,16646,17774,-751,21
FALSE,FALSE,0,FALSE,15933,18813,-866,22.1,TRUE,1,TRUE,16799,18554,866,24.9
FALSE,TRUE,1,TRUE,15552,17498,-164,23.9,FALSE,1,FALSE,15716,17404,164,20.3
FALSE,FALSE,1,TRUE,16675,18462,93,24,TRUE,0,FALSE,16582,16519,-93,20.9
FALSE,TRUE,0,FALSE,16585,18342,-991,23.1,FALSE,0,FALSE,17576,19186,991,22.3
TRUE,TRUE,1,TRUE,18665,17762,2524,21.3,FALSE,1,FALSE,16141,16722,-2524,20.2
TRUE,TRUE,1,TRUE,17555,17779,2875,22.3,FALSE,0,FALSE,14680,16393,-2875,19.6
FALSE,FALSE,0,FALSE,15942,17493,-1590,21.5,TRUE,1,TRUE,17532,18868,1590,22.1
FALSE,TRUE,0,FALSE,16185,17924,-2100,20.4,FALSE,2,TRUE,18285,18849,2100,19.9
FALSE,TRUE,0,FALSE,17444,16497,-1642,21.3,FALSE,1,TRUE,19086,20939,1642,22.3
FALSE,FALSE,1,TRUE,15471,18216,-499,22,TRUE,0,FALSE,15970,17956,499,25.2
FALSE,TRUE,1,TRUE,15043,17227,-1591,22.5,FALSE,1,FALSE,16634,19056,1591,23.6
TRUE,FALSE,1,TRUE,16424,18793,-158,21.7,TRUE,0,FALSE,16582,19481,158,24.3
TRUE,FALSE,0,FALSE,16061,17186,1195,15.8,TRUE,1,TRUE,14866,16648,-1195,21
FALSE,FALSE,0,FALSE,14910,16295,-4644,19.8,TRUE,0,FALSE,19554,19875,4644,24.7
FALSE,FALSE,0,FALSE,15127,16197,-4099,19.3,TRUE,0,FALSE,19226,20326,4099,22.5
FALSE,FALSE,0,FALSE,12682,15784,-4944,17.3,TRUE,1,TRUE,17626,19712,4944,23.3
TRUE,FALSE,1,TRUE,16298,19831,96,23.1,TRUE,0,FALSE,16202,16843,-96,20.1
TRUE,TRUE,2,TRUE,18818,19037,4107,21.5,FALSE,0,FALSE,14711,17217,-4107,20.9
TRUE,TRUE,1,TRUE,17221,18574,1823,19.9,FALSE,0,FALSE,15398,17000,-1823,20.8
TRUE,TRUE,2,TRUE,17897,18898,2332,23.7,FALSE,0,FALSE,15565,18261,-2332,19
TRUE,FALSE,0,FALSE,14657,15612,-2710,19.4,TRUE,1,TRUE,17367,17931,2710,22.7
FALSE,TRUE,0,FALSE,17232,17997,260,23.1,FALSE,0,FALSE,16972,18105,-260,20.5
TRUE,FALSE,0,FALSE,15830,19605,909,25.5,TRUE,0,FALSE,14921,17604,-909,21.9
FALSE,FALSE,0,FALSE,14992,16189,-1984,21.4,TRUE,1,TRUE,16976,18273,1984,24.6
TRUE,TRUE,0,FALSE,19000,18915,1259,23.3,FALSE,0,FALSE,17741,18975,-1259,26.4
FALSE,TRUE,0,FALSE,15723,17429,-1522,20.3,FALSE,1,TRUE,17245,19040,1522,24.1
FALSE,TRUE,0,FALSE,15428,16985,-2190,21.3,FALSE,2,TRUE,17618,20360,2190,21.8
FALSE,FALSE,1,TRUE,14592,16682,-1208,20.4,TRUE,0,FALSE,15800,17743,1208,20.5
FALSE,TRUE,0,FALSE,15613,17057,-2952,20.2,FALSE,1,TRUE,18565,20020,2952,22.1
FALSE,TRUE,1,TRUE,16844,18255,749,21.7,FALSE,0,FALSE,16095,17685,-749,23.3
TRUE,TRUE,1,TRUE,17709,19221,3324,24.2,FALSE,1,FALSE,14385,17823,-3324,22.7
FALSE,FALSE,1,FALSE,15028,18170,147,21.2,TRUE,1,TRUE,14881,16912,-147,23.1
TRUE,TRUE,0,FALSE,16399,17056,580,21.9,FALSE,0,FALSE,15819,17110,-580,18.9
FALSE,TRUE,1,TRUE,19079,18774,1330,20.6,FALSE,0,FALSE,17749,17920,-1330,21.2
TRUE,FALSE,0,FALSE,15809,18227,-2167,20.2,TRUE,0,FALSE,17976,19385,2167,24.3
FALSE,TRUE,1,TRUE,16755,18596,1470,26.1,FALSE,0,FALSE,15285,18098,-1470,21.7
FALSE,FALSE,0,FALSE,15043,17669,-635,20.3,TRUE,1,TRUE,15678,17467,635,24.2
TRUE,FALSE,1,TRUE,16832,17641,-1467,22.2,TRUE,0,FALSE,18299,19145,1467,21
TRUE,TRUE,1,TRUE,17580,19527,3391,21,FALSE,0,FALSE,14189,16630,-3391,19.5
TRUE,TRUE,0,FALSE,15453,16291,-2980,19.3,FALSE,0,FALSE,18433,19173,2980,23.3
FALSE,TRUE,0,FALSE,15869,18217,-397,26.1,FALSE,1,TRUE,16266,18380,397,22.7
TRUE,FALSE,0,FALSE,15917,18903,1528,22,TRUE,1,TRUE,14389,17118,-1528,19.9
TRUE,TRUE,1,TRUE,19612,20290,4871,25.9,FALSE,0,FALSE,14741,18271,-4871,21
FALSE,FALSE,0,FALSE,12519,13642,-7527,15.2,TRUE,0,FALSE,20046,17951,7527,22
FALSE,FALSE,1,TRUE,16227,19425,131,22.1,TRUE,0,FALSE,16096,18690,-131,20.6
FALSE,TRUE,0,FALSE,15291,15389,-2889,19,FALSE,1,TRUE,18180,19294,2889,22.8
FALSE,FALSE,0,FALSE,14442,16949,-2402,20.9,TRUE,2,TRUE,16844,18218,2402,24
TRUE,FALSE,0,FALSE,18968,18902,1686,20.1,TRUE,0,FALSE,17282,18016,-1686,18.6
TRUE,TRUE,2,TRUE,16187,18182,1408,23.9,FALSE,0,FALSE,14779,16519,-1408,20.4
TRUE,TRUE,1,TRUE,18062,17871,-1293,19,FALSE,0,FALSE,19355,18584,1293,24.7
FALSE,FALSE,0,FALSE,14824,18421,-1424,23,TRUE,1,TRUE,16248,20837,1424,22.8
FALSE,TRUE,0,FALSE,15195,18046,-2336,21.7,FALSE,1,TRUE,17531,19328,2336,24.7
FALSE,TRUE,0,FALSE,16457,18265,265,20.2,FALSE,1,TRUE,16192,18532,-265,23.4
TRUE,TRUE,1,FALSE,18317,19181,3006,23.8,FALSE,1,TRUE,15311,17367,-3006,20.8
TRUE,TRUE,1,TRUE,16319,19461,1110,21.8,FALSE,0,FALSE,15209,17563,-1110,19.8
TRUE,TRUE,0,FALSE,19275,18899,2711,23.3,FALSE,1,TRUE,16564,16968,-2711,18.3
TRUE,TRUE,1,TRUE,16605,17533,2086,21.9,FALSE,1,FALSE,14519,17173,-2086,21
TRUE,TRUE,2,TRUE,17898,19735,3477,23.8,FALSE,0,FALSE,14421,16349,-3477,22.4
FALSE,TRUE,0,FALSE,14745,17586,-1815,21.3,FALSE,1,TRUE,16560,18257,1815,21.1
TRUE,FALSE,1,FALSE,16417,18414,1086,24.9,TRUE,1,TRUE,15331,16610,-1086,21.9
TRUE,TRUE,0,FALSE,15169,17363,-145,21.7,FALSE,0,FALSE,15314,17243,145,20.5
FALSE,FALSE,2,TRUE,15197,17925,-1519,23.3,TRUE,0,FALSE,16716,19288,1519,24.5
TRUE,TRUE,1,TRUE,18208,19824,4538,24.8,FALSE,0,FALSE,13670,16206,-4538,17.6
TRUE,TRUE,1,TRUE,17879,19767,4864,24.1,FALSE,0,FALSE,13015,14457,-4864,18.5
TRUE,TRUE,0,FALSE,17947,19669,4121,23.9,FALSE,0,FALSE,13826,16619,-4121,17.7
TRUE,FALSE,1,TRUE,15393,18185,-1101,24.3,TRUE,0,FALSE,16494,18491,1101,26.7
TRUE,TRUE,0,FALSE,15729,18102,-448,20.5,FALSE,1,TRUE,16177,18265,448,23.2
TRUE,TRUE,1,FALSE,18560,19924,3373,24.4,FALSE,0,FALSE,15187,17541,-3373,21
TRUE,TRUE,1,TRUE,15718,17585,86,25.6,FALSE,0,FALSE,15632,17900,-86,22
FALSE,TRUE,0,FALSE,14021,15684,-3792,20,FALSE,1,TRUE,17813,19156,3792,23.6
TRUE,TRUE,0,FALSE,19485,19900,3823,19.6,FALSE,0,FALSE,15662,17337,-3823,20.1
FALSE,FALSE,1,TRUE,16029,17293,-1350,19.8,TRUE,0,FALSE,17379,19058,1350,20.6
FALSE,FALSE,1,FALSE,14372,16842,-1864,20.5,TRUE,0,FALSE,16236,18966,1864,21.6
TRUE,FALSE,0,FALSE,18348,17087,1864,19.5,TRUE,1,TRUE,16484,17884,-1864,21.1
FALSE,FALSE,1,TRUE,16464,17678,441,20.6,TRUE,0,FALSE,16023,17548,-441,22.9
FALSE,FALSE,0,FALSE,16377,18575,-2218,21.3,TRUE,2,TRUE,18595,19658,2218,22.2
TRUE,FALSE,1,TRUE,17421,17407,-120,20.3,TRUE,0,FALSE,17541,17801,120,22.5
TRUE,FALSE,0,FALSE,15284,17975,-188,22.1,TRUE,0,FALSE,15472,17076,188,22.6
FALSE,TRUE,1,TRUE,14900,18354,-1966,21.4,FALSE,0,FALSE,16866,18091,1966,21.4
TRUE,TRUE,0,FALSE,16345,16530,-323,20.4,FALSE,1,TRUE,16668,17522,323,19
FALSE,FALSE,0,FALSE,17982,18687,-708,24.4,TRUE,1,TRUE,18690,18300,708,20.3
FALSE,FALSE,0,FALSE,16259,18818,-147,23.2,TRUE,1,TRUE,16406,18634,147,23.7
TRUE,TRUE,0,FALSE,18472,19144,1041,22.8,FALSE,1,TRUE,17431,17957,-1041,17.5
TRUE,TRUE,1,TRUE,16099,18219,873,20.3,FALSE,0,FALSE,15226,17541,-873,20.8
TRUE,TRUE,0,FALSE,15947,17352,247,23.1,FALSE,1,TRUE,15700,18543,-247,21.9
TRUE,TRUE,0,FALSE,16590,19180,1209,22.8,FALSE,1,TRUE,15381,18081,-1209,20.2
FALSE,TRUE,1,FALSE,14986,16975,-495,22.9,FALSE,1,TRUE,15481,17699,495,24.6
FALSE,TRUE,1,TRUE,19234,18339,2899,19.3,FALSE,0,FALSE,16335,16831,-2899,21.1
TRUE,TRUE,2,TRUE,16657,18356,1129,22.8,FALSE,0,FALSE,15528,18138,-1129,23.8
TRUE,TRUE,2,TRUE,21512,19190,5514,21.8,FALSE,0,FALSE,15998,16139,-5514,19.6
FALSE,TRUE,1,FALSE,15905,17754,-1317,20,FALSE,1,TRUE,17222,19181,1317,20.3
FALSE,FALSE,0,FALSE,15793,17795,-571,19.1,TRUE,1,FALSE,16364,18727,571,22.7
FALSE,TRUE,0,FALSE,17883,17407,1485,19.8,FALSE,1,TRUE,16398,17671,-1485,19.4
FALSE,TRUE,0,FALSE,15744,18381,1185,21.9,FALSE,0,FALSE,14559,17339,-1185,23.1
FALSE,FALSE,1,TRUE,14765,16480,-2108,18.9,TRUE,0,FALSE,16873,17990,2108,21.2
TRUE,TRUE,2,TRUE,17446,20350,3229,25.5,FALSE,0,FALSE,14217,16802,-3229,22.1
TRUE,TRUE,1,TRUE,16190,17477,1267,23.3,FALSE,0,FALSE,14923,16557,-1267,19
TRUE,TRUE,1,TRUE,14967,16756,-1513,22.1,FALSE,0,FALSE,16480,19715,1513,22.4
TRUE,FALSE,2,TRUE,18108,18738,2967,21.8,TRUE,0,FALSE,15141,17791,-2967,22.8
FALSE,FALSE,1,TRUE,16397,17090,-1023,22.2,TRUE,0,FALSE,17420,19118,1023,24.3
TRUE,TRUE,1,FALSE,16606,18225,1385,23.7,FALSE,0,FALSE,15221,17256,-1385,21.7
TRUE,FALSE,0,FALSE,14351,16380,-3540,17.2,TRUE,2,TRUE,17891,20025,3540,22.4
FALSE,FALSE,1,FALSE,14864,16742,-2219,24.9,TRUE,1,TRUE,17083,18240,2219,22.9
TRUE,TRUE,1,TRUE,18214,19620,1295,22.7,FALSE,0,FALSE,16919,18290,-1295,20.5
FALSE,TRUE,0,FALSE,17059,18162,1601,20,FALSE,2,TRUE,15458,16933,-1601,20.6
FALSE,FALSE,1,TRUE,14353,16624,-874,21.5,TRUE,0,FALSE,15227,18259,874,21.6
FALSE,FALSE,1,FALSE,16580,17438,-551,20.5,TRUE,1,TRUE,17131,17989,551,21.8
TRUE,FALSE,0,FALSE,17426,17243,395,23.4,TRUE,0,FALSE,17031,17747,-395,18.8
FALSE,TRUE,2,TRUE,16308,18718,-52,22.7,FALSE,0,FALSE,16360,18288,52,20.8
TRUE,TRUE,1,FALSE,19723,19678,4609,24.9,FALSE,1,TRUE,15114,18489,-4609,22.6
FALSE,TRUE,0,FALSE,15946,17404,-1565,22.2,FALSE,0,FALSE,17511,17871,1565,18.7
TRUE,FALSE,0,FALSE,19425,20998,3143,21.8,TRUE,1,TRUE,16282,18146,-3143,21.6
TRUE,FALSE,2,TRUE,18135,19550,1490,19.8,TRUE,0,FALSE,16645,17696,-1490,18
FALSE,FALSE,0,FALSE,16774,17746,-1130,17.6,TRUE,0,FALSE,17904,17471,1130,20.6
TRUE,FALSE,1,TRUE,16637,17981,370,21.5,TRUE,0,FALSE,16267,17769,-370,20.7
FALSE,FALSE,0,FALSE,16750,17492,-2128,21.4,TRUE,2,TRUE,18878,19365,2128,23.6
TRUE,FALSE,1,TRUE,13493,16560,-3700,21.8,TRUE,0,FALSE,17193,18781,3700,22.9
FALSE,FALSE,0,FALSE,15794,17285,-4649,19.2,TRUE,1,TRUE,20443,19199,4649,21.3
TRUE,TRUE,1,TRUE,16574,17052,144,20.3,FALSE,0,FALSE,16430,17279,-144,22.9
TRUE,TRUE,1,FALSE,20182,20589,3404,19.9,FALSE,1,TRUE,16778,17922,-3404,20.6
FALSE,TRUE,0,FALSE,15402,15435,-2180,20.5,FALSE,0,FALSE,17582,19141,2180,20.4
FALSE,TRUE,1,TRUE,15414,16960,-2545,18.8,FALSE,1,FALSE,17959,17721,2545,22.5
FALSE,TRUE,2,TRUE,16982,17866,1935,22.5,FALSE,0,FALSE,15047,17704,-1935,20.8
TRUE,FALSE,2,TRUE,15193,16642,-404,20.8,TRUE,0,FALSE,15597,17061,404,21.6
FALSE,TRUE,0,FALSE,15968,17837,-1624,22.6,FALSE,1,TRUE,17592,18904,1624,19.8
TRUE,TRUE,1,FALSE,15260,18522,-505,22,FALSE,1,TRUE,15765,19124,505,24.9
TRUE,FALSE,0,FALSE,17115,17857,47,20.3,TRUE,0,FALSE,17068,18713,-47,21.9
FALSE,FALSE,0,FALSE,16365,17954,-1754,22.5,TRUE,1,TRUE,18119,18103,1754,24.3
TRUE,FALSE,0,FALSE,16712,18681,-424,19,TRUE,0,FALSE,17136,18373,424,20.3
TRUE,TRUE,1,TRUE,18236,17766,2369,20.2,FALSE,0,FALSE,15867,16249,-2369,19.1
TRUE,TRUE,0,FALSE,20067,18286,2778,20.6,FALSE,1,TRUE,17289,18533,-2778,18.4
FALSE,TRUE,1,TRUE,14792,16218,-1183,20.5,FALSE,0,FALSE,15975,17453,1183,21.1
FALSE,FALSE,0,FALSE,14748,17867,-2619,21.2,TRUE,1,TRUE,17367,19082,2619,23.7
TRUE,TRUE,2,TRUE,18682,19196,2733,20.7,FALSE,0,FALSE,15949,17134,-2733,21.6
TRUE,TRUE,0,FALSE,15883,18069,-277,22.9,FALSE,0,FALSE,16160,18192,277,24.2
TRUE,TRUE,0,FALSE,15938,17167,673,20,FALSE,1,FALSE,15265,17231,-673,21
TRUE,TRUE,0,FALSE,18405,19055,4817,22.8,FALSE,0,FALSE,13588,14533,-4817,19.3
TRUE,TRUE,0,FALSE,16164,19020,956,24.6,FALSE,1,TRUE,15208,19047,-956,24.2
FALSE,FALSE,1,FALSE,15000,17095,-3290,21.2,TRUE,1,TRUE,18290,18338,3290,25.2
FALSE,FALSE,0,FALSE,14454,17394,-3003,19.1,TRUE,1,TRUE,17457,19512,3003,23.9
TRUE,FALSE,1,TRUE,17459,17773,-1,20.9,TRUE,0,FALSE,17460,18232,1,23.1
TRUE,TRUE,1,FALSE,17933,19728,2690,21.7,FALSE,1,TRUE,15243,17284,-2690,21.3
TRUE,TRUE,1,FALSE,14780,14277,3568,18.8,FALSE,0,FALSE,11212,11351,-3568,13.2
FALSE,FALSE,1,TRUE,15056,18484,777,22.6,TRUE,1,FALSE,14279,17742,-777,23.4
FALSE,FALSE,0,FALSE,13337,14550,-5735,15.8,TRUE,2,TRUE,19072,20097,5735,23.2
TRUE,TRUE,1,TRUE,20169,17549,4453,20.5,FALSE,0,FALSE,15716,17212,-4453,16.2
TRUE,FALSE,1,FALSE,15549,17486,-193,22.2,TRUE,1,TRUE,15742,18093,193,24.8
TRUE,TRUE,1,TRUE,18392,17969,2119,22.1,FALSE,0,FALSE,16273,17760,-2119,20.6
TRUE,FALSE,0,FALSE,15865,16893,-480,20.8,TRUE,1,TRUE,16345,17938,480,22.6
TRUE,TRUE,2,TRUE,17498,18424,1885,20.9,FALSE,0,FALSE,15613,16788,-1885,20
FALSE,FALSE,1,TRUE,14606,17820,-1605,22.1,TRUE,0,FALSE,16211,17583,1605,23.5
FALSE,FALSE,0,FALSE,13590,16558,-5691,20,TRUE,1,TRUE,19281,19652,5691,22
FALSE,TRUE,1,FALSE,16259,18538,-995,24.2,FALSE,0,FALSE,17254,18357,995,25.6
FALSE,FALSE,0,FALSE,17137,18112,-1730,18.8,TRUE,2,TRUE,18867,18088,1730,21.1
FALSE,TRUE,0,FALSE,14775,17337,-1285,20.6,FALSE,1,FALSE,16060,19262,1285,22.7
TRUE,TRUE,0,FALSE,17571,16712,-3024,17.4,FALSE,1,FALSE,20595,19518,3024,24.3
FALSE,TRUE,0,FALSE,16946,18333,368,23,FALSE,2,TRUE,16578,19107,-368,22
FALSE,TRUE,1,FALSE,16437,18096,969,24.4,FALSE,1,TRUE,15468,18505,-969,23.6
FALSE,FALSE,0,FALSE,16881,18875,-259,24.1,TRUE,0,FALSE,17140,17816,259,18.8
TRUE,FALSE,1,TRUE,15938,19963,443,24.2,TRUE,0,FALSE,15495,18052,-443,24.4
FALSE,FALSE,1,TRUE,15639,18956,-1233,23,TRUE,0,FALSE,16872,18686,1233,24.3
FALSE,TRUE,1,TRUE,14582,16375,-2298,21.4,FALSE,0,FALSE,16880,18656,2298,21.3
TRUE,TRUE,0,FALSE,19537,19905,3608,24.2,FALSE,1,TRUE,15929,17012,-3608,18.8
FALSE,FALSE,0,FALSE,14031,16789,-1762,22.3,TRUE,2,TRUE,15793,18381,1762,21.6
FALSE,FALSE,0,FALSE,16749,17716,-2233,19.2,TRUE,1,TRUE,18982,18828,2233,21.5
TRUE,TRUE,0,FALSE,16542,19014,1428,21.4,FALSE,1,TRUE,15114,17814,-1428,23.8
TRUE,TRUE,0,FALSE,18053,19492,891,23,FALSE,1,TRUE,17162,17966,-891,20.2
FALSE,TRUE,1,TRUE,18102,18787,1712,21.6,FALSE,1,FALSE,16390,17609,-1712,22.6
TRUE,TRUE,0,FALSE,17332,16861,-874,17,FALSE,0,FALSE,18206,18231,874,21.8
TRUE,FALSE,2,TRUE,17748,19116,1212,20.6,TRUE,0,FALSE,16536,17017,-1212,19.1
FALSE,FALSE,0,FALSE,17034,18358,-370,21,TRUE,1,TRUE,17404,17803,370,20.1
FALSE,FALSE,1,TRUE,16000,18965,230,18.1,TRUE,0,FALSE,15770,17071,-230,23.6
TRUE,TRUE,0,FALSE,16655,18545,474,21.7,FALSE,1,TRUE,16181,18647,-474,23.4
FALSE,FALSE,0,FALSE,13719,16024,-4492,20.2,TRUE,0,FALSE,18211,20109,4492,21.9
TRUE,TRUE,0,FALSE,17264,18301,3037,24.8,FALSE,0,FALSE,14227,15740,-3037,17.4
FALSE,TRUE,0,FALSE,14725,17519,-2686,21,FALSE,0,FALSE,17411,19299,2686,24.2
FALSE,FALSE,0,FALSE,14360,16876,-3424,17.5,TRUE,1,TRUE,17784,18426,3424,20.7
TRUE,TRUE,0,FALSE,16223,17419,135,23.3,FALSE,1,TRUE,16088,17757,-135,20.2
TRUE,TRUE,0,FALSE,16695,17863,1755,23.6,FALSE,1,TRUE,14940,17146,-1755,23.4
TRUE,FALSE,0,FALSE,16297,19135,-2523,21.2,TRUE,0,FALSE,18820,20192,2523,23.6
TRUE,FALSE,2,TRUE,15386,18832,-1402,24.6,TRUE,0,FALSE,16788,19835,1402,26.4
TRUE,TRUE,2,TRUE,18435,18643,4751,25.4,FALSE,0,FALSE,13684,18002,-4751,20.3
TRUE,FALSE,0,FALSE,17008,18978,1238,21.6,TRUE,1,TRUE,15770,17941,-1238,23.1
TRUE,TRUE,0,FALSE,16684,19585,2672,24,FALSE,0,FALSE,14012,17801,-2672,22
TRUE,TRUE,1,TRUE,17965,20621,2954,22.9,FALSE,0,FALSE,15011,16131,-2954,20.8
TRUE,TRUE,1,TRUE,16737,17553,272,23.1,FALSE,0,FALSE,16465,18020,-272,21.8
FALSE,FALSE,0,FALSE,13638,16479,-2033,19,TRUE,0,FALSE,15671,18091,2033,23.8
FALSE,TRUE,0,FALSE,15838,18368,-348,22.1,FALSE,1,TRUE,16186,19269,348,26.1
FALSE,TRUE,0,FALSE,15734,18750,465,23.6,FALSE,1,TRUE,15269,19661,-465,22.6
FALSE,TRUE,0,FALSE,17802,18241,-201,22.6,FALSE,1,TRUE,18003,18255,201,20.3
TRUE,TRUE,0,FALSE,16149,16018,-393,18.6,FALSE,0,FALSE,16542,16496,393,17.3
FALSE,TRUE,0,FALSE,14719,16608,-3485,19.5,FALSE,1,TRUE,18204,19031,3485,23.7
FALSE,FALSE,0,FALSE,15883,16480,-791,22.8,TRUE,0,FALSE,16674,18637,791,21.3
TRUE,TRUE,0,FALSE,19917,18396,3759,20.9,FALSE,1,TRUE,16158,17057,-3759,17.2
FALSE,FALSE,0,FALSE,16137,17136,-1563,20.3,TRUE,1,TRUE,17700,18143,1563,21.9
FALSE,FALSE,1,FALSE,17994,20156,3033,26.9,TRUE,1,TRUE,14961,16969,-3033,20.6
TRUE,TRUE,1,TRUE,17693,19209,2120,22.6,FALSE,0,FALSE,15573,17067,-2120,17.8
TRUE,TRUE,0,FALSE,16184,18288,-382,22.4,FALSE,0,FALSE,16566,18535,382,24.2
FALSE,FALSE,1,TRUE,15791,18218,-478,22,TRUE,0,FALSE,16269,17872,478,24.7
FALSE,TRUE,0,FALSE,15426,17927,566,20.2,FALSE,0,FALSE,14860,18175,-566,24.9
FALSE,TRUE,1,TRUE,16885,18326,2657,22.9,FALSE,0,FALSE,14228,15858,-2657,20
FALSE,FALSE,1,TRUE,15880,18313,-1891,21.9,TRUE,0,FALSE,17771,18050,1891,23.6
TRUE,FALSE,1,TRUE,16701,17762,-16,19.6,TRUE,0,FALSE,16717,18229,16,23.2
FALSE,TRUE,0,FALSE,17040,18469,1740,23,FALSE,1,TRUE,15300,17540,-1740,19.8
TRUE,FALSE,1,FALSE,13703,16964,-1912,18.7,TRUE,0,FALSE,15615,17921,1912,24.1
FALSE,FALSE,1,TRUE,16953,18996,-515,23.8,TRUE,0,FALSE,17468,18347,515,21.1
TRUE,FALSE,0,FALSE,16327,18521,1570,19,TRUE,1,TRUE,14757,17201,-1570,21.4
TRUE,TRUE,0,FALSE,17854,20729,3215,26,FALSE,0,FALSE,14639,17637,-3215,19.4
TRUE,FALSE,0,FALSE,19970,19994,3605,22.1,TRUE,0,FALSE,16365,16490,-3605,18.6
FALSE,TRUE,1,TRUE,16010,17522,-210,23.1,FALSE,0,FALSE,16220,18111,210,21.8
TRUE,FALSE,0,FALSE,16899,16675,-1507,18,TRUE,2,TRUE,18406,18064,1507,21.7
FALSE,TRUE,0,FALSE,16256,16283,-1114,15.4,FALSE,1,TRUE,17370,17723,1114,19.1
FALSE,FALSE,0,FALSE,16676,18660,333,23.8,TRUE,0,FALSE,16343,17734,-333,24.1
TRUE,FALSE,1,TRUE,18877,19556,1711,20.9,TRUE,0,FALSE,17166,17789,-1711,21.5
FALSE,FALSE,0,FALSE,14827,16610,-2322,18.7,TRUE,1,TRUE,17149,18132,2322,22.2
FALSE,TRUE,0,FALSE,16098,17950,65,24.4,FALSE,0,FALSE,16033,17599,-65,20.8
FALSE,TRUE,1,TRUE,15237,17162,-305,22.4,FALSE,0,FALSE,15542,16920,305,20.1
FALSE,FALSE,0,FALSE,16796,19792,311,25.6,TRUE,1,TRUE,16485,19085,-311,24.1
TRUE,FALSE,1,FALSE,19323,19481,2728,22,TRUE,0,FALSE,16595,17800,-2728,24.1
TRUE,TRUE,1,FALSE,16127,17096,2329,23.7,FALSE,1,TRUE,13798,15765,-2329,18.6
TRUE,TRUE,0,FALSE,17027,17004,573,17.5,FALSE,0,FALSE,16454,16956,-573,19.1
FALSE,TRUE,1,FALSE,15965,17701,-865,21.3,FALSE,1,TRUE,16830,17721,865,20.4
FALSE,FALSE,0,FALSE,16167,18659,-2055,20.2,TRUE,2,TRUE,18222,18873,2055,20.4
TRUE,FALSE,1,TRUE,18334,18032,3485,22.5,TRUE,0,FALSE,14849,15585,-3485,18.8
FALSE,FALSE,0,FALSE,15191,17269,-1848,21.4,TRUE,2,TRUE,17039,18741,1848,21.9
FALSE,FALSE,1,FALSE,16132,18044,-1989,22.2,TRUE,1,TRUE,18121,18779,1989,21.8
TRUE,TRUE,0,FALSE,15098,16937,-100,23.2,FALSE,1,TRUE,15198,17242,100,17.8
TRUE,TRUE,1,TRUE,16261,19301,1320,22.1,FALSE,0,FALSE,14941,18462,-1320,20.4
TRUE,FALSE,0,FALSE,16427,18653,-311,24.8,TRUE,0,FALSE,16738,19197,311,22.7
FALSE,FALSE,0,FALSE,14901,14483,-2834,17,TRUE,1,TRUE,17735,17885,2834,21.6
TRUE,FALSE,1,TRUE,17070,18022,365,23.2,TRUE,0,FALSE,16705,17666,-365,20.1
TRUE,TRUE,0,FALSE,16217,17326,112,21.7,FALSE,2,TRUE,16105,17247,-112,22.5
TRUE,TRUE,1,FALSE,18822,20135,4577,25.3,FALSE,1,TRUE,14245,16418,-4577,19.2
TRUE,TRUE,1,TRUE,19185,18543,5794,19.6,FALSE,0,FALSE,13391,14644,-5794,16.6
FALSE,TRUE,0,FALSE,14220,16333,-3673,20.3,FALSE,1,TRUE,17893,19306,3673,23.4
TRUE,TRUE,1,TRUE,18477,19589,3593,24.8,FALSE,0,FALSE,14884,18453,-3593,23.6
TRUE,TRUE,0,FALSE,16324,18159,-330,23.1,FALSE,1,TRUE,16654,18104,330,21.3
FALSE,TRUE,1,TRUE,15247,17064,-2720,20.9,FALSE,0,FALSE,17967,19537,2720,20.7
TRUE,TRUE,1,TRUE,17361,19308,1670,20.8,FALSE,0,FALSE,15691,17543,-1670,21.7
TRUE,FALSE,1,TRUE,17793,19766,1988,20.8,TRUE,0,FALSE,15805,18214,-1988,21.7
TRUE,TRUE,0,FALSE,14619,16874,622,24.4,FALSE,1,TRUE,13997,17922,-622,19.8
TRUE,FALSE,0,FALSE,15552,16960,726,21.1,TRUE,1,TRUE,14826,17472,-726,19.2
TRUE,TRUE,1,FALSE,17170,19662,2695,25.8,FALSE,1,TRUE,14475,17966,-2695,23.3
FALSE,TRUE,1,FALSE,18658,19117,1603,20.3,FALSE,0,FALSE,17055,17728,-1603,22.9
TRUE,TRUE,1,FALSE,17857,17155,1879,21.1,FALSE,0,FALSE,15978,17499,-1879,22.7
FALSE,FALSE,0,FALSE,14613,16611,-3238,21.9,TRUE,1,TRUE,17851,20725,3238,25.5
TRUE,FALSE,1,TRUE,15359,17087,-2039,19.7,TRUE,0,FALSE,17398,17571,2039,23
FALSE,TRUE,1,FALSE,16756,18790,773,23.9,FALSE,1,TRUE,15983,17505,-773,19
TRUE,TRUE,2,TRUE,19984,19327,3140,20.7,FALSE,0,FALSE,16844,15802,-3140,20.1
FALSE,TRUE,0,FALSE,15470,17451,-522,21.1,FALSE,1,TRUE,15992,18028,522,20.9
FALSE,TRUE,0,FALSE,16494,15865,-1484,15.6,FALSE,1,TRUE,17978,17393,1484,19.6
FALSE,FALSE,0,FALSE,15904,17623,-73,20.1,TRUE,2,TRUE,15977,17406,73,22.8
FALSE,FALSE,1,FALSE,14423,16642,-4452,19,TRUE,1,TRUE,18875,20368,4452,23.8
FALSE,FALSE,0,FALSE,15136,17202,-401,21.6,TRUE,0,FALSE,15537,18197,401,24
FALSE,FALSE,0,FALSE,16681,18901,1650,21.6,TRUE,2,TRUE,15031,17671,-1650,22.4
FALSE,FALSE,0,FALSE,14868,18004,-2681,23,TRUE,1,TRUE,17549,19945,2681,26.9
TRUE,FALSE,1,TRUE,16103,17939,-511,21.6,TRUE,0,FALSE,16614,17636,511,23.7
FALSE,FALSE,0,FALSE,15674,15931,-3878,20.6,TRUE,1,TRUE,19552,19799,3878,20.7
FALSE,FALSE,0,FALSE,14100,16543,-4603,18.9,TRUE,2,TRUE,18703,19589,4603,24.1
TRUE,TRUE,1,TRUE,20177,21248,3696,23.6,FALSE,0,FALSE,16481,17690,-3696,20.7
TRUE,FALSE,1,TRUE,15222,16755,7,20.7,TRUE,0,FALSE,15215,17440,-7,21.2
FALSE,TRUE,0,FALSE,14731,16109,-3354,18.8,FALSE,1,TRUE,18085,18807,3354,24.1
FALSE,TRUE,0,FALSE,14566,16999,-2414,19,FALSE,0,FALSE,16980,17958,2414,21.8
FALSE,TRUE,1,TRUE,17545,17316,-280,17.9,FALSE,0,FALSE,17825,18068,280,21.7
TRUE,FALSE,1,TRUE,15159,17161,-2341,22.1,TRUE,0,FALSE,17500,19195,2341,21.4
FALSE,FALSE,0,FALSE,15855,17820,-891,21.2,TRUE,1,TRUE,16746,18588,891,26.4
FALSE,FALSE,1,TRUE,17023,17635,-355,22.4,TRUE,0,FALSE,17378,17761,355,20.9
FALSE,FALSE,1,TRUE,17163,18565,515,22.1,TRUE,0,FALSE,16648,16874,-515,21.1
FALSE,FALSE,1,TRUE,15875,18236,-1663,22.4,TRUE,0,FALSE,17538,18072,1663,17.3
TRUE,TRUE,1,TRUE,14887,14486,-498,15.9,FALSE,1,FALSE,15385,16730,498,22.7
TRUE,TRUE,1,TRUE,15330,16197,-2366,20.3,FALSE,0,FALSE,17696,19579,2366,22.9
FALSE,FALSE,0,FALSE,14295,16196,-2514,21.1,TRUE,1,TRUE,16809,18958,2514,21.9
TRUE,FALSE,1,TRUE,16454,17910,-247,20.9,TRUE,0,FALSE,16701,17930,247,22.7
FALSE,FALSE,0,FALSE,13951,17688,-2847,21.1,TRUE,1,TRUE,16798,18006,2847,23.9
FALSE,TRUE,0,FALSE,16307,19846,1180,25.5,FALSE,1,TRUE,15127,18722,-1180,24
FALSE,FALSE,2,TRUE,16072,15157,-5540,17,TRUE,0,FALSE,21612,20500,5540,25.7
FALSE,FALSE,0,FALSE,15515,17838,-2272,23.1,TRUE,1,TRUE,17787,20238,2272,22.5
TRUE,TRUE,2,TRUE,15188,17576,-888,22.1,FALSE,0,FALSE,16076,18551,888,19.2
FALSE,TRUE,2,TRUE,17791,18823,1090,19.8,FALSE,0,FALSE,16701,18481,-1090,26.5
FALSE,FALSE,0,FALSE,15813,18788,-80,24.8,TRUE,1,TRUE,15893,18318,80,21.9
FALSE,TRUE,1,FALSE,14424,17499,-541,20.1,FALSE,0,FALSE,14965,17565,541,23.4
FALSE,FALSE,0,FALSE,19306,19792,1087,21.8,TRUE,2,TRUE,18219,19452,-1087,22.2
FALSE,FALSE,0,FALSE,14348,17150,-3489,19.6,TRUE,1,TRUE,17837,19783,3489,23.9
FALSE,FALSE,0,FALSE,14990,17870,-1510,22.1,TRUE,1,TRUE,16500,19626,1510,22.8
FALSE,FALSE,0,FALSE,16129,18291,627,22.2,TRUE,1,TRUE,15502,18117,-627,21.9
TRUE,TRUE,1,TRUE,18135,18974,2649,23.3,FALSE,0,FALSE,15486,17723,-2649,21.9
FALSE,FALSE,1,FALSE,17039,18571,1008,22.8,TRUE,0,FALSE,16031,18199,-1008,21.8
FALSE,FALSE,1,TRUE,14761,16905,-2553,19.4,TRUE,1,FALSE,17314,19437,2553,22.4
FALSE,FALSE,0,FALSE,12971,14675,-6850,18.1,TRUE,1,TRUE,19821,20885,6850,23.6
TRUE,FALSE,0,FALSE,15220,18562,-1297,23.4,TRUE,0,FALSE,16517,18691,1297,24.1
TRUE,FALSE,1,TRUE,18228,19302,2894,19.6,TRUE,0,FALSE,15334,17005,-2894,19.2
TRUE,TRUE,0,FALSE,17490,17883,480,22.6,FALSE,0,FALSE,17010,18568,-480,22
TRUE,TRUE,0,FALSE,15338,17842,-849,21.7,FALSE,0,FALSE,16187,19014,849,23.4
TRUE,TRUE,1,TRUE,19421,19063,2548,21.5,FALSE,0,FALSE,16873,17190,-2548,16.5
TRUE,FALSE,0,FALSE,17321,18397,2091,23.3,TRUE,1,TRUE,15230,15879,-2091,20.4
FALSE,TRUE,1,TRUE,17170,18247,2453,24.7,FALSE,0,FALSE,14717,16445,-2453,17.8
TRUE,FALSE,1,TRUE,17162,18810,-810,21.6,TRUE,0,FALSE,17972,18687,810,27.2
TRUE,TRUE,1,TRUE,17382,19669,2164,21.8,FALSE,0,FALSE,15218,16518,-2164,20.5
FALSE,TRUE,0,FALSE,16313,16697,-1249,20.1,FALSE,0,FALSE,17562,19775,1249,22.8
TRUE,FALSE,0,FALSE,15264,17806,-286,21.7,TRUE,2,TRUE,15550,17200,286,23.5
FALSE,FALSE,0,FALSE,15001,17600,-4625,22.8,TRUE,1,TRUE,19626,19492,4625,24.7
FALSE,FALSE,1,FALSE,16938,18931,-377,24.8,TRUE,1,TRUE,17315,18517,377,22.4
TRUE,TRUE,1,FALSE,19634,19705,3966,24.2,FALSE,1,TRUE,15668,16800,-3966,20.3
FALSE,TRUE,1,FALSE,16782,19169,299,21.3,FALSE,0,FALSE,16483,18295,-299,23
FALSE,TRUE,0,FALSE,18723,17268,1844,18.8,FALSE,1,TRUE,16879,17302,-1844,21
FALSE,FALSE,1,FALSE,14644,16269,-2896,20.1,TRUE,1,TRUE,17540,18994,2896,24.2
TRUE,FALSE,0,FALSE,19118,19312,646,21.8,TRUE,1,FALSE,18472,17556,-646,21.1
FALSE,FALSE,0,FALSE,13546,16240,-2831,19.8,TRUE,0,FALSE,16377,17965,2831,21.9
FALSE,TRUE,2,TRUE,16431,16968,-3488,21.9,FALSE,0,FALSE,19919,19650,3488,24
TRUE,TRUE,0,FALSE,16561,19634,1852,22.6,FALSE,1,TRUE,14709,17199,-1852,23.8
FALSE,FALSE,0,FALSE,14866,16219,-2140,20.8,TRUE,2,TRUE,17006,18111,2140,22.4
TRUE,TRUE,0,FALSE,18625,18941,1059,23.4,FALSE,0,FALSE,17566,18258,-1059,19.1
TRUE,TRUE,1,TRUE,17194,19161,2410,22.1,FALSE,0,FALSE,14784,18127,-2410,23.5
TRUE,FALSE,1,TRUE,15873,18580,-14,23.6,TRUE,0,FALSE,15887,18599,14,23.2
TRUE,TRUE,1,TRUE,16398,17998,-940,21.7,FALSE,0,FALSE,17338,19017,940,22
FALSE,TRUE,1,FALSE,17951,18661,2114,24.4,FALSE,1,TRUE,15837,16757,-2114,22
FALSE,FALSE,1,TRUE,15240,17591,323,23.4,TRUE,0,FALSE,14917,17199,-323,23.1
FALSE,TRUE,1,TRUE,17561,18172,287,20.3,FALSE,0,FALSE,17274,17604,-287,22.8
FALSE,FALSE,0,FALSE,14200,17304,-3805,19.1,TRUE,1,TRUE,18005,19397,3805,23
TRUE,FALSE,0,FALSE,16055,17800,6,22.6,TRUE,1,TRUE,16049,16176,-6,16
TRUE,TRUE,0,FALSE,19456,21097,4525,23,FALSE,0,FALSE,14931,17045,-4525,24.7
FALSE,FALSE,0,FALSE,15923,17907,-228,21.2,TRUE,1,TRUE,16151,18294,228,23
TRUE,FALSE,1,TRUE,13879,16393,-1499,19.4,TRUE,0,FALSE,15378,18021,1499,22.6
TRUE,TRUE,0,FALSE,17356,19154,2356,19.5,FALSE,0,FALSE,15000,17857,-2356,19.3
TRUE,TRUE,0,FALSE,15861,17523,-1340,18.2,FALSE,2,TRUE,17201,17751,1340,20.4
TRUE,FALSE,1,TRUE,17511,19617,2745,22,TRUE,0,FALSE,14766,17817,-2745,23.5
FALSE,FALSE,0,FALSE,15528,17590,-2446,23,TRUE,1,TRUE,17974,19098,2446,24.8
FALSE,FALSE,0,FALSE,16393,18783,1131,19.6,TRUE,1,TRUE,15262,17413,-1131,25.3
TRUE,TRUE,0,FALSE,17433,17284,1668,19.8,FALSE,2,TRUE,15765,18058,-1668,21
TRUE,FALSE,0,FALSE,19714,18151,1460,18.6,TRUE,0,FALSE,18254,16043,-1460,20
FALSE,FALSE,0,FALSE,15569,17357,-4346,16.7,TRUE,1,TRUE,19915,19535,4346,23.9
TRUE,TRUE,1,TRUE,17031,16530,-36,18.1,FALSE,1,FALSE,17067,17171,36,22.4
TRUE,TRUE,1,TRUE,18254,18805,844,21.8,FALSE,1,FALSE,17410,17169,-844,18.3
FALSE,FALSE,0,FALSE,16126,18226,-842,20.1,TRUE,1,TRUE,16968,17477,842,23
FALSE,TRUE,0,FALSE,15937,17560,-1321,21.2,FALSE,1,TRUE,17258,18746,1321,24.1
FALSE,TRUE,0,FALSE,15595,16171,-1780,20.8,FALSE,1,TRUE,17375,19113,1780,23.1
TRUE,TRUE,2,TRUE,16874,17230,1319,22.6,FALSE,0,FALSE,15555,16674,-1319,21.2
TRUE,FALSE,1,TRUE,16344,19730,2032,23.4,TRUE,0,FALSE,14312,16897,-2032,21.2
FALSE,TRUE,0,FALSE,15882,18646,-27,21.4,FALSE,1,TRUE,15909,18532,27,25.4
FALSE,TRUE,0,FALSE,15498,16711,-1384,20.1,FALSE,1,TRUE,16882,17564,1384,19
TRUE,TRUE,0,FALSE,19699,20307,5935,25.1,FALSE,1,TRUE,13764,17374,-5935,18.4
TRUE,TRUE,2,TRUE,17320,17894,689,21.5,FALSE,0,FALSE,16631,18807,-689,22.6
TRUE,FALSE,0,FALSE,14720,18456,-2381,24.6,TRUE,1,FALSE,17101,19578,2381,23.7
FALSE,TRUE,0,FALSE,16518,19187,51,22.3,FALSE,1,TRUE,16467,19047,-51,24.5
FALSE,TRUE,0,FALSE,17926,18959,2664,24.5,FALSE,1,TRUE,15262,16804,-2664,15.8
TRUE,TRUE,0,FALSE,16632,17833,999,21.5,FALSE,1,TRUE,15633,17351,-999,19.8
FALSE,TRUE,1,TRUE,18357,18461,2757,22.8,FALSE,1,FALSE,15600,17491,-2757,20.9
TRUE,TRUE,1,TRUE,18258,19948,4535,23.7,FALSE,0,FALSE,13723,16458,-4535,23.7
FALSE,TRUE,1,TRUE,16706,17561,31,21.6,FALSE,1,FALSE,16675,18302,-31,23.1
TRUE,TRUE,1,TRUE,18234,19881,4651,24.3,FALSE,0,FALSE,13583,15588,-4651,15.6
FALSE,FALSE,0,FALSE,14202,16159,-4552,20,TRUE,1,TRUE,18754,18448,4552,22.3
TRUE,TRUE,1,TRUE,17911,18635,3969,24.8,FALSE,0,FALSE,13942,17516,-3969,16.4
FALSE,FALSE,0,FALSE,13094,15865,-3915,20.5,TRUE,1,TRUE,17009,19959,3915,25.9
FALSE,FALSE,0,FALSE,17476,19033,1716,24.5,TRUE,0,FALSE,15760,17063,-1716,20.9
FALSE,TRUE,0,FALSE,16979,19193,-988,24.7,FALSE,1,TRUE,17967,19990,988,21.9
FALSE,FALSE,0,FALSE,13977,15531,-4221,19.7,TRUE,1,TRUE,18198,19101,4221,23.3
FALSE,TRUE,1,TRUE,14345,15396,-2053,17.2,FALSE,0,FALSE,16398,18004,2053,20.8
FALSE,TRUE,0,FALSE,15601,17171,415,23.2,FALSE,1,TRUE,15186,17157,-415,20.2
FALSE,TRUE,0,FALSE,14966,16483,-1470,17.7,FALSE,1,TRUE,16436,18320,1470,22
TRUE,TRUE,0,FALSE,16127,18510,1439,22.5,FALSE,1,TRUE,14688,17755,-1439,21
FALSE,FALSE,0,FALSE,17156,17559,-1534,19.5,TRUE,1,TRUE,18690,18984,1534,20.4
FALSE,FALSE,0,FALSE,15790,16936,-175,22.1,TRUE,2,TRUE,15965,17560,175,20.5
FALSE,FALSE,0,FALSE,16462,18654,-1785,21.2,TRUE,1,TRUE,18247,19594,1785,23.2
FALSE,FALSE,1,FALSE,15798,17608,-2289,22.5,TRUE,1,TRUE,18087,19867,2289,23.9
TRUE,FALSE,0,FALSE,17666,20014,3749,26.4,TRUE,0,FALSE,13917,16459,-3749,21.4
TRUE,FALSE,0,FALSE,18018,19634,4287,23.4,TRUE,1,TRUE,13731,16098,-4287,20.9
TRUE,FALSE,1,FALSE,16027,16856,-177,21.2,TRUE,1,TRUE,16204,16969,177,18.3
TRUE,TRUE,0,FALSE,18681,20293,5492,24.9,FALSE,1,FALSE,13189,15788,-5492,18.1
TRUE,TRUE,1,TRUE,17671,18386,1726,23.1,FALSE,0,FALSE,15945,17228,-1726,19.9
FALSE,FALSE,1,TRUE,15974,17188,-836,22.7,TRUE,0,FALSE,16810,18027,836,21.7
TRUE,TRUE,0,FALSE,16656,18706,2082,23,FALSE,1,TRUE,14574,17402,-2082,21.3
FALSE,FALSE,0,FALSE,14224,16992,-1325,22.9,TRUE,1,TRUE,15549,18340,1325,22.3
TRUE,FALSE,1,TRUE,16526,18314,-36,23.7,TRUE,0,FALSE,16562,19066,36,22.5
TRUE,TRUE,1,TRUE,16890,17686,-1647,22.1,FALSE,1,FALSE,18537,19129,1647,22.3
TRUE,TRUE,0,FALSE,16879,19019,2336,23.7,FALSE,0,FALSE,14543,16696,-2336,19.4
TRUE,TRUE,1,TRUE,19622,18338,1997,21.6,FALSE,0,FALSE,17625,19138,-1997,21.1
TRUE,FALSE,0,FALSE,16867,18880,2333,22.6,TRUE,1,TRUE,14534,16882,-2333,22.4
FALSE,FALSE,1,FALSE,15874,18205,-1024,22.3,TRUE,1,TRUE,16898,17265,1024,21.7
FALSE,TRUE,1,TRUE,16789,17799,-898,20.5,FALSE,0,FALSE,17687,18876,898,19.9
TRUE,TRUE,2,TRUE,17315,18205,1327,23.1,FALSE,0,FALSE,15988,17639,-1327,23.2
TRUE,FALSE,0,FALSE,15605,19324,-2048,21.6,TRUE,1,TRUE,17653,19353,2048,22.1
FALSE,TRUE,0,FALSE,15059,17650,-3606,20,FALSE,1,TRUE,18665,19621,3606,20.8
TRUE,TRUE,2,TRUE,18137,18171,3807,23.1,FALSE,0,FALSE,14330,16341,-3807,20.4
TRUE,TRUE,0,FALSE,14698,16713,-1341,19.2,FALSE,2,TRUE,16039,17052,1341,19.7
FALSE,TRUE,0,FALSE,15788,18069,647,20,FALSE,2,TRUE,15141,17588,-647,22.8
TRUE,TRUE,0,FALSE,15464,17569,209,23.7,FALSE,0,FALSE,15255,17319,-209,24.2
FALSE,FALSE,1,FALSE,17042,19460,934,20.7,TRUE,0,FALSE,16108,18684,-934,24.8
FALSE,FALSE,0,FALSE,15242,16237,-1707,20.4,TRUE,1,TRUE,16949,17837,1707,23.1
TRUE,TRUE,0,FALSE,16125,20079,-624,24.6,FALSE,1,TRUE,16749,18938,624,27.1
TRUE,FALSE,1,TRUE,17955,20629,3912,24.1,TRUE,0,FALSE,14043,15585,-3912,18.2
TRUE,TRUE,1,TRUE,15277,17240,-387,20.7,FALSE,0,FALSE,15664,16445,387,21.7
TRUE,FALSE,1,TRUE,15087,16343,-764,21.3,TRUE,0,FALSE,15851,16463,764,21.1
TRUE,FALSE,0,FALSE,16880,18007,1313,21.7,TRUE,0,FALSE,15567,16600,-1313,18.1
TRUE,TRUE,2,TRUE,17878,18056,4347,21.6,FALSE,0,FALSE,13531,15584,-4347,17.9
TRUE,TRUE,0,FALSE,19270,19668,3855,22.9,FALSE,2,TRUE,15415,18022,-3855,21.3
TRUE,TRUE,1,TRUE,15318,17999,1125,19.1,FALSE,0,FALSE,14193,17700,-1125,25.1
TRUE,FALSE,1,TRUE,16291,16847,478,17.9,TRUE,0,FALSE,15813,15681,-478,20.5
TRUE,FALSE,1,TRUE,17738,18849,1868,20.9,TRUE,0,FALSE,15870,17417,-1868,20.7
TRUE,TRUE,0,FALSE,16765,19056,1711,20.1,FALSE,1,TRUE,15054,17592,-1711,24
TRUE,TRUE,1,TRUE,16912,17678,1416,22.2,FALSE,0,FALSE,15496,17889,-1416,19.6
TRUE,TRUE,1,FALSE,14534,17364,-2269,22.4,FALSE,1,TRUE,16803,18980,2269,25
TRUE,TRUE,1,TRUE,17289,18113,69,20.1,FALSE,1,FALSE,17220,18232,-69,23.7
TRUE,TRUE,2,TRUE,17948,18736,2435,24.7,FALSE,0,FALSE,15513,17842,-2435,21.9
TRUE,TRUE,0,FALSE,16058,17194,-535,20,FALSE,1,TRUE,16593,15797,535,19.8
FALSE,TRUE,1,TRUE,17112,18050,-975,21.5,FALSE,1,FALSE,18087,18728,975,22.5
FALSE,FALSE,2,TRUE,16089,18217,-704,22.7,TRUE,0,FALSE,16793,19444,704,23.7
FALSE,FALSE,0,FALSE,17132,19401,789,23.7,TRUE,0,FALSE,16343,17781,-789,20.9
TRUE,TRUE,0,FALSE,17777,18847,1317,23.2,FALSE,1,FALSE,16460,17367,-1317,20.2
TRUE,FALSE,0,FALSE,18808,19323,948,24.4,TRUE,1,TRUE,17860,19031,-948,23.4
FALSE,TRUE,0,FALSE,14842,17857,270,23.1,FALSE,1,TRUE,14572,17178,-270,19.3
TRUE,TRUE,1,FALSE,16475,18879,2741,23.1,FALSE,1,TRUE,13734,18011,-2741,23.3
TRUE,FALSE,0,FALSE,17917,17502,3201,23.9,TRUE,1,TRUE,14716,17226,-3201,19.7
FALSE,TRUE,0,FALSE,16324,17601,541,19.7,FALSE,0,FALSE,15783,16726,-541,24
TRUE,FALSE,1,TRUE,16308,18876,-1055,24.5,TRUE,1,FALSE,17363,19083,1055,25.9
FALSE,FALSE,0,FALSE,14756,17655,-4105,18.4,TRUE,1,TRUE,18861,19934,4105,22.9
TRUE,FALSE,0,FALSE,14820,15946,-4156,18.4,TRUE,1,FALSE,18976,18879,4156,24
TRUE,TRUE,0,FALSE,15624,17633,1579,23.3,FALSE,2,TRUE,14045,16740,-1579,22.2
FALSE,FALSE,0,FALSE,15098,18104,-3779,22.5,TRUE,2,TRUE,18877,19641,3779,22.7
TRUE,FALSE,1,TRUE,17315,18903,4064,23.2,TRUE,0,FALSE,13251,15167,-4064,18.1
FALSE,TRUE,0,FALSE,13981,16753,-2494,22,FALSE,0,FALSE,16475,17749,2494,25
FALSE,TRUE,1,TRUE,15602,16235,-1081,19.5,FALSE,0,FALSE,16683,18390,1081,21.4
TRUE,TRUE,0,FALSE,17569,17425,2975,19.1,FALSE,0,FALSE,14594,16431,-2975,18
FALSE,TRUE,1,TRUE,15381,14805,-1611,16.7,FALSE,0,FALSE,16992,16706,1611,20.1
FALSE,FALSE,1,FALSE,14840,17620,-2579,22.6,TRUE,0,FALSE,17419,18246,2579,24.5
FALSE,FALSE,0,FALSE,15346,15646,-2764,18.7,TRUE,1,TRUE,18110,18580,2764,20.2
TRUE,TRUE,0,FALSE,16530,18713,837,24.3,FALSE,1,TRUE,15693,17514,-837,23.3
FALSE,TRUE,0,FALSE,14379,16423,-6676,20.3,FALSE,1,TRUE,21055,20347,6676,22.3
FALSE,FALSE,0,FALSE,16792,16518,-2787,19.8,TRUE,2,TRUE,19579,19180,2787,21.6
FALSE,FALSE,0,FALSE,15243,16159,-2449,19.3,TRUE,1,TRUE,17692,19254,2449,25.7
TRUE,TRUE,0,FALSE,17332,19582,1372,23.5,FALSE,0,FALSE,15960,17914,-1372,20.7
TRUE,TRUE,1,TRUE,16120,18058,-576,24.6,FALSE,1,FALSE,16696,19327,576,22.8
TRUE,TRUE,0,FALSE,17013,19131,447,23,FALSE,1,TRUE,16566,18035,-447,22.8
TRUE,TRUE,0,FALSE,15754,16911,-1157,19.6,FALSE,1,TRUE,16911,17484,1157,22.8
FALSE,FALSE,1,TRUE,20007,19097,3774,24.1,TRUE,0,FALSE,16233,14720,-3774,18.4
TRUE,FALSE,1,TRUE,20063,20273,3702,24.4,TRUE,1,FALSE,16361,16918,-3702,17.5
TRUE,TRUE,0,FALSE,17263,18277,2622,22.2,FALSE,1,TRUE,14641,17197,-2622,21.2
FALSE,FALSE,0,FALSE,16793,17671,620,24.2,TRUE,1,TRUE,16173,17897,-620,23.7
TRUE,FALSE,1,FALSE,14982,15862,-2690,17.1,TRUE,0,FALSE,17672,16605,2690,18.7
FALSE,TRUE,2,TRUE,16385,17327,-219,21.5,FALSE,0,FALSE,16604,17916,219,19.9
TRUE,TRUE,0,FALSE,17135,18089,754,22.7,FALSE,0,FALSE,16381,17930,-754,19.5
TRUE,FALSE,0,FALSE,16894,18333,1077,21.9,TRUE,0,FALSE,15817,17237,-1077,20.8
TRUE,FALSE,1,TRUE,16869,19165,840,23.2,TRUE,1,FALSE,16029,16925,-840,21
TRUE,TRUE,1,TRUE,17201,17805,317,22.1,FALSE,0,FALSE,16884,16861,-317,17.4
TRUE,TRUE,1,TRUE,16864,18073,1040,22.4,FALSE,0,FALSE,15824,16879,-1040,19.8
TRUE,TRUE,1,TRUE,18432,19560,2495,22.4,FALSE,0,FALSE,15937,16377,-2495,19.3
TRUE,TRUE,0,FALSE,17232,18525,672,23.8,FALSE,1,TRUE,16560,18114,-672,21
TRUE,TRUE,1,TRUE,18704,19748,2765,22.3,FALSE,0,FALSE,15939,16950,-2765,23.3
TRUE,FALSE,0,FALSE,16818,16961,1448,20.4,TRUE,1,TRUE,15370,17625,-1448,25
FALSE,FALSE,0,FALSE,16595,18645,-997,23.1,TRUE,0,FALSE,17592,18975,997,22.5
TRUE,TRUE,0,FALSE,17592,19904,3031,25.9,FALSE,0,FALSE,14561,18708,-3031,22.4
TRUE,FALSE,1,TRUE,17775,19408,2009,25.6,TRUE,0,FALSE,15766,17318,-2009,24.8
FALSE,FALSE,0,FALSE,15817,18561,-2378,21.2,TRUE,1,TRUE,18195,19039,2378,22.6
FALSE,FALSE,1,FALSE,16222,16170,-3561,18.4,TRUE,1,TRUE,19783,18081,3561,23.7
FALSE,TRUE,1,TRUE,16451,18027,-700,23.4,FALSE,0,FALSE,17151,19655,700,22.2
TRUE,TRUE,2,TRUE,19904,21324,5305,27.2,FALSE,0,FALSE,14599,16705,-5305,21
TRUE,FALSE,0,FALSE,16907,17497,-47,18.5,TRUE,0,FALSE,16954,17010,47,21.9
FALSE,FALSE,0,FALSE,13728,16556,-5040,21.1,TRUE,0,FALSE,18768,18052,5040,23.9
FALSE,TRUE,0,FALSE,14324,16390,-2808,21.7,FALSE,0,FALSE,17132,17945,2808,23.1
FALSE,FALSE,1,TRUE,15175,17282,-1409,21.4,TRUE,0,FALSE,16584,17298,1409,23.4
FALSE,FALSE,0,FALSE,14108,16327,-4316,18.8,TRUE,2,TRUE,18424,19044,4316,26.2
FALSE,TRUE,1,TRUE,18239,19135,640,22.8,FALSE,0,FALSE,17599,18724,-640,24
TRUE,TRUE,1,TRUE,18178,18563,5174,23.3,FALSE,0,FALSE,13004,15458,-5174,18.2
TRUE,TRUE,2,TRUE,15711,18516,458,19.6,FALSE,0,FALSE,15253,16273,-458,21.9
TRUE,TRUE,1,TRUE,20666,19611,5525,22,FALSE,0,FALSE,15141,16228,-5525,18.5
TRUE,FALSE,1,TRUE,15721,17894,1900,20.3,TRUE,0,FALSE,13821,16162,-1900,18.7
TRUE,TRUE,1,TRUE,16100,16520,-488,18.9,FALSE,0,FALSE,16588,17832,488,24
FALSE,TRUE,0,FALSE,15017,16114,-2936,20.3,FALSE,1,TRUE,17953,18970,2936,23.2
TRUE,FALSE,0,FALSE,13771,16290,-4907,17.4,TRUE,1,TRUE,18678,19164,4907,24.1
FALSE,FALSE,0,FALSE,17061,18530,744,19.7,TRUE,0,FALSE,16317,18069,-744,17.8
TRUE,TRUE,1,TRUE,16993,18935,422,26.2,FALSE,0,FALSE,16571,19693,-422,25.4
TRUE,FALSE,0,FALSE,14127,16566,-1171,18.6,TRUE,1,TRUE,15298,17723,1171,23.3
TRUE,FALSE,1,FALSE,16100,17451,-2907,19.2,TRUE,1,TRUE,19007,18827,2907,26
TRUE,TRUE,1,TRUE,16229,18988,164,20,FALSE,0,FALSE,16065,18502,-164,23
TRUE,FALSE,0,FALSE,15724,17512,81,21.7,TRUE,1,TRUE,15643,15647,-81,21.9
TRUE,TRUE,1,TRUE,17222,19032,485,21.6,FALSE,0,FALSE,16737,18813,-485,20.2
FALSE,TRUE,1,TRUE,19020,18128,609,21.6,FALSE,1,FALSE,18411,18147,-609,22.1
TRUE,TRUE,2,TRUE,19847,20768,6658,25,FALSE,0,FALSE,13189,14579,-6658,16.6
FALSE,FALSE,1,FALSE,14814,16691,-3082,21.6,TRUE,1,TRUE,17896,18385,3082,24.2
FALSE,FALSE,0,FALSE,15002,15784,-3255,17,TRUE,1,TRUE,18257,17582,3255,24
TRUE,TRUE,0,FALSE,17605,19955,2897,24.7,FALSE,0,FALSE,14708,16760,-2897,22.3
FALSE,FALSE,0,FALSE,14502,17558,-3041,21.3,TRUE,2,TRUE,17543,18875,3041,22.3
FALSE,FALSE,0,FALSE,14599,17147,-4196,22,TRUE,1,FALSE,18795,18796,4196,24.4
FALSE,FALSE,0,FALSE,13686,16575,-2755,21.3,TRUE,2,TRUE,16441,18830,2755,23
FALSE,FALSE,0,FALSE,16449,17858,973,20.7,TRUE,0,FALSE,15476,17033,-973,19.2
TRUE,TRUE,1,FALSE,21783,20533,5638,24.4,FALSE,0,FALSE,16145,17283,-5638,16.7
FALSE,FALSE,0,FALSE,15867,17569,-430,21,TRUE,1,FALSE,16297,17410,430,20.3
FALSE,FALSE,2,TRUE,15889,17078,-2212,17.7,TRUE,0,FALSE,18101,18760,2212,21.2
TRUE,TRUE,1,TRUE,16988,18623,1575,19.6,FALSE,0,FALSE,15413,19139,-1575,22.4
TRUE,FALSE,0,FALSE,16076,18917,1067,24.5,TRUE,0,FALSE,15009,17093,-1067,23.5
TRUE,FALSE,2,TRUE,22162,21254,6578,24.9,TRUE,0,FALSE,15584,15866,-6578,15.6
TRUE,FALSE,1,TRUE,15178,18172,-767,20.9,TRUE,1,FALSE,15945,18778,767,22.9
FALSE,FALSE,0,FALSE,15196,16925,-2560,18.8,TRUE,1,TRUE,17756,17751,2560,21.1
TRUE,TRUE,0,FALSE,15600,17354,-226,22.9,FALSE,0,FALSE,15826,17511,226,19.1
TRUE,TRUE,2,TRUE,16742,19145,1468,21.5,FALSE,0,FALSE,15274,18213,-1468,24.7
FALSE,FALSE,0,FALSE,15580,17286,-502,19.7,TRUE,1,FALSE,16082,18399,502,19.7
TRUE,FALSE,1,FALSE,16111,17724,-1090,21.1,TRUE,1,TRUE,17201,17169,1090,19.6
FALSE,FALSE,0,FALSE,15404,17893,-1793,24.4,TRUE,1,TRUE,17197,19119,1793,25.4
FALSE,FALSE,0,FALSE,15147,15110,-4470,20.1,TRUE,1,TRUE,19617,18958,4470,19.3
TRUE,TRUE,2,TRUE,17058,18736,2107,17.8,FALSE,0,FALSE,14951,16704,-2107,21.1
FALSE,FALSE,0,FALSE,14129,16038,-5489,17.4,TRUE,1,TRUE,19618,19781,5489,18.5
TRUE,FALSE,0,FALSE,16368,18622,1079,25,TRUE,1,TRUE,15289,17259,-1079,20.6
FALSE,FALSE,1,FALSE,15577,16808,-2268,23.5,TRUE,1,TRUE,17845,18659,2268,23.9
FALSE,TRUE,1,TRUE,17102,18327,339,20.7,FALSE,1,FALSE,16763,18066,-339,25.2
FALSE,FALSE,0,FALSE,14323,15853,-3016,20.6,TRUE,1,TRUE,17339,19332,3016,23.5
TRUE,TRUE,1,TRUE,15807,18131,70,21.9,FALSE,0,FALSE,15737,17722,-70,22.1
FALSE,TRUE,0,FALSE,14988,15585,-3562,18.6,FALSE,0,FALSE,18550,18904,3562,20.8
FALSE,FALSE,1,FALSE,15051,17519,-2815,22,TRUE,0,FALSE,17866,18723,2815,23.6
TRUE,TRUE,1,TRUE,15641,18490,-371,26.1,FALSE,0,FALSE,16012,18934,371,20.9
TRUE,TRUE,0,FALSE,16715,19011,911,22.7,FALSE,1,TRUE,15804,18298,-911,19.1
TRUE,TRUE,0,FALSE,18423,18773,2514,21.2,FALSE,1,FALSE,15909,17349,-2514,20
TRUE,TRUE,1,TRUE,15289,16346,-282,19.3,FALSE,0,FALSE,15571,17086,282,19.7
FALSE,FALSE,0,FALSE,14467,17728,-2287,22,TRUE,1,TRUE,16754,18463,2287,21.8
FALSE,FALSE,1,TRUE,15544,18418,-590,23.6,TRUE,1,FALSE,16134,17860,590,22.8
FALSE,FALSE,0,FALSE,14743,17174,-1625,22.8,TRUE,2,TRUE,16368,19235,1625,23.9
TRUE,FALSE,1,TRUE,14591,16795,-3236,22.4,TRUE,1,FALSE,17827,19669,3236,25.2
TRUE,TRUE,0,FALSE,18787,18788,2048,21.2,FALSE,0,FALSE,16739,17738,-2048,22.8
FALSE,TRUE,0,FALSE,16671,17530,-1141,18.1,FALSE,1,FALSE,17812,18160,1141,21.6
FALSE,TRUE,1,TRUE,17134,17172,1167,22.2,FALSE,0,FALSE,15967,17986,-1167,22.1
FALSE,FALSE,0,FALSE,14996,16234,-1502,22.1,TRUE,0,FALSE,16498,17193,1502,22.9
TRUE,TRUE,1,FALSE,17610,17839,3259,23.6,FALSE,1,TRUE,14351,15557,-3259,19.9
TRUE,FALSE,1,TRUE,17302,17065,-1085,19.7,TRUE,0,FALSE,18387,18781,1085,20.8
FALSE,FALSE,1,TRUE,16877,18403,-147,20.3,TRUE,0,FALSE,17024,18130,147,21.4
FALSE,FALSE,1,TRUE,16218,15119,-3070,15.4,TRUE,1,FALSE,19288,18146,3070,19.4
FALSE,FALSE,1,TRUE,15680,17983,-638,20.1,TRUE,0,FALSE,16318,16212,638,21.9
TRUE,FALSE,0,FALSE,16070,17613,-1245,19.4,TRUE,1,TRUE,17315,18584,1245,23.7
FALSE,TRUE,0,FALSE,15267,17008,-1002,21.2,FALSE,1,FALSE,16269,19327,1002,20.9
TRUE,TRUE,1,TRUE,14894,16548,-2094,24.4,FALSE,0,FALSE,16988,19056,2094,23
FALSE,FALSE,0,FALSE,13598,15349,-3892,18.9,TRUE,1,TRUE,17490,18074,3892,22.3
FALSE,FALSE,0,FALSE,15373,18554,-991,22.5,TRUE,1,TRUE,16364,18690,991,22
TRUE,FALSE,0,FALSE,16260,16989,-1791,21.1,TRUE,0,FALSE,18051,18660,1791,19.2
TRUE,FALSE,0,FALSE,16894,17731,1797,20.5,TRUE,1,TRUE,15097,16637,-1797,19
FALSE,TRUE,0,FALSE,17951,18517,680,21.9,FALSE,1,TRUE,17271,19221,-680,21.6
FALSE,FALSE,0,FALSE,15054,16739,-2327,20.4,TRUE,0,FALSE,17381,19210,2327,20.9
FALSE,FALSE,0,FALSE,13791,16220,-4379,19.9,TRUE,0,FALSE,18170,20031,4379,25
TRUE,TRUE,0,FALSE,17348,16417,1528,19.1,FALSE,1,TRUE,15820,16521,-1528,19.1
TRUE,FALSE,1,TRUE,16573,17651,-438,21.9,TRUE,0,FALSE,17011,18285,438,24.5
FALSE,TRUE,0,FALSE,17149,17975,1547,24.7,FALSE,0,FALSE,15602,17364,-1547,21
FALSE,TRUE,1,TRUE,16024,18727,-566,22.8,FALSE,0,FALSE,16590,19889,566,22.9
TRUE,TRUE,0,FALSE,16368,18776,1418,20.4,FALSE,1,TRUE,14950,17448,-1418,19.4
TRUE,TRUE,0,FALSE,18351,19205,2556,22.2,FALSE,1,TRUE,15795,15687,-2556,17
FALSE,FALSE,1,FALSE,14044,16385,-4107,23.1,TRUE,1,TRUE,18151,19475,4107,23.4
TRUE,TRUE,1,TRUE,15855,17383,-2536,20.4,FALSE,0,FALSE,18391,19726,2536,21.8
TRUE,TRUE,1,TRUE,19301,19342,3471,21.2,FALSE,0,FALSE,15830,16634,-3471,19.7
TRUE,TRUE,1,TRUE,15530,17181,196,22.1,FALSE,1,FALSE,15334,17364,-196,20.2
FALSE,TRUE,0,FALSE,14637,17706,-2433,19.3,FALSE,0,FALSE,17070,19393,2433,22.3
FALSE,TRUE,0,FALSE,15312,15636,-1352,16.7,FALSE,1,TRUE,16664,16816,1352,22
TRUE,FALSE,1,TRUE,17677,19493,1715,23.3,TRUE,0,FALSE,15962,17520,-1715,19.8
TRUE,TRUE,0,FALSE,18689,19882,3634,23.5,FALSE,0,FALSE,15055,17460,-3634,22.3
FALSE,TRUE,0,FALSE,17008,16636,801,20.6,FALSE,0,FALSE,16207,18169,-801,22.3
FALSE,TRUE,0,FALSE,15658,17569,-1047,22.4,FALSE,0,FALSE,16705,19187,1047,25.1
FALSE,FALSE,0,FALSE,14318,16916,-1575,18,TRUE,1,TRUE,15893,18140,1575,19.3
FALSE,FALSE,1,TRUE,16262,17436,-867,18.6,TRUE,0,FALSE,17129,17374,867,21.2
FALSE,FALSE,0,FALSE,15653,16813,-6105,15.8,TRUE,0,FALSE,21758,20878,6105,22.3
FALSE,FALSE,1,TRUE,15908,16828,-2080,21.1,TRUE,0,FALSE,17988,17945,2080,24.7
TRUE,FALSE,2,TRUE,15884,19448,322,24.1,TRUE,0,FALSE,15562,18071,-322,23.6
TRUE,TRUE,0,FALSE,17399,20087,2105,24.5,FALSE,0,FALSE,15294,17777,-2105,20.5
FALSE,FALSE,0,FALSE,17892,18969,1873,21.5,TRUE,1,TRUE,16019,18086,-1873,24.9
TRUE,TRUE,1,TRUE,18348,19343,3294,22.6,FALSE,0,FALSE,15054,17535,-3294,21.8
FALSE,FALSE,0,FALSE,14287,17457,-3045,22.5,TRUE,2,TRUE,17332,18837,3045,26.1
FALSE,FALSE,1,TRUE,16024,15686,-1307,20.2,TRUE,0,FALSE,17331,16500,1307,20.1
FALSE,FALSE,0,FALSE,17039,19626,1116,26.1,TRUE,1,TRUE,15923,18503,-1116,22.1
TRUE,TRUE,0,FALSE,17827,18573,24,21.6,FALSE,1,FALSE,17803,17590,-24,20.4
TRUE,FALSE,1,TRUE,16819,18725,707,23.9,TRUE,0,FALSE,16112,16765,-707,19.8
FALSE,FALSE,0,FALSE,13709,15514,-4681,19.9,TRUE,1,TRUE,18390,18011,4681,23
FALSE,FALSE,0,FALSE,15442,17142,-3924,20.4,TRUE,2,TRUE,19366,20841,3924,25.4
FALSE,FALSE,0,FALSE,14996,17555,-844,23.2,TRUE,1,TRUE,15840,18557,844,23
FALSE,FALSE,1,FALSE,15325,17258,-2368,23.8,TRUE,1,TRUE,17693,17508,2368,20.1
FALSE,TRUE,0,FALSE,13967,15942,-3789,19.6,FALSE,0,FALSE,17756,20025,3789,22.3
FALSE,TRUE,0,FALSE,15032,16226,-2798,22.1,FALSE,2,TRUE,17830,18629,2798,21.5
TRUE,TRUE,1,TRUE,19045,20131,3387,22.7,FALSE,0,FALSE,15658,17349,-3387,18.7
FALSE,FALSE,0,FALSE,15820,18001,-758,24.2,TRUE,2,TRUE,16578,18393,758,22.9
FALSE,FALSE,0,FALSE,14536,15452,-3203,20.1,TRUE,0,FALSE,17739,17651,3203,21.2
TRUE,TRUE,2,TRUE,16833,18765,3246,24.4,FALSE,0,FALSE,13587,17085,-3246,21.9
TRUE,FALSE,0,FALSE,16483,16652,-1412,18.6,TRUE,1,TRUE,17895,17057,1412,20.8
TRUE,TRUE,0,FALSE,17483,20101,3502,23.9,FALSE,0,FALSE,13981,16354,-3502,21.4
FALSE,FALSE,0,FALSE,14400,16399,-2884,21.5,TRUE,1,TRUE,17284,19720,2884,23.9
TRUE,TRUE,2,TRUE,18661,18012,2479,19.7,FALSE,0,FALSE,16182,16802,-2479,20.3
TRUE,TRUE,0,FALSE,17603,18424,1835,22.4,FALSE,2,TRUE,15768,17252,-1835,18.6
FALSE,FALSE,0,FALSE,13643,16564,-5479,19.9,TRUE,0,FALSE,19122,19896,5479,22.6
FALSE,FALSE,0,FALSE,16228,17098,-1957,23.2,TRUE,2,TRUE,18185,18061,1957,18.8
FALSE,TRUE,2,TRUE,18050,19654,1949,23.9,FALSE,0,FALSE,16101,19440,-1949,21.4
FALSE,TRUE,0,FALSE,16007,17474,-1729,20.6,FALSE,2,TRUE,17736,19579,1729,20.9
TRUE,TRUE,1,TRUE,17979,17675,3112,19.4,FALSE,0,FALSE,14867,17140,-3112,18.9
FALSE,FALSE,1,FALSE,15552,18535,-1462,24,TRUE,1,TRUE,17014,19142,1462,24.5
TRUE,TRUE,0,FALSE,18850,17995,3293,21.6,FALSE,0,FALSE,15557,17008,-3293,21
FALSE,FALSE,0,FALSE,14698,16625,-1723,22.4,TRUE,1,TRUE,16421,19150,1723,21.6
FALSE,FALSE,0,FALSE,13456,16144,-5199,16.4,TRUE,1,TRUE,18655,19752,5199,24.5
FALSE,TRUE,1,FALSE,16777,18671,441,24.3,FALSE,1,TRUE,16336,18904,-441,25.1
TRUE,TRUE,0,FALSE,19146,19236,2994,21.4,FALSE,1,TRUE,16152,16284,-2994,17.5
FALSE,TRUE,0,FALSE,18027,18601,850,21.2,FALSE,1,TRUE,17177,16159,-850,17.4
TRUE,FALSE,1,FALSE,17612,18342,1227,21.2,TRUE,0,FALSE,16385,17292,-1227,16.9
FALSE,FALSE,0,FALSE,14102,16718,-1936,22.5,TRUE,1,TRUE,16038,19150,1936,23.6
TRUE,FALSE,1,TRUE,18000,18718,3330,21.4,TRUE,0,FALSE,14670,15217,-3330,20.9
TRUE,TRUE,1,TRUE,16613,17888,-271,22.9,FALSE,0,FALSE,16884,17789,271,23.2
TRUE,TRUE,2,TRUE,17903,19614,3249,21.6,FALSE,0,FALSE,14654,18204,-3249,23.1
TRUE,FALSE,0,FALSE,17907,19004,1227,20.3,TRUE,0,FALSE,16680,16600,-1227,21.8
FALSE,FALSE,1,TRUE,16002,17397,-1260,17.7,TRUE,0,FALSE,17262,18580,1260,20.9
FALSE,TRUE,1,TRUE,14816,17070,-1631,20.4,FALSE,0,FALSE,16447,18210,1631,23.9
TRUE,FALSE,1,TRUE,16093,19191,517,24.5,TRUE,0,FALSE,15576,18969,-517,21.3
TRUE,TRUE,2,TRUE,18239,17409,2258,19.9,FALSE,0,FALSE,15981,18228,-2258,21.1
FALSE,TRUE,0,FALSE,16969,18552,416,18.1,FALSE,1,TRUE,16553,17616,-416,23.1
TRUE,TRUE,2,TRUE,18596,19244,4633,25.4,FALSE,0,FALSE,13963,15793,-4633,19.2
FALSE,TRUE,1,TRUE,15702,17467,-816,23,FALSE,0,FALSE,16518,18656,816,22.4
FALSE,FALSE,0,FALSE,15885,18620,-390,25.2,TRUE,1,TRUE,16275,18672,390,25.8
TRUE,FALSE,1,FALSE,15292,17766,-2888,19,TRUE,1,TRUE,18180,19538,2888,23.1
TRUE,TRUE,0,FALSE,15843,18349,1284,23.6,FALSE,1,TRUE,14559,17954,-1284,20.4
FALSE,FALSE,1,TRUE,16028,18310,-1437,21.6,TRUE,0,FALSE,17465,19080,1437,25.9
FALSE,FALSE,1,TRUE,15718,16225,-1012,15.9,TRUE,0,FALSE,16730,16541,1012,19.2
FALSE,FALSE,1,TRUE,17378,17926,202,16.7,TRUE,1,FALSE,17176,16896,-202,20.3
TRUE,TRUE,1,TRUE,17354,19609,2944,26.3,FALSE,0,FALSE,14410,16517,-2944,23.2
TRUE,FALSE,1,TRUE,19718,20453,3614,21.5,TRUE,1,FALSE,16104,17079,-3614,19.2
TRUE,FALSE,1,TRUE,20245,18815,4733,24.5,TRUE,0,FALSE,15512,17146,-4733,18.2
FALSE,FALSE,0,FALSE,15869,16808,-4369,16.2,TRUE,1,TRUE,20238,20132,4369,24.2
FALSE,FALSE,0,FALSE,15321,16450,-4562,19.8,TRUE,1,FALSE,19883,19266,4562,22.2
FALSE,TRUE,0,FALSE,16293,18611,-176,21.8,FALSE,0,FALSE,16469,18260,176,20.3
TRUE,TRUE,2,TRUE,19669,19333,4456,22,FALSE,0,FALSE,15213,16995,-4456,19.6
FALSE,FALSE,1,TRUE,17093,18200,-492,21.7,TRUE,0,FALSE,17585,18025,492,21.4
TRUE,TRUE,1,TRUE,17434,18954,4612,25.7,FALSE,0,FALSE,12822,15106,-4612,20.3
TRUE,FALSE,0,FALSE,14250,17406,-1461,23.8,TRUE,2,TRUE,15711,17165,1461,22.8
TRUE,TRUE,1,FALSE,19104,17733,2241,20.4,FALSE,1,TRUE,16863,16656,-2241,20
FALSE,TRUE,0,FALSE,17700,18269,2986,21.6,FALSE,0,FALSE,14714,15819,-2986,15.4
TRUE,FALSE,0,FALSE,15687,18199,-423,20.6,TRUE,0,FALSE,16110,17483,423,21.9
TRUE,TRUE,0,FALSE,15866,18127,218,22.1,FALSE,1,TRUE,15648,18725,-218,21.9
TRUE,FALSE,2,TRUE,16079,19081,-1289,20.3,TRUE,0,FALSE,17368,18163,1289,26.4
TRUE,TRUE,0,FALSE,19610,20901,4491,22,FALSE,1,TRUE,15119,15326,-4491,18.6
TRUE,TRUE,0,FALSE,16597,17747,2296,23.2,FALSE,0,FALSE,14301,16974,-2296,15.3
FALSE,FALSE,0,FALSE,14211,17253,-1807,21.5,TRUE,1,TRUE,16018,19371,1807,25.2
TRUE,TRUE,2,TRUE,15897,19077,188,23.5,FALSE,0,FALSE,15709,17918,-188,25.5
FALSE,FALSE,1,TRUE,15740,14844,-5057,17.8,TRUE,0,FALSE,20797,18765,5057,23.8
FALSE,FALSE,1,TRUE,17170,18831,-815,23.7,TRUE,0,FALSE,17985,19530,815,24.4
TRUE,TRUE,0,FALSE,15950,17900,-365,23.5,FALSE,0,FALSE,16315,18334,365,22.5
TRUE,TRUE,0,FALSE,17990,19289,2964,22.6,FALSE,1,TRUE,15026,17036,-2964,23.2
FALSE,TRUE,1,FALSE,15749,19614,362,23.5,FALSE,1,TRUE,15387,18725,-362,22.6
FALSE,TRUE,1,TRUE,15317,16907,-1300,22.6,FALSE,1,FALSE,16617,17027,1300,21.1
TRUE,FALSE,0,FALSE,16896,19116,1447,22.5,TRUE,1,TRUE,15449,16493,-1447,19
FALSE,FALSE,0,FALSE,15085,17193,-2695,23.1,TRUE,0,FALSE,17780,17345,2695,21.8
TRUE,TRUE,1,FALSE,17790,18908,1477,20.3,FALSE,0,FALSE,16313,18217,-1477,20.8
TRUE,FALSE,1,TRUE,15245,17542,-2220,21,TRUE,0,FALSE,17465,19034,2220,21.8
FALSE,TRUE,2,TRUE,18654,17865,3054,22.6,FALSE,0,FALSE,15600,17426,-3054,22.1
FALSE,FALSE,0,FALSE,14266,18401,-1659,22.3,TRUE,1,TRUE,15925,19275,1659,23.6
TRUE,TRUE,0,FALSE,17742,18190,1311,18.5,FALSE,1,TRUE,16431,17633,-1311,23.2
TRUE,TRUE,1,TRUE,17610,18827,1677,22.1,FALSE,0,FALSE,15933,18018,-1677,21.2
FALSE,FALSE,0,FALSE,15921,17466,-1110,20.3,TRUE,0,FALSE,17031,18187,1110,21.5
FALSE,FALSE,0,FALSE,16860,17641,1293,21.8,TRUE,0,FALSE,15567,17903,-1293,21.9
FALSE,FALSE,0,FALSE,13842,15669,-4256,18.1,TRUE,1,TRUE,18098,18988,4256,24
TRUE,FALSE,1,TRUE,17378,19405,3268,25.3,TRUE,0,FALSE,14110,16755,-3268,21.2
TRUE,FALSE,1,TRUE,15979,18795,1027,26,TRUE,0,FALSE,14952,18180,-1027,21.9
FALSE,TRUE,0,FALSE,15475,17551,-1892,21.6,FALSE,1,TRUE,17367,19678,1892,21.1
TRUE,TRUE,0,FALSE,17077,16964,2537,22.8,FALSE,0,FALSE,14540,15568,-2537,20.8
FALSE,FALSE,0,FALSE,14294,17770,-3738,20.6,TRUE,2,TRUE,18032,19030,3738,22.9
FALSE,FALSE,0,FALSE,14504,16668,-3966,20.3,TRUE,1,TRUE,18470,19780,3966,19.2
TRUE,FALSE,0,FALSE,18022,19347,1382,20.2,TRUE,1,FALSE,16640,17240,-1382,18.6
FALSE,TRUE,2,TRUE,15390,17555,-544,23,FALSE,0,FALSE,15934,17401,544,21.6
FALSE,FALSE,0,FALSE,17251,17267,339,19.2,TRUE,0,FALSE,16912,16391,-339,20.3
FALSE,TRUE,0,FALSE,15337,17008,-2284,18.6,FALSE,1,TRUE,17621,20227,2284,23
TRUE,FALSE,1,FALSE,16498,18955,468,21.9,TRUE,0,FALSE,16030,16864,-468,23.7
TRUE,TRUE,1,TRUE,17359,18203,3098,21.9,FALSE,1,FALSE,14261,16321,-3098,21.3
TRUE,TRUE,0,FALSE,20346,19902,5797,22.8,FALSE,1,TRUE,14549,15538,-5797,20.3
FALSE,FALSE,1,TRUE,17711,18722,1127,23.8,TRUE,0,FALSE,16584,18094,-1127,24.6
FALSE,FALSE,0,FALSE,15089,17046,-494,21.3,TRUE,2,TRUE,15583,17863,494,21.6
FALSE,FALSE,0,FALSE,15077,15707,-7278,13.8,TRUE,0,FALSE,22355,21728,7278,22.9
TRUE,TRUE,1,TRUE,15519,17775,-859,23.6,FALSE,0,FALSE,16378,19277,859,23.7
TRUE,TRUE,0,FALSE,16003,17857,-1761,21.4,FALSE,0,FALSE,17764,19303,1761,23.8
FALSE,TRUE,0,FALSE,16270,18684,454,24.8,FALSE,1,TRUE,15816,18351,-454,25.7
FALSE,FALSE,0,FALSE,17917,19033,39,23.4,TRUE,1,TRUE,17878,19060,-39,18
TRUE,FALSE,0,FALSE,18099,18989,2420,23.8,TRUE,1,TRUE,15679,16717,-2420,21.8
TRUE,TRUE,1,TRUE,16073,18021,-570,19.6,FALSE,0,FALSE,16643,17554,570,21.5
TRUE,TRUE,1,FALSE,15887,17744,1323,24,FALSE,1,TRUE,14564,17698,-1323,20.8
FALSE,FALSE,0,FALSE,14486,15962,-3299,17,TRUE,2,TRUE,17785,18681,3299,25.6
FALSE,TRUE,0,FALSE,14635,17734,-1478,23.5,FALSE,0,FALSE,16113,19122,1478,24.6
TRUE,TRUE,1,TRUE,18928,18365,4165,21,FALSE,1,FALSE,14763,16135,-4165,19.7
TRUE,FALSE,1,FALSE,15649,17358,-2558,18.5,TRUE,0,FALSE,18207,18186,2558,22.9
TRUE,FALSE,0,FALSE,16291,18127,473,22.7,TRUE,0,FALSE,15818,16546,-473,22
TRUE,TRUE,1,TRUE,16523,18465,1284,23.8,FALSE,0,FALSE,15239,17020,-1284,23.9
FALSE,FALSE,1,FALSE,15084,17618,-3847,18.8,TRUE,1,TRUE,18931,18551,3847,23.2
TRUE,FALSE,0,FALSE,16146,17725,1136,21,TRUE,1,TRUE,15010,17349,-1136,19.8
TRUE,TRUE,1,TRUE,16945,17981,2136,22.3,FALSE,0,FALSE,14809,18031,-2136,23.8
TRUE,TRUE,0,FALSE,16600,18970,735,20.8,FALSE,1,TRUE,15865,18809,-735,25.2
TRUE,FALSE,1,TRUE,16941,19352,-441,22.8,TRUE,0,FALSE,17382,18962,441,23.3
TRUE,FALSE,1,TRUE,15862,17707,-152,22.7,TRUE,1,FALSE,16014,18137,152,21
TRUE,FALSE,2,TRUE,18526,19693,1924,22.2,TRUE,0,FALSE,16602,17701,-1924,24
TRUE,FALSE,0,FALSE,14399,18382,-621,22.9,TRUE,0,FALSE,15020,18063,621,22.8
TRUE,TRUE,1,TRUE,16496,17575,615,21.3,FALSE,0,FALSE,15881,17563,-615,22.7
TRUE,TRUE,1,TRUE,16521,18785,2101,26.1,FALSE,0,FALSE,14420,17385,-2101,21.5
FALSE,FALSE,1,TRUE,16972,18035,-1079,21,TRUE,0,FALSE,18051,20327,1079,20.9
FALSE,FALSE,0,FALSE,16375,18609,-1189,23.1,TRUE,1,TRUE,17564,19683,1189,21.7
FALSE,FALSE,0,FALSE,17149,18495,-1258,21.8,TRUE,1,TRUE,18407,19220,1258,21.4
FALSE,TRUE,0,FALSE,15319,16582,-2416,15.8,FALSE,1,TRUE,17735,19390,2416,20.9
TRUE,TRUE,0,FALSE,19475,18495,4519,21.8,FALSE,0,FALSE,14956,15643,-4519,18.9
TRUE,TRUE,2,TRUE,18576,20102,2276,22.7,FALSE,0,FALSE,16300,18131,-2276,21.3
TRUE,TRUE,2,TRUE,20218,18749,4266,20.7,FALSE,0,FALSE,15952,15839,-4266,22.6
FALSE,FALSE,1,TRUE,15398,17861,378,20,TRUE,1,FALSE,15020,17540,-378,22.7
TRUE,FALSE,1,TRUE,19683,19202,879,19.5,TRUE,0,FALSE,18804,17407,-879,17.9
TRUE,TRUE,0,FALSE,17284,15506,550,18.2,FALSE,0,FALSE,16734,15877,-550,19.2
TRUE,FALSE,0,FALSE,18281,17603,2064,22.4,TRUE,0,FALSE,16217,15479,-2064,19.1
TRUE,FALSE,0,FALSE,16905,17224,831,21.4,TRUE,1,TRUE,16074,17216,-831,21.8
TRUE,TRUE,0,FALSE,16875,17964,2590,22.2,FALSE,1,TRUE,14285,17282,-2590,22.5
TRUE,FALSE,0,FALSE,16277,17277,1434,21,TRUE,0,FALSE,14843,16237,-1434,21.5
TRUE,TRUE,0,FALSE,18380,18318,1938,22,FALSE,0,FALSE,16442,17305,-1938,18.9
TRUE,FALSE,0,FALSE,16622,16799,-1129,17,TRUE,1,TRUE,17751,18541,1129,21.1
FALSE,FALSE,0,FALSE,16388,16720,-1182,21.2,TRUE,1,TRUE,17570,19450,1182,22.9
TRUE,TRUE,0,FALSE,17441,19668,2947,21.4,FALSE,1,FALSE,14494,17421,-2947,19
TRUE,TRUE,0,FALSE,17469,18265,1625,24.2,FALSE,0,FALSE,15844,18144,-1625,23.6
FALSE,FALSE,0,FALSE,15649,17079,-934,20.1,TRUE,1,TRUE,16583,17811,934,21.6
TRUE,TRUE,1,TRUE,18130,19017,3154,20.6,FALSE,1,FALSE,14976,17297,-3154,19.4
FALSE,TRUE,0,FALSE,17850,19495,30,25.6,FALSE,1,TRUE,17820,19744,-30,23.4
FALSE,FALSE,0,FALSE,16164,18803,-1050,23.9,TRUE,1,TRUE,17214,18715,1050,23.7
FALSE,TRUE,2,TRUE,15928,16033,-1885,17.3,FALSE,0,FALSE,17813,17058,1885,23.3
TRUE,TRUE,0,FALSE,15356,16499,925,23.3,FALSE,0,FALSE,14431,16899,-925,20.6
FALSE,TRUE,0,FALSE,16135,16582,-1370,18.1,FALSE,0,FALSE,17505,17802,1370,23.5
TRUE,TRUE,0,FALSE,16019,20401,1577,26.2,FALSE,1,TRUE,14442,17819,-1577,23.2
TRUE,FALSE,1,TRUE,16079,17138,1769,22.5,TRUE,0,FALSE,14310,15963,-1769,18.5
TRUE,TRUE,1,TRUE,18272,20304,3619,21.9,FALSE,0,FALSE,14653,17112,-3619,22.2
TRUE,TRUE,0,FALSE,15595,17779,65,24.1,FALSE,1,TRUE,15530,18052,-65,22.8
TRUE,TRUE,1,TRUE,20010,20053,4311,20.8,FALSE,0,FALSE,15699,17481,-4311,21.4
FALSE,FALSE,1,TRUE,16879,18288,45,19.9,TRUE,0,FALSE,16834,18639,-45,25.4
FALSE,TRUE,1,FALSE,15578,18183,-313,24.3,FALSE,1,TRUE,15891,18884,313,25.3
TRUE,TRUE,0,FALSE,18877,20418,3094,24.4,FALSE,0,FALSE,15783,18419,-3094,20.5
TRUE,FALSE,0,FALSE,18904,18979,4879,23.6,TRUE,0,FALSE,14025,15205,-4879,16.2
FALSE,TRUE,1,TRUE,17394,16652,182,17.5,FALSE,0,FALSE,17212,16811,-182,19.2
FALSE,FALSE,2,TRUE,16829,19002,-1212,25.1,TRUE,0,FALSE,18041,18030,1212,23.6
FALSE,TRUE,2,TRUE,17002,18865,-365,20.9,FALSE,0,FALSE,17367,19132,365,22.9
FALSE,TRUE,0,FALSE,15721,17191,-24,18,FALSE,0,FALSE,15745,18261,24,23.8
TRUE,FALSE,1,TRUE,16263,16904,-1190,22,TRUE,0,FALSE,17453,18347,1190,20.8
TRUE,TRUE,0,FALSE,15833,16967,-1800,20.8,FALSE,1,TRUE,17633,19167,1800,24.5
FALSE,FALSE,0,FALSE,14918,17605,-2442,22.1,TRUE,1,TRUE,17360,19032,2442,26.2
FALSE,TRUE,0,FALSE,15043,16533,-2816,20.7,FALSE,1,TRUE,17859,19293,2816,23.2
TRUE,TRUE,1,TRUE,17775,18094,3629,22.2,FALSE,0,FALSE,14146,12983,-3629,12.3
TRUE,TRUE,0,FALSE,20012,19043,4093,23.1,FALSE,1,TRUE,15919,17118,-4093,21.5
FALSE,FALSE,1,TRUE,15954,18014,26,22.8,TRUE,0,FALSE,15928,17321,-26,19
TRUE,FALSE,2,TRUE,14194,17765,-1949,19.2,TRUE,0,FALSE,16143,17783,1949,19
TRUE,FALSE,0,FALSE,14689,16546,-3860,17.4,TRUE,2,TRUE,18549,18265,3860,25.3
FALSE,TRUE,0,FALSE,18152,18229,-921,24.5,FALSE,1,TRUE,19073,19427,921,20.6
FALSE,FALSE,1,TRUE,16642,18251,-348,21.8,TRUE,1,FALSE,16990,18862,348,23.7
FALSE,FALSE,0,FALSE,13383,15553,-4079,19.3,TRUE,1,TRUE,17462,18547,4079,24.5
FALSE,FALSE,0,FALSE,16818,18786,936,23.2,TRUE,2,TRUE,15882,18082,-936,22.1
FALSE,FALSE,0,FALSE,16621,17456,-2115,24.4,TRUE,2,TRUE,18736,17912,2115,22.2
TRUE,TRUE,1,TRUE,16729,17848,1204,22,FALSE,0,FALSE,15525,17499,-1204,21.4
FALSE,TRUE,0,FALSE,14630,16137,-1309,18.1,FALSE,1,TRUE,15939,17545,1309,21.2
FALSE,TRUE,0,FALSE,16489,17669,1212,23.7,FALSE,1,TRUE,15277,16562,-1212,19.6
FALSE,FALSE,0,FALSE,13608,15291,-5040,17.8,TRUE,0,FALSE,18648,21409,5040,20.2
TRUE,TRUE,1,TRUE,16583,18572,2532,24.4,FALSE,0,FALSE,14051,16850,-2532,22.3
TRUE,TRUE,2,TRUE,19439,19736,3863,24.4,FALSE,0,FALSE,15576,17097,-3863,19.7
FALSE,FALSE,1,FALSE,15974,18618,-2545,22.6,TRUE,1,TRUE,18519,20159,2545,24.7
TRUE,TRUE,0,FALSE,15865,18037,-517,22.5,FALSE,1,TRUE,16382,18462,517,24.4
FALSE,FALSE,0,FALSE,15919,16708,-3288,20.5,TRUE,2,TRUE,19207,19219,3288,22.9
TRUE,TRUE,1,FALSE,15360,18594,818,20.7,FALSE,1,TRUE,14542,16681,-818,22.4
FALSE,TRUE,1,TRUE,16836,17688,312,18.6,FALSE,0,FALSE,16524,18301,-312,21.5
TRUE,TRUE,0,FALSE,16284,18617,1496,21.6,FALSE,0,FALSE,14788,16859,-1496,22.5
TRUE,TRUE,1,TRUE,18303,19093,3586,21.4,FALSE,0,FALSE,14717,16396,-3586,18
FALSE,FALSE,0,FALSE,16206,17906,-33,22.9,TRUE,1,TRUE,16239,16673,33,20
TRUE,TRUE,0,FALSE,17310,18101,390,20.2,FALSE,1,TRUE,16920,18401,-390,19.3
TRUE,FALSE,0,FALSE,14562,15925,-1295,16.4,TRUE,1,TRUE,15857,17155,1295,21.3
FALSE,TRUE,0,FALSE,15954,17647,534,20.3,FALSE,1,TRUE,15420,17558,-534,24.8
FALSE,FALSE,1,TRUE,14079,16131,-4780,21.5,TRUE,0,FALSE,18859,19556,4780,21.4
FALSE,TRUE,0,FALSE,16636,18650,668,24.3,FALSE,1,TRUE,15968,19112,-668,22.3
FALSE,FALSE,0,FALSE,16048,16740,-2954,20.9,TRUE,0,FALSE,19002,19605,2954,20.6
FALSE,TRUE,0,FALSE,14953,17005,-3903,22.1,FALSE,1,TRUE,18856,19095,3903,23.9
TRUE,TRUE,0,FALSE,16279,18714,2004,25.5,FALSE,1,TRUE,14275,18329,-2004,21.3
FALSE,FALSE,0,FALSE,13841,16368,-5048,21.6,TRUE,1,TRUE,18889,20513,5048,26.8
FALSE,FALSE,0,FALSE,15311,17731,597,18.7,TRUE,1,TRUE,14714,16135,-597,21.2
FALSE,TRUE,2,TRUE,16677,15835,-503,16.8,FALSE,0,FALSE,17180,16625,503,19.1
FALSE,FALSE,0,FALSE,16224,18263,-376,18.9,TRUE,1,TRUE,16600,17258,376,22
TRUE,FALSE,2,TRUE,16372,19294,1162,20.8,TRUE,0,FALSE,15210,17216,-1162,19.3
TRUE,TRUE,1,TRUE,19306,19450,5831,20.6,FALSE,0,FALSE,13475,14862,-5831,19.7
TRUE,TRUE,0,FALSE,18801,19438,1917,21.5,FALSE,1,TRUE,16884,18116,-1917,20.2
TRUE,TRUE,1,TRUE,16988,18314,3222,20.9,FALSE,0,FALSE,13766,16109,-3222,21.8
FALSE,FALSE,0,FALSE,15027,16491,-3148,21.6,TRUE,1,TRUE,18175,18598,3148,22
FALSE,FALSE,1,TRUE,15512,17704,-2399,19.8,TRUE,0,FALSE,17911,19231,2399,22.2
FALSE,FALSE,1,FALSE,17147,17894,946,21.3,TRUE,1,TRUE,16201,18333,-946,22.2
TRUE,FALSE,1,FALSE,16748,17820,2533,22.1,TRUE,1,TRUE,14215,16296,-2533,19.8
FALSE,FALSE,0,FALSE,14456,17039,-4680,21.2,TRUE,2,TRUE,19136,20229,4680,22
TRUE,TRUE,1,TRUE,18247,18886,1348,22.5,FALSE,1,FALSE,16899,17728,-1348,22.4
TRUE,TRUE,0,FALSE,18196,19070,2763,23,FALSE,1,TRUE,15433,17403,-2763,19.4
TRUE,TRUE,1,TRUE,16866,18028,-808,22,FALSE,0,FALSE,17674,19106,808,23.4
FALSE,FALSE,1,TRUE,13960,16218,-2791,18.4,TRUE,0,FALSE,16751,18360,2791,23.8
FALSE,FALSE,0,FALSE,14545,16581,-1199,19,TRUE,1,TRUE,15744,17333,1199,20.3
TRUE,TRUE,1,TRUE,18894,18656,2712,19.5,FALSE,0,FALSE,16182,17475,-2712,19.5
FALSE,FALSE,0,FALSE,14595,15889,-4266,18.1,TRUE,1,TRUE,18861,19983,4266,24.5
TRUE,TRUE,1,FALSE,19670,19683,3380,23.9,FALSE,0,FALSE,16290,18017,-3380,19.7
TRUE,TRUE,1,TRUE,19116,19542,3648,22.3,FALSE,0,FALSE,15468,17675,-3648,20.9
TRUE,TRUE,0,FALSE,17186,18505,2320,23.4,FALSE,0,FALSE,14866,16271,-2320,20.7
FALSE,FALSE,0,FALSE,14498,17488,-1754,22.3,TRUE,0,FALSE,16252,18959,1754,22.8
TRUE,TRUE,2,TRUE,17085,18329,411,22.9,FALSE,0,FALSE,16674,18822,-411,21.3
TRUE,TRUE,1,TRUE,19032,19015,3965,19.1,FALSE,0,FALSE,15067,15510,-3965,18.2
FALSE,FALSE,0,FALSE,14401,17502,-3441,21.2,TRUE,1,TRUE,17842,19327,3441,22.9
TRUE,FALSE,1,TRUE,15741,17468,-1864,19.8,TRUE,0,FALSE,17605,18537,1864,20.5
TRUE,TRUE,0,FALSE,19138,18317,3653,23.9,FALSE,1,FALSE,15485,16764,-3653,19.3
TRUE,TRUE,1,FALSE,17363,18387,1449,23.3,FALSE,1,TRUE,15914,17866,-1449,20.6
FALSE,FALSE,0,FALSE,15190,18432,-1782,24.1,TRUE,1,TRUE,16972,19186,1782,25.1
FALSE,TRUE,2,TRUE,15592,18837,-1711,20.5,FALSE,0,FALSE,17303,19140,1711,24.1
TRUE,FALSE,0,FALSE,15951,17680,322,22.1,TRUE,0,FALSE,15629,16634,-322,20.3
FALSE,TRUE,0,FALSE,15934,16140,-2277,19.9,FALSE,1,TRUE,18211,19059,2277,25.7
TRUE,FALSE,0,FALSE,15894,18853,310,22.3,TRUE,1,TRUE,15584,18317,-310,22.3
FALSE,FALSE,0,FALSE,16148,18119,-404,23.7,TRUE,2,TRUE,16552,19177,404,21.5
FALSE,FALSE,0,FALSE,16456,16502,-706,20.9,TRUE,1,TRUE,17162,17962,706,20
FALSE,TRUE,2,TRUE,17903,18746,651,23.9,FALSE,0,FALSE,17252,17998,-651,21.7
TRUE,TRUE,0,FALSE,16925,17065,784,21.2,FALSE,0,FALSE,16141,19994,-784,22.4
FALSE,TRUE,1,TRUE,14966,17656,-1966,22.7,FALSE,1,FALSE,16932,19205,1966,24.7
TRUE,FALSE,1,FALSE,16014,18062,-2651,21.1,TRUE,1,TRUE,18665,19351,2651,24
FALSE,FALSE,0,FALSE,15311,18263,-1731,22.9,TRUE,1,TRUE,17042,19816,1731,23.8
FALSE,TRUE,0,FALSE,16177,18367,1255,22.6,FALSE,0,FALSE,14922,18090,-1255,25.3
TRUE,FALSE,0,FALSE,16123,17612,569,20.3,TRUE,1,TRUE,15554,17308,-569,18.1
FALSE,TRUE,0,FALSE,18344,18470,2326,22.2,FALSE,0,FALSE,16018,17483,-2326,18.8
FALSE,TRUE,1,FALSE,17564,20203,1369,25.7,FALSE,1,TRUE,16195,18763,-1369,23.3
TRUE,FALSE,1,TRUE,15676,19069,-261,23.1,TRUE,1,FALSE,15937,18626,261,23.1
FALSE,FALSE,0,FALSE,15652,18830,11,25.8,TRUE,2,TRUE,15641,18969,-11,22.7
TRUE,FALSE,1,TRUE,18079,18997,1120,21.5,TRUE,0,FALSE,16959,18987,-1120,22.6
FALSE,FALSE,0,FALSE,14325,17432,-1887,23.5,TRUE,1,TRUE,16212,18019,1887,22.8
FALSE,FALSE,0,FALSE,16132,17519,-155,21,TRUE,0,FALSE,16287,17570,155,19.1
TRUE,TRUE,0,FALSE,17130,18124,1931,22.6,FALSE,0,FALSE,15199,16557,-1931,21.9
TRUE,TRUE,1,TRUE,19459,17657,1896,20.6,FALSE,0,FALSE,17563,18080,-1896,21.5
FALSE,TRUE,0,FALSE,15742,17504,501,21.9,FALSE,1,TRUE,15241,16862,-501,19.6
FALSE,FALSE,1,FALSE,15412,17498,-1271,19.2,TRUE,0,FALSE,16683,17397,1271,23.3
TRUE,FALSE,0,FALSE,15337,16778,-2811,21.7,TRUE,1,TRUE,18148,19076,2811,22.4
FALSE,TRUE,1,TRUE,15969,17823,-1070,21.7,FALSE,0,FALSE,17039,18716,1070,25.4
TRUE,FALSE,0,FALSE,16347,16992,-559,18.5,TRUE,1,FALSE,16906,17786,559,21.5
TRUE,TRUE,0,FALSE,20341,19192,3202,23.5,FALSE,1,TRUE,17139,16725,-3202,18.9
FALSE,TRUE,0,FALSE,16507,18410,731,22.8,FALSE,1,FALSE,15776,18366,-731,20.3
FALSE,FALSE,1,TRUE,13649,17258,-2497,19.9,TRUE,0,FALSE,16146,18497,2497,21.1
FALSE,TRUE,0,FALSE,15377,15779,-4853,19.1,FALSE,0,FALSE,20230,19317,4853,23
FALSE,TRUE,1,FALSE,15345,18848,-164,23,FALSE,1,TRUE,15509,17490,164,23.6
FALSE,TRUE,0,FALSE,14426,16666,-3954,20.5,FALSE,1,TRUE,18380,18606,3954,25.4
FALSE,FALSE,1,TRUE,16518,18036,176,22.9,TRUE,0,FALSE,16342,17093,-176,20
FALSE,FALSE,1,TRUE,14112,17265,-2720,23.2,TRUE,1,FALSE,16832,19684,2720,24.7
FALSE,FALSE,0,FALSE,16809,19023,226,22.5,TRUE,2,TRUE,16583,18466,-226,23.9
FALSE,TRUE,1,TRUE,17011,18754,-2215,23.1,FALSE,1,FALSE,19226,18892,2215,20.6
FALSE,TRUE,1,TRUE,16928,18438,1071,23.6,FALSE,0,FALSE,15857,18473,-1071,25.4
FALSE,FALSE,0,FALSE,14016,16299,-4534,19,TRUE,1,TRUE,18550,19008,4534,22.8
TRUE,FALSE,0,FALSE,16082,17134,287,19.9,TRUE,0,FALSE,15795,16845,-287,20.9
TRUE,TRUE,2,TRUE,18851,19537,4064,23,FALSE,0,FALSE,14787,16973,-4064,19.5
TRUE,TRUE,2,TRUE,19994,20865,5475,24.8,FALSE,0,FALSE,14519,17152,-5475,21.7
FALSE,FALSE,0,FALSE,17935,18860,2070,22.6,TRUE,0,FALSE,15865,17529,-2070,21.4
FALSE,FALSE,0,FALSE,13539,15736,-5293,16.3,TRUE,0,FALSE,18832,19513,5293,23.6
FALSE,FALSE,0,FALSE,13874,17105,-4231,20.3,TRUE,1,TRUE,18105,20263,4231,24.8
TRUE,TRUE,0,FALSE,16920,17906,1563,20.4,FALSE,0,FALSE,15357,17005,-1563,17.8
TRUE,FALSE,0,FALSE,17484,18682,-978,22.2,TRUE,1,TRUE,18462,19217,978,21.3
FALSE,FALSE,0,FALSE,16731,17994,-1625,19.1,TRUE,0,FALSE,18356,18436,1625,22.9
FALSE,FALSE,0,FALSE,16374,17432,-255,19.4,TRUE,1,TRUE,16629,16304,255,19.4
FALSE,TRUE,1,TRUE,15706,18183,-578,21.9,FALSE,0,FALSE,16284,19332,578,24
FALSE,TRUE,1,TRUE,14368,16711,-5683,20.1,FALSE,0,FALSE,20051,21967,5683,27
FALSE,TRUE,0,FALSE,15081,15753,-1492,19.5,FALSE,0,FALSE,16573,16972,1492,21.8
FALSE,FALSE,0,FALSE,16077,16712,-3056,18,TRUE,0,FALSE,19133,19174,3056,22.3
FALSE,FALSE,0,FALSE,15092,18501,-1857,20.4,TRUE,2,TRUE,16949,19200,1857,25.2
TRUE,FALSE,1,TRUE,14986,17946,-2042,22,TRUE,1,FALSE,17028,18382,2042,23.2
TRUE,TRUE,1,TRUE,16894,19048,2647,23.4,FALSE,0,FALSE,14247,17908,-2647,21.7
FALSE,FALSE,0,FALSE,14525,16786,-5011,20.1,TRUE,0,FALSE,19536,19230,5011,24.4
TRUE,TRUE,1,FALSE,18618,19304,4343,22.3,FALSE,0,FALSE,14275,16668,-4343,19
FALSE,FALSE,0,FALSE,15345,17067,-192,22.6,TRUE,2,TRUE,15537,17354,192,19.1
TRUE,FALSE,1,TRUE,17967,18521,3066,20.9,TRUE,0,FALSE,14901,15723,-3066,17.7
TRUE,TRUE,0,FALSE,19484,19688,4694,23.5,FALSE,2,TRUE,14790,16907,-4694,19.6
FALSE,FALSE,0,FALSE,14508,17217,-3968,20,TRUE,2,TRUE,18476,19678,3968,24.3
TRUE,TRUE,1,TRUE,17505,19310,786,22.3,FALSE,0,FALSE,16719,17422,-786,22
TRUE,TRUE,0,FALSE,17428,18741,2444,21.9,FALSE,1,TRUE,14984,18180,-2444,24.2
TRUE,TRUE,0,FALSE,17336,19025,691,21.8,FALSE,0,FALSE,16645,18329,-691,19.2
TRUE,FALSE,1,TRUE,15386,17872,-2820,20.9,TRUE,0,FALSE,18206,19015,2820,22.9
TRUE,FALSE,1,TRUE,16353,18091,246,24,TRUE,0,FALSE,16107,17874,-246,22.7
TRUE,FALSE,0,FALSE,16697,18511,-864,21.1,TRUE,0,FALSE,17561,19376,864,22.6
TRUE,FALSE,1,TRUE,14850,17967,-858,22.6,TRUE,0,FALSE,15708,17120,858,23.9
FALSE,FALSE,0,FALSE,14879,16931,-1775,21.7,TRUE,0,FALSE,16654,17653,1775,21.5
FALSE,TRUE,1,TRUE,18454,19370,1455,23,FALSE,0,FALSE,16999,18768,-1455,24.7
TRUE,FALSE,0,FALSE,14334,18293,-1878,24.2,TRUE,1,TRUE,16212,18471,1878,26.2
TRUE,FALSE,1,TRUE,17490,18903,2755,23.3,TRUE,1,FALSE,14735,17411,-2755,19.7
TRUE,TRUE,1,TRUE,19526,19551,3003,22.5,FALSE,0,FALSE,16523,16488,-3003,20
TRUE,TRUE,1,TRUE,18439,18689,1894,22.3,FALSE,0,FALSE,16545,18590,-1894,20.3
FALSE,TRUE,1,TRUE,17375,18906,-522,21,FALSE,1,FALSE,17897,18637,522,19
TRUE,FALSE,1,TRUE,17367,19496,1992,21.5,TRUE,0,FALSE,15375,17400,-1992,21.1
TRUE,FALSE,0,FALSE,16354,18198,-1256,21.3,TRUE,2,TRUE,17610,18757,1256,22.6
FALSE,FALSE,0,FALSE,15708,17420,-1127,22,TRUE,0,FALSE,16835,19426,1127,22.6
FALSE,TRUE,2,TRUE,15427,16873,-1186,20.9,FALSE,0,FALSE,16613,18633,1186,23
FALSE,TRUE,2,TRUE,16851,17153,-1328,19,FALSE,0,FALSE,18179,18295,1328,22.7
FALSE,TRUE,0,FALSE,15786,16824,-1818,19.3,FALSE,1,TRUE,17604,18885,1818,24.6
FALSE,TRUE,0,FALSE,16319,17715,-1228,21.7,FALSE,0,FALSE,17547,17704,1228,19.1
FALSE,TRUE,1,TRUE,14324,16757,-2638,21.1,FALSE,0,FALSE,16962,18428,2638,24.4
TRUE,FALSE,0,FALSE,16064,17943,41,18.1,TRUE,2,TRUE,16023,17765,-41,20.6
TRUE,TRUE,1,TRUE,18013,18223,1446,22.8,FALSE,0,FALSE,16567,18366,-1446,21.6
FALSE,FALSE,0,FALSE,15890,17797,-2782,22.9,TRUE,1,TRUE,18672,19539,2782,23.5
FALSE,FALSE,0,FALSE,15492,17869,-310,21.8,TRUE,1,TRUE,15802,18261,310,19.2
FALSE,TRUE,0,FALSE,16281,18349,699,21.9,FALSE,1,TRUE,15582,18603,-699,20
FALSE,FALSE,1,TRUE,15032,18462,-2785,23.2,TRUE,1,FALSE,17817,18915,2785,22.8
FALSE,FALSE,0,FALSE,16777,19056,-1681,21.9,TRUE,0,FALSE,18458,19015,1681,24.1
FALSE,TRUE,0,FALSE,15708,16783,-189,19.7,FALSE,1,FALSE,15897,16994,189,24.4
TRUE,FALSE,1,TRUE,17505,18661,791,24,TRUE,0,FALSE,16714,17523,-791,23.4
FALSE,FALSE,1,TRUE,15889,16752,-1248,22,TRUE,0,FALSE,17137,16249,1248,19.1
FALSE,TRUE,1,TRUE,19031,18999,4188,23.4,FALSE,1,FALSE,14843,16600,-4188,20.7
TRUE,FALSE,0,FALSE,18581,19769,3301,24.9,TRUE,1,TRUE,15280,16422,-3301,21.3
FALSE,TRUE,0,FALSE,14796,16514,-2944,22.5,FALSE,1,TRUE,17740,19349,2944,23.1
FALSE,FALSE,1,TRUE,17429,19044,2800,23.9,TRUE,0,FALSE,14629,16570,-2800,19.7
FALSE,FALSE,1,TRUE,17686,19734,1178,23.6,TRUE,1,FALSE,16508,17511,-1178,18.7
FALSE,FALSE,0,FALSE,16158,18018,-900,21.3,TRUE,2,TRUE,17058,17751,900,17.7
FALSE,FALSE,0,FALSE,14471,16470,-4204,16.9,TRUE,2,TRUE,18675,18608,4204,22.7
TRUE,TRUE,1,TRUE,17419,18137,2196,20.9,FALSE,0,FALSE,15223,16892,-2196,19.2
TRUE,FALSE,1,FALSE,17859,17682,1711,22.1,TRUE,0,FALSE,16148,17418,-1711,20.9
TRUE,FALSE,0,FALSE,14546,16662,-2560,20,TRUE,1,TRUE,17106,17937,2560,20.3
FALSE,FALSE,1,TRUE,17373,16452,-1768,17.8,TRUE,0,FALSE,19141,18682,1768,19.8
TRUE,FALSE,0,FALSE,17239,18395,1436,20.9,TRUE,0,FALSE,15803,16571,-1436,22.5
FALSE,TRUE,0,FALSE,18178,17725,342,21.3,FALSE,1,TRUE,17836,18371,-342,22.2
FALSE,FALSE,1,TRUE,16690,17356,170,21.5,TRUE,0,FALSE,16520,16182,-170,18.9
FALSE,FALSE,0,FALSE,13508,15474,-5373,18.6,TRUE,2,TRUE,18881,19948,5373,24.1
FALSE,FALSE,0,FALSE,17122,19090,360,23.6,TRUE,1,TRUE,16762,17988,-360,18.7
FALSE,TRUE,0,FALSE,16429,17419,-448,22.6,FALSE,1,TRUE,16877,18559,448,23.3
TRUE,FALSE,0,FALSE,17556,17097,-2089,19.2,TRUE,0,FALSE,19645,17932,2089,18.6
FALSE,FALSE,0,FALSE,14635,16718,-3709,20.2,TRUE,1,TRUE,18344,17735,3709,23.1
TRUE,TRUE,0,FALSE,17890,18682,2961,22.6,FALSE,0,FALSE,14929,16055,-2961,20.7
FALSE,FALSE,0,FALSE,12884,15586,-2825,17.4,TRUE,1,TRUE,15709,18691,2825,23.9
FALSE,TRUE,1,TRUE,17160,17725,2841,19.1,FALSE,0,FALSE,14319,16241,-2841,20.8
FALSE,FALSE,0,FALSE,14416,16951,-3253,18.5,TRUE,1,TRUE,17669,20000,3253,22.9
TRUE,FALSE,0,FALSE,18165,18510,2746,21.9,TRUE,0,FALSE,15419,17511,-2746,20.6
FALSE,FALSE,0,FALSE,14438,17107,-2502,19.9,TRUE,1,TRUE,16940,18918,2502,23.2
FALSE,FALSE,0,FALSE,16784,19211,-1270,19.6,TRUE,0,FALSE,18054,18188,1270,21
FALSE,FALSE,0,FALSE,15384,17040,-1495,18.9,TRUE,2,TRUE,16879,17841,1495,21.1
FALSE,TRUE,0,FALSE,14980,16246,-2432,23.2,FALSE,1,TRUE,17412,18034,2432,21.9
TRUE,TRUE,0,FALSE,18314,17903,3884,21.9,FALSE,1,TRUE,14430,15679,-3884,16.7
FALSE,FALSE,0,FALSE,16548,17735,-2133,22.4,TRUE,1,TRUE,18681,17991,2133,21.5
TRUE,TRUE,1,TRUE,18329,20471,4973,22.5,FALSE,0,FALSE,13356,17297,-4973,19.9
TRUE,TRUE,0,FALSE,16877,17631,338,21.6,FALSE,1,TRUE,16539,17903,-338,23
FALSE,FALSE,0,FALSE,14899,17420,-3099,23.2,TRUE,1,TRUE,17998,19115,3099,22.7
FALSE,FALSE,1,TRUE,15630,18026,-1655,23.6,TRUE,0,FALSE,17285,18907,1655,25.7
TRUE,TRUE,1,FALSE,18321,18428,2788,23,FALSE,0,FALSE,15533,17870,-2788,18.3
TRUE,FALSE,2,TRUE,17793,19322,508,21.5,TRUE,0,FALSE,17285,18158,-508,19.3
FALSE,FALSE,0,FALSE,14297,16721,-2955,23.5,TRUE,1,TRUE,17252,19775,2955,25.7
TRUE,FALSE,0,FALSE,15602,17116,-2082,21.6,TRUE,1,TRUE,17684,17643,2082,19.9
FALSE,TRUE,1,FALSE,17938,18626,3117,23.9,FALSE,1,TRUE,14821,17046,-3117,19.6
TRUE,TRUE,1,TRUE,17556,17943,2153,20.6,FALSE,0,FALSE,15403,17144,-2153,20.2
TRUE,TRUE,0,FALSE,15232,17793,-625,20.9,FALSE,0,FALSE,15857,18738,625,21.5
FALSE,FALSE,1,FALSE,15768,17528,-1657,23.3,TRUE,0,FALSE,17425,18728,1657,25.3
FALSE,FALSE,0,FALSE,14663,16086,-893,20.6,TRUE,0,FALSE,15556,16756,893,21.2
TRUE,TRUE,0,FALSE,17180,17511,1618,21.9,FALSE,1,TRUE,15562,16577,-1618,19.5
TRUE,FALSE,1,TRUE,16616,19895,958,24.6,TRUE,0,FALSE,15658,17292,-958,22.9
FALSE,FALSE,1,TRUE,14555,16722,-2459,23.2,TRUE,0,FALSE,17014,18832,2459,24.3
FALSE,FALSE,0,FALSE,15614,17578,-816,24.1,TRUE,1,TRUE,16430,17406,816,23.4
TRUE,TRUE,0,FALSE,16956,18863,3560,27,FALSE,0,FALSE,13396,16552,-3560,19.8
TRUE,FALSE,0,FALSE,17102,19068,2763,21.9,TRUE,0,FALSE,14339,16836,-2763,22.9
FALSE,TRUE,0,FALSE,14869,16447,-4659,18.8,FALSE,2,TRUE,19528,20331,4659,25.5
TRUE,TRUE,1,TRUE,15295,17054,98,21,FALSE,0,FALSE,15197,16078,-98,21.3
TRUE,TRUE,0,FALSE,16506,17581,1922,23.3,FALSE,0,FALSE,14584,16226,-1922,21.8
TRUE,TRUE,1,TRUE,18745,18917,4783,25.9,FALSE,1,FALSE,13962,16066,-4783,21.7
TRUE,TRUE,1,FALSE,18802,18463,2393,21.3,FALSE,1,TRUE,16409,17788,-2393,20.6
TRUE,TRUE,1,FALSE,18677,18208,1334,22,FALSE,1,TRUE,17343,18444,-1334,20.6
TRUE,TRUE,1,TRUE,20909,19188,3193,21,FALSE,0,FALSE,17716,17976,-3193,18.3
TRUE,TRUE,0,FALSE,17012,17394,-992,20.4,FALSE,1,TRUE,18004,17884,992,24
FALSE,FALSE,0,FALSE,16559,18604,715,20.5,TRUE,1,TRUE,15844,18059,-715,23.5
TRUE,TRUE,0,FALSE,19884,19673,1136,22.6,FALSE,0,FALSE,18748,16891,-1136,21.1
FALSE,FALSE,0,FALSE,14642,15759,-3133,18.9,TRUE,0,FALSE,17775,19562,3133,21.3
FALSE,FALSE,1,TRUE,14120,16943,-1443,21.7,TRUE,1,FALSE,15563,16979,1443,21.4
FALSE,FALSE,0,FALSE,15484,17528,-5634,18.8,TRUE,1,TRUE,21118,21315,5634,24.3
FALSE,TRUE,0,FALSE,15392,17891,1232,23.2,FALSE,1,TRUE,14160,17777,-1232,22.3
FALSE,TRUE,0,FALSE,16568,18504,-1163,23.9,FALSE,1,TRUE,17731,19634,1163,22.3
TRUE,TRUE,0,FALSE,17140,16531,-791,16.7,FALSE,0,FALSE,17931,17492,791,21.4
FALSE,FALSE,1,TRUE,16695,19057,-771,18.9,TRUE,0,FALSE,17466,18574,771,24.4
FALSE,FALSE,0,FALSE,17513,17486,-773,19.3,TRUE,1,TRUE,18286,18220,773,20.8
FALSE,FALSE,2,TRUE,17299,18331,-1143,21.8,TRUE,0,FALSE,18442,19778,1143,23.3
TRUE,FALSE,0,FALSE,16581,19116,1103,25.4,TRUE,0,FALSE,15478,17760,-1103,20.5
TRUE,TRUE,0,FALSE,17137,19582,1482,26.1,FALSE,2,TRUE,15655,19541,-1482,23
FALSE,FALSE,0,FALSE,16262,18196,591,20.7,TRUE,1,TRUE,15671,18004,-591,21.7
FALSE,FALSE,0,FALSE,15719,17678,-3558,21.1,TRUE,2,TRUE,19277,20024,3558,21.2
FALSE,FALSE,1,FALSE,15824,19141,225,22.1,TRUE,1,TRUE,15599,17737,-225,24.8
TRUE,FALSE,1,FALSE,17235,19304,3613,22.7,TRUE,0,FALSE,13622,15795,-3613,18.2
FALSE,TRUE,1,TRUE,17199,19299,1545,22.9,FALSE,0,FALSE,15654,17882,-1545,22.6
FALSE,TRUE,0,FALSE,15716,17405,-411,24.1,FALSE,1,TRUE,16127,19618,411,24.6
TRUE,FALSE,1,TRUE,17835,19830,2177,24.6,TRUE,0,FALSE,15658,18246,-2177,21.3
FALSE,FALSE,0,FALSE,10730,10826,-10830,14,TRUE,0,FALSE,21560,20159,10830,24.1
TRUE,TRUE,1,TRUE,18436,18190,2312,25,FALSE,0,FALSE,16124,17111,-2312,18.1
FALSE,FALSE,1,TRUE,14017,15335,-2309,18.5,TRUE,0,FALSE,16326,18008,2309,21.4
FALSE,TRUE,0,FALSE,15888,15944,-1696,19.5,FALSE,0,FALSE,17584,18479,1696,18.6
TRUE,TRUE,1,FALSE,17185,16790,-246,19.3,FALSE,0,FALSE,17431,17660,246,20.8
FALSE,TRUE,1,FALSE,15358,17220,543,22.3,FALSE,1,TRUE,14815,17844,-543,19.9
TRUE,TRUE,0,FALSE,15448,16856,58,18,FALSE,1,TRUE,15390,16653,-58,20.1
TRUE,TRUE,1,TRUE,17913,19123,2185,24.9,FALSE,0,FALSE,15728,17683,-2185,23.1
TRUE,TRUE,1,TRUE,16231,17392,124,22.2,FALSE,0,FALSE,16107,19651,-124,23.9
FALSE,FALSE,1,TRUE,14878,16786,-4657,21.3,TRUE,0,FALSE,19535,20786,4657,24.4
FALSE,FALSE,1,FALSE,15229,18526,511,24.2,TRUE,1,TRUE,14718,18555,-511,20.9
TRUE,FALSE,0,FALSE,19933,19756,4171,24.8,TRUE,1,TRUE,15762,16259,-4171,20.2
FALSE,FALSE,0,FALSE,14637,17059,-3368,21,TRUE,1,TRUE,18005,19646,3368,23.6
TRUE,FALSE,0,FALSE,16637,17846,-2368,21.9,TRUE,1,TRUE,19005,17228,2368,22.4
TRUE,TRUE,1,TRUE,16840,19004,-144,19.3,FALSE,0,FALSE,16984,19161,144,21.8
FALSE,FALSE,1,TRUE,14358,18106,-2128,19,TRUE,0,FALSE,16486,17842,2128,22.7
FALSE,TRUE,1,TRUE,15403,17392,-2613,24.2,FALSE,1,FALSE,18016,19366,2613,23
FALSE,FALSE,0,FALSE,16328,17459,-1325,22.1,TRUE,1,TRUE,17653,18418,1325,23.4
TRUE,TRUE,1,TRUE,16166,17100,-209,18.8,FALSE,0,FALSE,16375,17453,209,21.5
FALSE,FALSE,0,FALSE,13458,16195,-4232,22.1,TRUE,0,FALSE,17690,18651,4232,22.5
TRUE,FALSE,1,TRUE,15613,17643,-716,22.9,TRUE,0,FALSE,16329,17006,716,21.3
FALSE,FALSE,0,FALSE,16819,18039,1621,24.4,TRUE,1,TRUE,15198,17911,-1621,21.9
FALSE,FALSE,0,FALSE,14815,16969,-2541,22.1,TRUE,2,TRUE,17356,18890,2541,23.7
FALSE,FALSE,0,FALSE,16186,17103,-2072,20.7,TRUE,2,TRUE,18258,18458,2072,21.1
FALSE,FALSE,0,FALSE,16538,18285,239,25.3,TRUE,2,TRUE,16299,18590,-239,24.3
FALSE,FALSE,0,FALSE,14291,16706,-3378,17.8,TRUE,1,TRUE,17669,18788,3378,23.3
FALSE,TRUE,0,FALSE,15399,17209,-1589,21.7,FALSE,1,TRUE,16988,17784,1589,21
FALSE,FALSE,1,FALSE,13726,16098,-4474,18.4,TRUE,1,TRUE,18200,21314,4474,23.6
TRUE,FALSE,0,FALSE,17776,17464,90,21.1,TRUE,0,FALSE,17686,18004,-90,20.3
TRUE,TRUE,1,TRUE,18913,19076,1051,18.3,FALSE,0,FALSE,17862,19064,-1051,20.9
TRUE,TRUE,1,TRUE,17317,18842,2022,22.6,FALSE,0,FALSE,15295,17872,-2022,24.2
FALSE,TRUE,0,FALSE,17809,18479,2278,23.8,FALSE,0,FALSE,15531,16268,-2278,18.9
TRUE,TRUE,1,TRUE,16474,18843,2402,22.5,FALSE,0,FALSE,14072,16403,-2402,20.6
TRUE,FALSE,0,FALSE,16915,19035,-1716,21.4,TRUE,2,TRUE,18631,20129,1716,23.8
FALSE,FALSE,1,TRUE,14964,17928,-973,23.5,TRUE,0,FALSE,15937,19660,973,25.1
TRUE,FALSE,0,FALSE,19253,19378,3044,21.2,TRUE,1,TRUE,16209,18117,-3044,21.2
FALSE,FALSE,0,FALSE,14797,16690,-4265,21.3,TRUE,2,TRUE,19062,19880,4265,24.4
TRUE,FALSE,0,FALSE,17642,18820,1794,22.7,TRUE,0,FALSE,15848,16272,-1794,17.9
FALSE,FALSE,0,FALSE,14462,16255,-2247,21,TRUE,1,TRUE,16709,17756,2247,21.3
TRUE,FALSE,0,FALSE,16993,19167,-1019,19.5,TRUE,0,FALSE,18012,18468,1019,20.2
FALSE,FALSE,0,FALSE,14149,17085,-3960,18.9,TRUE,0,FALSE,18109,19618,3960,22
TRUE,TRUE,1,TRUE,18633,18488,4235,23.1,FALSE,0,FALSE,14398,14934,-4235,16.4
TRUE,FALSE,1,TRUE,17421,19535,-108,24.4,TRUE,0,FALSE,17529,18281,108,21.2
FALSE,FALSE,1,FALSE,14112,17417,-1309,20.2,TRUE,1,TRUE,15421,17066,1309,20.5
FALSE,TRUE,0,FALSE,19095,19444,2999,21.9,FALSE,0,FALSE,16096,17260,-2999,20.4
TRUE,FALSE,1,TRUE,16770,19515,402,21.2,TRUE,0,FALSE,16368,17874,-402,22.2
FALSE,FALSE,0,FALSE,17430,17345,421,21,TRUE,1,TRUE,17009,18100,-421,21.6
FALSE,FALSE,1,TRUE,15011,15341,-1071,17.3,TRUE,0,FALSE,16082,17151,1071,22.6
FALSE,FALSE,1,FALSE,13475,15686,-5840,20.6,TRUE,1,TRUE,19315,18098,5840,26.2
FALSE,FALSE,0,FALSE,13581,17687,-1885,20.1,TRUE,1,TRUE,15466,18053,1885,24.6
TRUE,TRUE,2,TRUE,16743,17531,52,18.9,FALSE,0,FALSE,16691,17310,-52,20.8
TRUE,TRUE,1,TRUE,16331,17720,-377,23.1,FALSE,0,FALSE,16708,18954,377,22.9
FALSE,FALSE,1,FALSE,15948,16134,-361,18.5,TRUE,0,FALSE,16309,17156,361,19.6
TRUE,TRUE,2,TRUE,19155,20750,4526,25.1,FALSE,0,FALSE,14629,17991,-4526,19.2
TRUE,TRUE,1,FALSE,17312,16818,1139,20.9,FALSE,1,TRUE,16173,17703,-1139,20.8
TRUE,TRUE,0,FALSE,16990,17608,2565,18.7,FALSE,0,FALSE,14425,16373,-2565,21.2
TRUE,FALSE,1,TRUE,17785,17490,376,18.3,TRUE,0,FALSE,17409,17960,-376,20.7
FALSE,TRUE,0,FALSE,15704,16968,-322,21,FALSE,0,FALSE,16026,17684,322,17.9
TRUE,FALSE,1,TRUE,17055,19132,1400,22.8,TRUE,0,FALSE,15655,18644,-1400,23.5
FALSE,TRUE,1,TRUE,17538,19111,34,21.9,FALSE,0,FALSE,17504,18966,-34,22.5
TRUE,TRUE,0,FALSE,15340,16902,-885,21.3,FALSE,2,TRUE,16225,18456,885,24
FALSE,FALSE,0,FALSE,15679,16997,-3209,18.8,TRUE,0,FALSE,18888,19723,3209,23.3
TRUE,FALSE,0,FALSE,16391,17955,129,20.9,TRUE,1,TRUE,16262,17725,-129,19.9
TRUE,FALSE,1,TRUE,19362,18101,870,22.1,TRUE,1,FALSE,18492,17971,-870,21.6
FALSE,FALSE,0,FALSE,14049,16350,-2798,19.4,TRUE,2,TRUE,16847,19975,2798,24.8
TRUE,FALSE,1,TRUE,17905,18292,482,19.5,TRUE,0,FALSE,17423,17826,-482,15.9
TRUE,FALSE,1,TRUE,17329,19569,1257,23.9,TRUE,0,FALSE,16072,18446,-1257,24.2
FALSE,FALSE,0,FALSE,16699,17566,-967,19.5,TRUE,0,FALSE,17666,17829,967,20.8
FALSE,TRUE,1,FALSE,16859,17173,-2416,19.8,FALSE,1,TRUE,19275,19425,2416,22.1
FALSE,FALSE,0,FALSE,14800,18190,-1808,20.7,TRUE,1,TRUE,16608,18449,1808,23.1
TRUE,TRUE,0,FALSE,15452,16236,926,19.5,FALSE,1,TRUE,14526,17085,-926,18.6
FALSE,FALSE,1,TRUE,16981,19169,1621,23.2,TRUE,0,FALSE,15360,17376,-1621,23.6
TRUE,TRUE,0,FALSE,15735,17967,1558,21.9,FALSE,1,FALSE,14177,16400,-1558,20.2
TRUE,FALSE,1,TRUE,15458,19132,98,21.9,TRUE,0,FALSE,15360,18148,-98,24
FALSE,TRUE,0,FALSE,16515,16954,1547,19.8,FALSE,1,TRUE,14968,15736,-1547,19.3
FALSE,TRUE,0,FALSE,16275,16965,-2001,22.1,FALSE,1,TRUE,18276,19501,2001,19.3
TRUE,FALSE,0,FALSE,16150,16981,-1166,20.7,TRUE,1,TRUE,17316,17969,1166,21.8
TRUE,FALSE,2,TRUE,17913,18248,785,21.7,TRUE,0,FALSE,17128,16875,-785,19.1
FALSE,FALSE,0,FALSE,15623,17536,-1160,22.4,TRUE,1,TRUE,16783,18128,1160,19.4
TRUE,FALSE,1,TRUE,16405,18231,1410,23.3,TRUE,0,FALSE,14995,16988,-1410,23.5
TRUE,FALSE,1,TRUE,16912,19261,750,25.3,TRUE,0,FALSE,16162,17968,-750,23.3
TRUE,TRUE,1,TRUE,17092,19011,2788,24.2,FALSE,0,FALSE,14304,17686,-2788,21.5
TRUE,TRUE,1,TRUE,17056,18811,739,23.4,FALSE,0,FALSE,16317,18100,-739,23.1
TRUE,FALSE,0,FALSE,15039,17278,-960,22.1,TRUE,1,TRUE,15999,19021,960,23.2
TRUE,TRUE,0,FALSE,17465,17968,1428,21.8,FALSE,1,TRUE,16037,17505,-1428,22.2
TRUE,TRUE,2,TRUE,18989,19584,2545,20.1,FALSE,0,FALSE,16444,17889,-2545,21.2
FALSE,TRUE,0,FALSE,14663,16512,-2405,24.2,FALSE,1,TRUE,17068,19166,2405,23.5
TRUE,FALSE,1,TRUE,15208,17411,-1318,22.4,TRUE,1,FALSE,16526,17005,1318,21.1
FALSE,TRUE,1,TRUE,18036,17340,-1501,21.3,FALSE,1,FALSE,19537,20459,1501,22.1
FALSE,TRUE,2,TRUE,17875,18665,984,20.5,FALSE,0,FALSE,16891,17523,-984,22.7
FALSE,TRUE,0,FALSE,15985,17576,-974,22.3,FALSE,1,TRUE,16959,19554,974,18.8
FALSE,TRUE,1,TRUE,17035,16379,1385,18.7,FALSE,1,FALSE,15650,17206,-1385,17.9
TRUE,TRUE,0,FALSE,17602,18119,2956,25.4,FALSE,0,FALSE,14646,15979,-2956,20.5
FALSE,FALSE,0,FALSE,15979,17379,-583,19.5,TRUE,1,TRUE,16562,17019,583,20
FALSE,TRUE,0,FALSE,18287,18535,2845,24.2,FALSE,0,FALSE,15442,16371,-2845,23.3
FALSE,FALSE,0,FALSE,14888,15213,-5010,15.3,TRUE,1,TRUE,19898,19722,5010,21.8
TRUE,FALSE,1,TRUE,16040,18690,-877,24.8,TRUE,0,FALSE,16917,19503,877,26.4
TRUE,TRUE,1,TRUE,15388,17788,365,22,FALSE,0,FALSE,15023,18507,-365,25.2
FALSE,FALSE,0,FALSE,16726,18339,278,21.7,TRUE,1,TRUE,16448,18682,-278,20.6
TRUE,FALSE,1,TRUE,17242,18478,1291,23,TRUE,0,FALSE,15951,16362,-1291,17.1
TRUE,TRUE,1,TRUE,17650,18670,2518,24.3,FALSE,0,FALSE,15132,16288,-2518,19.6
FALSE,FALSE,0,FALSE,17335,19512,364,20.8,TRUE,0,FALSE,16971,17807,-364,21.8
FALSE,TRUE,1,TRUE,16938,17857,206,22.2,FALSE,0,FALSE,16732,18317,-206,21.5
FALSE,TRUE,0,FALSE,13655,15392,-5221,17.9,FALSE,1,TRUE,18876,19612,5221,23.9
TRUE,FALSE,1,FALSE,16823,18727,151,21.3,TRUE,1,TRUE,16672,17921,-151,22.6
TRUE,TRUE,1,TRUE,15834,19029,782,25.8,FALSE,0,FALSE,15052,17387,-782,23.8
FALSE,FALSE,1,FALSE,14970,17809,-2366,23.5,TRUE,0,FALSE,17336,18149,2366,22.6
FALSE,FALSE,1,TRUE,17173,18789,386,23.2,TRUE,0,FALSE,16787,18989,-386,20.2
FALSE,FALSE,0,FALSE,13409,15601,-3559,20.3,TRUE,2,TRUE,16968,18921,3559,23.6
TRUE,TRUE,1,FALSE,17022,19318,-900,23.7,FALSE,1,TRUE,17922,17843,900,20.3
FALSE,FALSE,1,FALSE,15804,18509,606,22.8,TRUE,1,TRUE,15198,17689,-606,21
FALSE,TRUE,1,TRUE,17073,16988,2939,19.5,FALSE,0,FALSE,14134,15995,-2939,19.7
TRUE,FALSE,1,TRUE,16553,19304,1216,20.5,TRUE,0,FALSE,15337,16415,-1216,17.3
FALSE,TRUE,1,TRUE,17679,19757,2488,23.7,FALSE,0,FALSE,15191,17304,-2488,22.2
FALSE,FALSE,1,TRUE,14007,14101,-6259,19.7,TRUE,0,FALSE,20266,19477,6259,24.7
FALSE,FALSE,1,TRUE,13986,16124,-3246,18.9,TRUE,0,FALSE,17232,18104,3246,20.9
FALSE,TRUE,0,FALSE,16481,18136,572,19,FALSE,1,TRUE,15909,18369,-572,22.4
TRUE,FALSE,1,TRUE,17834,19107,1260,20.8,TRUE,0,FALSE,16574,17966,-1260,22.6
TRUE,TRUE,1,TRUE,17200,17501,528,22.6,FALSE,0,FALSE,16672,18306,-528,19.9
TRUE,TRUE,2,TRUE,17125,16776,-206,19.1,FALSE,0,FALSE,17331,17139,206,20.4
TRUE,FALSE,1,TRUE,16937,18017,375,21.4,TRUE,0,FALSE,16562,18583,-375,19.4
TRUE,TRUE,2,TRUE,15802,17365,306,23.7,FALSE,0,FALSE,15496,18301,-306,20.9
TRUE,FALSE,0,FALSE,19336,19593,4680,22.1,TRUE,0,FALSE,14656,16813,-4680,21.4
TRUE,TRUE,1,TRUE,18524,18193,2702,24.1,FALSE,0,FALSE,15822,17146,-2702,22.8
FALSE,TRUE,0,FALSE,15346,17250,-1938,21.2,FALSE,1,TRUE,17284,18423,1938,22.5
TRUE,TRUE,1,TRUE,16912,17195,1051,20.5,FALSE,0,FALSE,15861,16398,-1051,21.2
TRUE,FALSE,0,FALSE,14843,18146,-620,23.6,TRUE,0,FALSE,15463,18293,620,23.6
FALSE,TRUE,0,FALSE,17037,17825,987,23.7,FALSE,2,TRUE,16050,18202,-987,21.9
TRUE,FALSE,0,FALSE,17525,16972,-437,20.2,TRUE,1,TRUE,17962,18256,437,19
FALSE,FALSE,1,FALSE,14102,16463,-2031,21.1,TRUE,0,FALSE,16133,19003,2031,22.1
FALSE,FALSE,0,FALSE,15530,18389,-1932,22.2,TRUE,1,TRUE,17462,19319,1932,23.2
FALSE,TRUE,0,FALSE,15168,17149,-2626,20.1,FALSE,0,FALSE,17794,19141,2626,25.4
TRUE,FALSE,1,TRUE,14900,18274,-2631,21.1,TRUE,0,FALSE,17531,19632,2631,22.1
TRUE,TRUE,2,TRUE,17639,19606,1899,22.8,FALSE,0,FALSE,15740,16916,-1899,20.8
TRUE,TRUE,1,TRUE,14958,16560,-2607,23.9,FALSE,0,FALSE,17565,18685,2607,25.3
FALSE,FALSE,1,TRUE,14569,16559,-676,22.7,TRUE,0,FALSE,15245,17423,676,23.6
FALSE,TRUE,2,TRUE,16820,18804,1968,22.2,FALSE,0,FALSE,14852,16881,-1968,20.5
FALSE,FALSE,0,FALSE,14891,17683,-4035,21.8,TRUE,1,TRUE,18926,20322,4035,24.6
FALSE,FALSE,0,FALSE,15089,16002,-2349,18.2,TRUE,1,TRUE,17438,18680,2349,20.1
FALSE,FALSE,0,FALSE,13427,16472,-3175,21.1,TRUE,1,TRUE,16602,18317,3175,21.7
TRUE,TRUE,2,TRUE,17848,19823,2450,25.3,FALSE,0,FALSE,15398,17590,-2450,22.7
TRUE,TRUE,2,TRUE,18021,18556,1373,20.2,FALSE,0,FALSE,16648,16790,-1373,20
TRUE,TRUE,2,TRUE,16370,18289,1504,25.7,FALSE,0,FALSE,14866,16232,-1504,19.1
TRUE,TRUE,1,TRUE,16091,16748,-765,20,FALSE,0,FALSE,16856,17240,765,18.5
FALSE,FALSE,0,FALSE,15129,15915,-2921,17.6,TRUE,0,FALSE,18050,19111,2921,20.3
TRUE,TRUE,0,FALSE,16817,17790,2283,22.8,FALSE,1,TRUE,14534,16960,-2283,20.2
TRUE,TRUE,1,FALSE,18203,17893,2297,24.8,FALSE,1,TRUE,15906,17501,-2297,19.3
TRUE,FALSE,0,FALSE,17706,17870,578,21.2,TRUE,0,FALSE,17128,17726,-578,20.4
TRUE,FALSE,1,TRUE,16668,18055,1794,19.2,TRUE,0,FALSE,14874,15408,-1794,20.3
FALSE,TRUE,0,FALSE,15862,16175,-971,22.9,FALSE,1,FALSE,16833,17763,971,19.5
TRUE,TRUE,0,FALSE,17479,17898,1269,20.9,FALSE,1,TRUE,16210,18320,-1269,20.7
FALSE,TRUE,1,FALSE,16782,18450,-34,21.8,FALSE,1,TRUE,16816,18572,34,23.4
FALSE,FALSE,1,TRUE,17942,18724,1171,21.3,TRUE,0,FALSE,16771,17806,-1171,18.9
FALSE,FALSE,0,FALSE,17418,18495,-2298,20.2,TRUE,1,TRUE,19716,19750,2298,17.1
FALSE,TRUE,0,FALSE,16180,16639,-2807,18.5,FALSE,0,FALSE,18987,19595,2807,23.6
TRUE,TRUE,0,FALSE,14124,15978,-1155,22.9,FALSE,0,FALSE,15279,16616,1155,21.5
FALSE,FALSE,0,FALSE,18452,17864,-69,24.1,TRUE,2,TRUE,18521,18498,69,18
FALSE,TRUE,1,TRUE,17142,18300,576,22.7,FALSE,1,FALSE,16566,20139,-576,22.2
FALSE,TRUE,1,FALSE,16143,17196,-1694,18.1,FALSE,1,TRUE,17837,17664,1694,20
FALSE,FALSE,0,FALSE,15944,17805,-2600,20.1,TRUE,1,TRUE,18544,19392,2600,25.1
FALSE,FALSE,1,FALSE,14059,17446,-2160,21.3,TRUE,1,TRUE,16219,17534,2160,20.4
TRUE,TRUE,1,TRUE,19465,17819,4013,21.4,FALSE,0,FALSE,15452,15682,-4013,18.2
FALSE,TRUE,1,TRUE,17151,18082,1338,22.7,FALSE,0,FALSE,15813,18036,-1338,20.4
TRUE,FALSE,1,FALSE,19483,19290,5019,22.7,TRUE,0,FALSE,14464,15525,-5019,20.3
FALSE,FALSE,0,FALSE,15716,16324,258,19,TRUE,1,TRUE,15458,15562,-258,18.3
FALSE,FALSE,0,FALSE,15015,17386,-2327,21.6,TRUE,1,FALSE,17342,19687,2327,23
FALSE,FALSE,0,FALSE,16847,19212,1843,21.1,TRUE,0,FALSE,15004,15628,-1843,19.4
FALSE,TRUE,0,FALSE,14907,16847,-1021,20.5,FALSE,1,TRUE,15928,18999,1021,23.8
FALSE,TRUE,0,FALSE,15768,17401,-450,20,FALSE,1,TRUE,16218,19122,450,22.5
FALSE,TRUE,1,TRUE,16722,17229,-790,16.3,FALSE,1,FALSE,17512,18401,790,20.7
FALSE,FALSE,1,FALSE,15385,17822,-989,22.7,TRUE,1,TRUE,16374,18924,989,22.4
FALSE,TRUE,0,FALSE,16102,17077,-1412,20,FALSE,0,FALSE,17514,17845,1412,22.7
TRUE,FALSE,0,FALSE,16977,19637,1926,20.9,TRUE,1,TRUE,15051,15863,-1926,23.5
FALSE,TRUE,0,FALSE,16033,17402,-3022,18.8,FALSE,1,FALSE,19055,18015,3022,22.1
TRUE,FALSE,1,TRUE,15272,18442,-716,20.5,TRUE,0,FALSE,15988,17869,716,20.7
FALSE,FALSE,0,FALSE,18959,19305,3522,22,TRUE,1,TRUE,15437,17309,-3522,20.6
FALSE,TRUE,0,FALSE,15633,17562,148,22.2,FALSE,0,FALSE,15485,18105,-148,21
FALSE,FALSE,0,FALSE,14490,17638,-2987,22.2,TRUE,1,TRUE,17477,19655,2987,23.5
TRUE,TRUE,0,FALSE,17812,19411,2303,26.3,FALSE,1,TRUE,15509,16461,-2303,19.1
FALSE,FALSE,0,FALSE,15603,18354,288,23.9,TRUE,0,FALSE,15315,18693,-288,23.2
TRUE,TRUE,1,TRUE,16667,18290,1692,23.9,FALSE,1,FALSE,14975,17917,-1692,20.9
FALSE,FALSE,0,FALSE,16177,18425,-1546,22.4,TRUE,1,TRUE,17723,19135,1546,18.3
FALSE,FALSE,0,FALSE,16780,17484,-1226,20.9,TRUE,1,TRUE,18006,17436,1226,22.5
FALSE,TRUE,0,FALSE,15938,14724,-1985,19.4,FALSE,1,TRUE,17923,18390,1985,18.7
TRUE,TRUE,0,FALSE,16154,16080,-2005,19.9,FALSE,0,FALSE,18159,17816,2005,22.9
FALSE,FALSE,2,TRUE,14975,18139,-1530,20.1,TRUE,0,FALSE,16505,18285,1530,22
FALSE,TRUE,1,FALSE,14683,16048,-4600,21.5,FALSE,0,FALSE,19283,19954,4600,20.9
TRUE,FALSE,1,TRUE,15836,18034,75,21.6,TRUE,0,FALSE,15761,18157,-75,25.4
TRUE,TRUE,0,FALSE,16463,16852,-185,20.7,FALSE,2,TRUE,16648,18294,185,22.8
TRUE,TRUE,1,TRUE,15712,17100,-418,21.3,FALSE,0,FALSE,16130,17085,418,16.6
TRUE,TRUE,1,FALSE,17665,19246,3642,23.2,FALSE,1,TRUE,14023,17048,-3642,19.9
TRUE,TRUE,1,TRUE,19680,18528,5397,20.4,FALSE,0,FALSE,14283,15600,-5397,17.5
TRUE,TRUE,0,FALSE,16400,18900,2247,25.5,FALSE,1,TRUE,14153,17461,-2247,20.2
TRUE,FALSE,1,TRUE,14659,15944,-944,19.3,TRUE,0,FALSE,15603,17994,944,21.3
FALSE,FALSE,0,FALSE,18742,18884,46,23.2,TRUE,0,FALSE,18696,18785,-46,23.6
TRUE,FALSE,0,FALSE,16637,19339,1530,24.5,TRUE,1,TRUE,15107,17034,-1530,21.6
TRUE,TRUE,1,TRUE,18079,19818,3854,27.2,FALSE,0,FALSE,14225,17439,-3854,23
TRUE,TRUE,1,FALSE,16407,18597,-450,21.7,FALSE,1,TRUE,16857,18470,450,22.3
FALSE,FALSE,0,FALSE,16145,17448,-1962,21.5,TRUE,0,FALSE,18107,18132,1962,22.3
TRUE,TRUE,1,FALSE,19557,18126,4238,19.3,FALSE,1,TRUE,15319,16708,-4238,20.6
TRUE,FALSE,0,FALSE,16495,18530,1037,23.2,TRUE,0,FALSE,15458,17608,-1037,23.8
FALSE,FALSE,1,TRUE,17480,17096,-366,20.3,TRUE,0,FALSE,17846,18019,366,21.7
TRUE,FALSE,0,FALSE,15074,16329,-1673,22.5,TRUE,1,TRUE,16747,18059,1673,21.5
FALSE,TRUE,0,FALSE,14963,15662,-6047,17,FALSE,2,TRUE,21010,18722,6047,20.3
TRUE,TRUE,1,TRUE,16058,17515,-677,21.7,FALSE,1,FALSE,16735,18897,677,21.4
FALSE,TRUE,0,FALSE,14824,17975,-2465,21.4,FALSE,1,FALSE,17289,18886,2465,24.3
TRUE,TRUE,1,TRUE,17079,17964,-365,21.2,FALSE,0,FALSE,17444,17109,365,23.8
TRUE,TRUE,1,TRUE,20351,19996,5057,22.5,FALSE,0,FALSE,15294,16573,-5057,19.7
TRUE,TRUE,1,FALSE,18732,18910,2292,22.2,FALSE,0,FALSE,16440,17888,-2292,21.3
TRUE,TRUE,1,TRUE,19017,19432,5117,24,FALSE,0,FALSE,13900,15306,-5117,19.3
TRUE,TRUE,0,FALSE,17078,17751,-304,22.4,FALSE,1,TRUE,17382,18774,304,24
FALSE,FALSE,0,FALSE,15351,18539,390,24.5,TRUE,2,TRUE,14961,19367,-390,23.5
FALSE,FALSE,1,FALSE,15885,18531,-257,24.3,TRUE,0,FALSE,16142,19414,257,23.2
TRUE,TRUE,0,FALSE,18851,19227,3737,25.2,FALSE,0,FALSE,15114,17431,-3737,20.3
TRUE,TRUE,0,FALSE,16425,17611,2167,22.7,FALSE,1,TRUE,14258,17073,-2167,20.8
FALSE,FALSE,0,FALSE,15649,17686,-2870,19.9,TRUE,1,TRUE,18519,19709,2870,22.9
TRUE,TRUE,0,FALSE,14659,16241,-1962,19.2,FALSE,0,FALSE,16621,18705,1962,24.4
FALSE,FALSE,1,TRUE,15983,18335,-704,22.9,TRUE,0,FALSE,16687,18866,704,20.5
TRUE,TRUE,1,FALSE,15868,18299,946,22.2,FALSE,1,TRUE,14922,17705,-946,21.3
FALSE,FALSE,1,TRUE,16732,16963,-496,20.8,TRUE,0,FALSE,17228,18147,496,18.6
FALSE,TRUE,0,FALSE,14366,14866,-5395,17.1,FALSE,2,TRUE,19761,20153,5395,21.7
TRUE,FALSE,0,FALSE,16037,18383,59,20.7,TRUE,1,TRUE,15978,18490,-59,22.9
TRUE,FALSE,0,FALSE,17643,17908,1550,21.8,TRUE,2,TRUE,16093,16866,-1550,18.3
FALSE,FALSE,1,TRUE,14261,17724,-2160,19.8,TRUE,0,FALSE,16421,17639,2160,20.7
FALSE,FALSE,0,FALSE,15939,17619,-1874,25.3,TRUE,1,FALSE,17813,18801,1874,22.1
FALSE,FALSE,0,FALSE,15487,18816,-1854,23.8,TRUE,2,TRUE,17341,19633,1854,23.2
FALSE,FALSE,1,TRUE,16601,16246,103,19.6,TRUE,0,FALSE,16498,16183,-103,19.4
TRUE,TRUE,1,FALSE,17048,17678,2575,20.6,FALSE,1,TRUE,14473,16681,-2575,21.4
TRUE,FALSE,2,TRUE,18328,18180,3048,22.3,TRUE,0,FALSE,15280,15961,-3048,19.5
FALSE,TRUE,0,FALSE,17375,18610,-2049,22.2,FALSE,2,TRUE,19424,19840,2049,23.6
TRUE,FALSE,0,FALSE,16556,16868,2139,21.5,TRUE,1,TRUE,14417,16018,-2139,17.6
TRUE,TRUE,1,TRUE,21883,20941,7980,25.2,FALSE,0,FALSE,13903,16025,-7980,19.3
FALSE,TRUE,0,FALSE,17382,19283,1103,22,FALSE,0,FALSE,16279,18166,-1103,20.9
TRUE,FALSE,2,TRUE,20795,18944,6547,24.9,TRUE,0,FALSE,14248,16391,-6547,17.9
FALSE,FALSE,0,FALSE,15469,17314,-2472,23.4,TRUE,2,TRUE,17941,17868,2472,22.7
TRUE,TRUE,1,TRUE,17951,18755,1464,22.8,FALSE,1,FALSE,16487,18576,-1464,23.3
FALSE,FALSE,0,FALSE,15205,15267,-4683,16.6,TRUE,1,TRUE,19888,18711,4683,22
TRUE,TRUE,1,TRUE,17835,18812,4277,23.1,FALSE,1,FALSE,13558,15472,-4277,20.7
TRUE,TRUE,0,FALSE,17329,19681,1870,22.4,FALSE,1,TRUE,15459,17890,-1870,24.3
TRUE,TRUE,2,TRUE,14992,17212,499,21.7,FALSE,0,FALSE,14493,17214,-499,23
TRUE,TRUE,0,FALSE,17033,17938,832,23.2,FALSE,2,TRUE,16201,17035,-832,22.8
FALSE,FALSE,1,FALSE,17535,19338,1782,23.6,TRUE,1,TRUE,15753,16482,-1782,20.7
FALSE,TRUE,0,FALSE,17645,18506,-177,20.1,FALSE,1,TRUE,17822,18814,177,20.6
FALSE,FALSE,0,FALSE,16523,17836,-2692,21.9,TRUE,1,TRUE,19215,20589,2692,17.6
FALSE,FALSE,0,FALSE,14630,16426,-1976,18.8,TRUE,1,TRUE,16606,19418,1976,23
FALSE,FALSE,1,TRUE,17617,18621,-642,24.5,TRUE,0,FALSE,18259,18310,642,23.6
FALSE,TRUE,1,FALSE,18142,16864,1051,20.9,FALSE,1,TRUE,17091,18275,-1051,18.3
TRUE,TRUE,0,FALSE,16068,17607,932,23.5,FALSE,0,FALSE,15136,18141,-932,24.1
FALSE,TRUE,1,FALSE,18041,17904,1197,22.9,FALSE,1,TRUE,16844,18851,-1197,22.4
TRUE,TRUE,1,FALSE,17583,18536,2858,22.3,FALSE,0,FALSE,14725,15802,-2858,19
TRUE,FALSE,1,FALSE,15381,17303,202,19.8,TRUE,0,FALSE,15179,16617,-202,21.4
FALSE,TRUE,1,TRUE,15929,17996,-688,23.6,FALSE,0,FALSE,16617,19109,688,26.9
TRUE,TRUE,1,TRUE,21132,19941,6289,21.7,FALSE,0,FALSE,14843,15945,-6289,17.9
FALSE,FALSE,0,FALSE,14022,16586,-4075,22.3,TRUE,2,TRUE,18097,19740,4075,21.1
FALSE,FALSE,1,TRUE,16786,18389,651,25,TRUE,1,FALSE,16135,15962,-651,20.1
FALSE,FALSE,0,FALSE,17171,18333,-1882,25.4,TRUE,2,TRUE,19053,20250,1882,21.8
TRUE,TRUE,1,TRUE,16004,18381,-695,21.6,FALSE,0,FALSE,16699,19064,695,24
FALSE,FALSE,1,FALSE,16043,18432,711,23.7,TRUE,1,TRUE,15332,16818,-711,20.9
FALSE,FALSE,1,TRUE,15720,17797,-325,18.5,TRUE,0,FALSE,16045,18028,325,20
FALSE,TRUE,1,TRUE,14451,16951,-341,21.3,FALSE,0,FALSE,14792,18533,341,23.1
TRUE,FALSE,2,TRUE,15551,17239,-284,20.9,TRUE,0,FALSE,15835,17499,284,22.8
FALSE,TRUE,0,FALSE,16574,18040,-37,23.1,FALSE,0,FALSE,16611,18422,37,20.9
FALSE,FALSE,0,FALSE,14264,15870,-2234,20.1,TRUE,1,TRUE,16498,17891,2234,20.4
TRUE,TRUE,0,FALSE,15223,17157,-299,21.7,FALSE,1,TRUE,15522,17395,299,20.3
FALSE,FALSE,0,FALSE,14366,16510,-3046,22.1,TRUE,1,TRUE,17412,18500,3046,22.2
FALSE,FALSE,1,FALSE,16860,19037,-259,23.9,TRUE,0,FALSE,17119,18680,259,23.8
TRUE,TRUE,1,FALSE,17791,19229,2095,21.9,FALSE,1,TRUE,15696,17353,-2095,21.4
TRUE,TRUE,1,FALSE,18066,18920,4597,24.2,FALSE,1,TRUE,13469,15337,-4597,18.9
TRUE,TRUE,0,FALSE,20245,21086,4151,24,FALSE,0,FALSE,16094,17594,-4151,17.1
TRUE,FALSE,0,FALSE,15413,16314,-3,21,TRUE,0,FALSE,15416,17079,3,22.1
TRUE,TRUE,0,FALSE,15510,17649,1215,20.3,FALSE,1,TRUE,14295,16479,-1215,24.4
FALSE,FALSE,1,TRUE,15838,17892,-2279,23.6,TRUE,0,FALSE,18117,20047,2279,23.5
TRUE,TRUE,1,TRUE,16029,19239,771,23.6,FALSE,1,FALSE,15258,17984,-771,20.8
FALSE,FALSE,1,TRUE,14506,17908,-1288,23,TRUE,0,FALSE,15794,18593,1288,21.7
FALSE,FALSE,0,FALSE,15293,15389,-4408,20.2,TRUE,2,TRUE,19701,19911,4408,25
FALSE,FALSE,0,FALSE,14796,16448,-3385,20.4,TRUE,2,TRUE,18181,19428,3385,22.3
FALSE,FALSE,2,TRUE,14142,16922,-1691,22.9,TRUE,0,FALSE,15833,18530,1691,23.4
FALSE,TRUE,0,FALSE,15890,18495,995,23.2,FALSE,1,TRUE,14895,17788,-995,21.9
TRUE,FALSE,1,TRUE,17040,18270,2402,19.1,TRUE,0,FALSE,14638,16247,-2402,22.8
FALSE,TRUE,1,TRUE,16196,18801,-25,21.4,FALSE,0,FALSE,16221,17847,25,21.7
FALSE,TRUE,1,TRUE,16373,18169,1221,18.8,FALSE,0,FALSE,15152,17675,-1221,20.9
FALSE,FALSE,0,FALSE,17505,17635,1841,22.4,TRUE,1,TRUE,15664,18226,-1841,19.7
TRUE,TRUE,2,TRUE,18635,19958,4368,23,FALSE,0,FALSE,14267,16435,-4368,20.8
FALSE,FALSE,2,TRUE,16807,19662,2052,23.2,TRUE,0,FALSE,14755,16817,-2052,21.6
FALSE,TRUE,1,FALSE,16842,16280,-1725,21,FALSE,1,TRUE,18567,18544,1725,19.2
TRUE,FALSE,0,FALSE,16963,17360,1479,20.3,TRUE,1,TRUE,15484,16358,-1479,17.3
FALSE,FALSE,0,FALSE,16587,17801,-674,21.6,TRUE,0,FALSE,17261,16892,674,21.9
TRUE,TRUE,1,TRUE,18404,19768,3993,24.5,FALSE,0,FALSE,14411,17603,-3993,18.8
FALSE,FALSE,1,TRUE,15901,18666,-2522,24.5,TRUE,0,FALSE,18423,20429,2522,25
TRUE,TRUE,1,FALSE,17495,19239,1858,23.5,FALSE,1,TRUE,15637,17810,-1858,21.5
FALSE,FALSE,1,TRUE,14891,17103,-996,21,TRUE,0,FALSE,15887,18997,996,26.1
TRUE,FALSE,0,FALSE,16072,18312,-346,22.9,TRUE,1,TRUE,16418,17996,346,24.1
FALSE,FALSE,0,FALSE,15460,16868,-1946,18.4,TRUE,0,FALSE,17406,18016,1946,25
FALSE,TRUE,0,FALSE,16708,17428,-775,19.3,FALSE,0,FALSE,17483,17840,775,17.8
TRUE,TRUE,1,FALSE,18275,17102,-1963,17.3,FALSE,1,TRUE,20238,19038,1963,21.4
FALSE,FALSE,0,FALSE,13785,15847,-6199,19.5,TRUE,1,FALSE,19984,20844,6199,24.9
TRUE,FALSE,0,FALSE,18596,20017,520,19.8,TRUE,0,FALSE,18076,19076,-520,20.7
TRUE,FALSE,0,FALSE,15964,17988,-243,20.6,TRUE,2,TRUE,16207,17128,243,20.5
TRUE,TRUE,0,FALSE,18343,18609,3314,24.6,FALSE,0,FALSE,15029,16347,-3314,20.4
TRUE,FALSE,1,FALSE,17079,19361,1680,25,TRUE,0,FALSE,15399,16977,-1680,20
TRUE,TRUE,2,TRUE,19639,19564,5025,23.9,FALSE,0,FALSE,14614,15955,-5025,14.7
TRUE,TRUE,0,FALSE,20560,19784,4426,21.6,FALSE,0,FALSE,16134,17399,-4426,20.6
TRUE,FALSE,0,FALSE,15013,16013,-1937,21,TRUE,1,FALSE,16950,17472,1937,19.7
FALSE,FALSE,0,FALSE,15846,18039,1481,20.1,TRUE,0,FALSE,14365,17043,-1481,20.8
FALSE,FALSE,0,FALSE,15018,15571,-3643,19.2,TRUE,1,TRUE,18661,19199,3643,22
FALSE,TRUE,0,FALSE,16123,16738,-2240,19.4,FALSE,0,FALSE,18363,18683,2240,22.3
TRUE,TRUE,1,TRUE,17166,20100,2027,20.8,FALSE,0,FALSE,15139,17841,-2027,21.8
TRUE,FALSE,1,TRUE,15431,17257,-2844,23.7,TRUE,0,FALSE,18275,19790,2844,22.1
TRUE,TRUE,0,FALSE,14814,18414,500,23.3,FALSE,1,FALSE,14314,17194,-500,21.3
FALSE,FALSE,0,FALSE,17554,19237,-315,24.3,TRUE,0,FALSE,17869,19530,315,17.9
FALSE,TRUE,0,FALSE,14450,16178,-4625,19.1,FALSE,0,FALSE,19075,19371,4625,23.6
FALSE,FALSE,0,FALSE,15193,16021,-2162,19.9,TRUE,1,TRUE,17355,17251,2162,20.5
TRUE,FALSE,0,FALSE,19140,20293,4170,25.7,TRUE,0,FALSE,14970,15812,-4170,17.1
TRUE,TRUE,1,TRUE,16388,17884,-473,23.6,FALSE,0,FALSE,16861,19238,473,23.5
TRUE,TRUE,2,TRUE,18532,19666,3248,20.2,FALSE,0,FALSE,15284,17074,-3248,16.4
FALSE,FALSE,0,FALSE,14332,15949,-5624,21.9,TRUE,1,TRUE,19956,20104,5624,22.6
FALSE,FALSE,1,TRUE,14697,17577,-1769,23,TRUE,0,FALSE,16466,18164,1769,25.4
FALSE,FALSE,1,TRUE,15731,17396,-2238,23.6,TRUE,0,FALSE,17969,18534,2238,23.5
FALSE,FALSE,0,FALSE,13881,16578,-3756,21.5,TRUE,1,TRUE,17637,17984,3756,18.4
FALSE,TRUE,0,FALSE,15857,16404,-2314,17.7,FALSE,2,TRUE,18171,18307,2314,20.3
TRUE,TRUE,0,FALSE,16131,17990,-207,24.2,FALSE,1,FALSE,16338,19272,207,22.3
TRUE,TRUE,1,TRUE,19349,19673,2445,21.9,FALSE,0,FALSE,16904,17866,-2445,19.4
TRUE,TRUE,0,FALSE,16731,17558,2073,23.9,FALSE,0,FALSE,14658,15468,-2073,20.3
TRUE,FALSE,0,FALSE,18363,20591,2012,25,TRUE,2,TRUE,16351,18277,-2012,22.1
FALSE,FALSE,0,FALSE,15132,17149,-1740,19.6,TRUE,1,TRUE,16872,18065,1740,23
TRUE,FALSE,1,TRUE,17393,19257,1959,21.9,TRUE,0,FALSE,15434,16816,-1959,21.2
FALSE,TRUE,0,FALSE,15615,18309,1471,23.7,FALSE,0,FALSE,14144,18122,-1471,18.7
FALSE,FALSE,0,FALSE,15358,16660,-3859,21.3,TRUE,1,TRUE,19217,18671,3859,21.6
FALSE,FALSE,0,FALSE,13936,16231,-2566,23.5,TRUE,1,TRUE,16502,18028,2566,26.4
TRUE,FALSE,0,FALSE,17047,18719,-1518,20.2,TRUE,1,TRUE,18565,19825,1518,25.6
TRUE,TRUE,1,TRUE,16350,18813,1387,23.3,FALSE,0,FALSE,14963,18111,-1387,21.7
TRUE,FALSE,1,TRUE,16444,18703,370,20.7,TRUE,0,FALSE,16074,17977,-370,22.6
TRUE,TRUE,1,TRUE,21703,19827,7605,20.2,FALSE,1,FALSE,14098,15834,-7605,17.7
FALSE,FALSE,0,FALSE,16526,17292,-609,19.4,TRUE,0,FALSE,17135,18303,609,22.8
FALSE,TRUE,0,FALSE,14698,17544,-501,20.8,FALSE,1,TRUE,15199,18698,501,22.7
TRUE,FALSE,0,FALSE,15329,17425,-486,21,TRUE,1,TRUE,15815,17245,486,21.8
FALSE,TRUE,1,TRUE,14746,17610,-1108,20.6,FALSE,0,FALSE,15854,17980,1108,21
FALSE,FALSE,0,FALSE,15831,17839,-152,24.7,TRUE,0,FALSE,15983,17823,152,24.3
TRUE,FALSE,0,FALSE,18575,18686,1501,22.8,TRUE,0,FALSE,17074,18412,-1501,21.9
TRUE,TRUE,0,FALSE,16803,19509,1829,24.2,FALSE,1,TRUE,14974,18013,-1829,23.9
FALSE,TRUE,1,TRUE,16666,18258,-790,23.6,FALSE,0,FALSE,17456,18999,790,23
TRUE,TRUE,1,TRUE,18616,19395,1885,21.3,FALSE,0,FALSE,16731,18313,-1885,18.9
TRUE,TRUE,0,FALSE,14939,16939,-1348,21.8,FALSE,1,FALSE,16287,19021,1348,25
TRUE,FALSE,0,FALSE,16828,17628,-47,22.7,TRUE,1,TRUE,16875,18516,47,24
FALSE,FALSE,0,FALSE,15398,17243,-1091,21.3,TRUE,2,TRUE,16489,17860,1091,22.2
TRUE,FALSE,1,TRUE,14087,16178,-1808,21.7,TRUE,0,FALSE,15895,17996,1808,18.3
TRUE,FALSE,1,TRUE,17081,18350,2061,22.6,TRUE,0,FALSE,15020,17426,-2061,21.8
FALSE,FALSE,0,FALSE,16216,17978,-872,23.3,TRUE,1,FALSE,17088,18410,872,21.3
TRUE,FALSE,0,FALSE,17174,16698,-1682,18.6,TRUE,1,TRUE,18856,18800,1682,22.1
FALSE,TRUE,0,FALSE,17161,17805,-262,22.7,FALSE,1,TRUE,17423,19051,262,20.2
TRUE,FALSE,0,FALSE,18119,18951,4108,19.8,TRUE,1,TRUE,14011,16024,-4108,17.9
FALSE,TRUE,0,FALSE,15332,16368,-2398,18.7,FALSE,1,TRUE,17730,18694,2398,20.2
FALSE,FALSE,0,FALSE,16386,18530,-167,21.8,TRUE,1,FALSE,16553,18221,167,23
TRUE,TRUE,2,TRUE,18591,20081,3105,26,FALSE,0,FALSE,15486,17996,-3105,20.8
FALSE,TRUE,1,FALSE,16138,17626,-1208,17.8,FALSE,1,TRUE,17346,18991,1208,21.5
TRUE,TRUE,1,TRUE,18662,19321,4088,25.5,FALSE,0,FALSE,14574,16659,-4088,20.9
TRUE,FALSE,0,FALSE,16454,18576,2042,20.7,TRUE,0,FALSE,14412,17449,-2042,19.5
FALSE,FALSE,1,TRUE,15797,15229,-4801,16.8,TRUE,0,FALSE,20598,20434,4801,21.9
TRUE,TRUE,1,TRUE,16028,17147,192,22,FALSE,0,FALSE,15836,18459,-192,21.1
TRUE,TRUE,1,TRUE,15142,14696,-566,17.8,FALSE,0,FALSE,15708,18102,566,24.6
TRUE,TRUE,2,TRUE,16849,16993,1651,20.5,FALSE,0,FALSE,15198,16591,-1651,20.7
FALSE,FALSE,1,FALSE,20066,19018,4646,20.9,TRUE,0,FALSE,15420,15157,-4646,19.3
FALSE,TRUE,0,FALSE,14312,17694,-980,21.6,FALSE,0,FALSE,15292,18378,980,23.6
TRUE,TRUE,0,FALSE,16786,19003,2264,26,FALSE,2,TRUE,14522,17873,-2264,24.7
FALSE,FALSE,1,TRUE,14299,17111,-1673,21.1,TRUE,0,FALSE,15972,17898,1673,22.8
FALSE,TRUE,0,FALSE,15724,15396,-866,20.3,FALSE,1,FALSE,16590,17529,866,19.8
TRUE,FALSE,0,FALSE,14828,18224,-1402,23.4,TRUE,1,TRUE,16230,18314,1402,23
TRUE,FALSE,2,TRUE,16294,17550,-445,18.6,TRUE,0,FALSE,16739,17843,445,19.3
TRUE,FALSE,0,FALSE,15761,17783,-802,23,TRUE,0,FALSE,16563,19026,802,24.7
FALSE,TRUE,0,FALSE,14565,16719,179,19.2,FALSE,1,TRUE,14386,17136,-179,19.9
TRUE,TRUE,0,FALSE,15711,17395,886,22.3,FALSE,1,TRUE,14825,16689,-886,22.5
TRUE,TRUE,1,TRUE,16116,19219,1409,24.6,FALSE,0,FALSE,14707,17014,-1409,20.3
TRUE,FALSE,0,FALSE,14629,16283,-3259,18.3,TRUE,2,TRUE,17888,17801,3259,21
FALSE,TRUE,1,TRUE,15694,17914,1074,21.9,FALSE,0,FALSE,14620,17677,-1074,21
FALSE,FALSE,0,FALSE,17041,18750,1016,23.2,TRUE,1,TRUE,16025,16672,-1016,21.1
FALSE,FALSE,0,FALSE,15478,18118,-697,21.4,TRUE,2,TRUE,16175,19251,697,24.4
FALSE,TRUE,0,FALSE,16956,18267,399,22.9,FALSE,2,TRUE,16557,17119,-399,18.7
TRUE,FALSE,0,FALSE,16956,19562,-387,25.2,TRUE,1,TRUE,17343,18096,387,23.6
TRUE,TRUE,2,TRUE,19172,18959,3456,24.2,FALSE,0,FALSE,15716,15726,-3456,19.7
TRUE,TRUE,0,FALSE,16979,18700,1486,21.3,FALSE,0,FALSE,15493,17709,-1486,20
FALSE,FALSE,0,FALSE,14806,17653,-2194,21.1,TRUE,1,TRUE,17000,18893,2194,24.7
FALSE,FALSE,1,TRUE,18244,18223,-173,20.5,TRUE,0,FALSE,18417,19212,173,21
TRUE,TRUE,0,FALSE,16989,18031,2000,25.6,FALSE,1,TRUE,14989,16966,-2000,20.6
FALSE,FALSE,0,FALSE,14281,13851,-7666,18.3,TRUE,1,FALSE,21947,19335,7666,23.1
TRUE,TRUE,0,FALSE,15393,17028,1875,23,FALSE,0,FALSE,13518,15667,-1875,21.5
TRUE,TRUE,1,TRUE,17636,19295,2578,24.9,FALSE,1,FALSE,15058,18135,-2578,23.2
TRUE,FALSE,0,FALSE,16600,17594,-629,21.3,TRUE,0,FALSE,17229,18826,629,20.3
FALSE,TRUE,0,FALSE,15889,18326,-1253,22.8,FALSE,0,FALSE,17142,18309,1253,22.5
FALSE,TRUE,0,FALSE,19657,18537,1675,20.4,FALSE,1,TRUE,17982,18960,-1675,20.2
TRUE,TRUE,0,FALSE,16818,18454,3138,23.1,FALSE,2,TRUE,13680,15648,-3138,19.6
TRUE,TRUE,2,TRUE,17415,19432,2148,24.6,FALSE,0,FALSE,15267,17930,-2148,21.2
TRUE,TRUE,0,FALSE,16602,19275,2919,24.6,FALSE,0,FALSE,13683,16977,-2919,21.4
FALSE,TRUE,0,FALSE,17181,18481,-2692,18.4,FALSE,1,TRUE,19873,20090,2692,19.1
TRUE,TRUE,1,FALSE,16492,16905,-499,20.2,FALSE,1,TRUE,16991,17200,499,22
FALSE,TRUE,1,TRUE,16410,18121,75,23.6,FALSE,0,FALSE,16335,17477,-75,20.1
FALSE,FALSE,0,FALSE,15238,16831,-1314,20.9,TRUE,0,FALSE,16552,18329,1314,22.6
TRUE,TRUE,1,TRUE,20271,19487,3243,20,FALSE,0,FALSE,17028,17568,-3243,23.5
FALSE,TRUE,0,FALSE,15372,17632,-443,22.8,FALSE,0,FALSE,15815,18364,443,23.7
FALSE,FALSE,0,FALSE,14930,16710,-1844,22.2,TRUE,1,TRUE,16774,18078,1844,21.2
TRUE,TRUE,0,FALSE,17450,18989,270,23.6,FALSE,1,FALSE,17180,18351,-270,22
TRUE,TRUE,0,FALSE,14812,17296,1221,25.4,FALSE,1,TRUE,13591,17607,-1221,21.4
FALSE,FALSE,0,FALSE,17605,19074,1132,24.1,TRUE,0,FALSE,16473,18296,-1132,21.9
FALSE,FALSE,0,FALSE,16841,17341,-1482,23.4,TRUE,1,TRUE,18323,18065,1482,19.9
TRUE,TRUE,2,TRUE,16321,18143,1151,24.9,FALSE,0,FALSE,15170,18251,-1151,21.8
TRUE,FALSE,1,FALSE,16270,17716,-143,23,TRUE,1,TRUE,16413,17008,143,20.6
TRUE,TRUE,1,TRUE,15954,17461,305,19.1,FALSE,0,FALSE,15649,17835,-305,23.4
FALSE,FALSE,1,TRUE,15682,18027,-438,24.7,TRUE,0,FALSE,16120,18805,438,20.6
FALSE,FALSE,0,FALSE,16190,17466,-3531,21.5,TRUE,1,TRUE,19721,19247,3531,23.6
TRUE,FALSE,2,TRUE,19572,18020,3987,21.3,TRUE,0,FALSE,15585,16851,-3987,19.3
FALSE,FALSE,0,FALSE,15930,17859,179,23.6,TRUE,2,TRUE,15751,18821,-179,22.5
FALSE,FALSE,0,FALSE,13785,16211,-4124,21.5,TRUE,1,TRUE,17909,19301,4124,26
TRUE,TRUE,1,FALSE,16898,19309,2927,24.7,FALSE,0,FALSE,13971,16174,-2927,21.2
TRUE,FALSE,2,TRUE,18333,18853,1665,22.9,TRUE,0,FALSE,16668,17275,-1665,18.1
FALSE,FALSE,1,TRUE,14289,16754,-2946,22,TRUE,0,FALSE,17235,19706,2946,22.3
TRUE,TRUE,0,FALSE,16501,18045,1440,20.8,FALSE,0,FALSE,15061,16897,-1440,25.8
TRUE,TRUE,0,FALSE,16618,19643,2263,25,FALSE,0,FALSE,14355,18192,-2263,24.3
FALSE,TRUE,2,TRUE,16557,18637,1878,26.1,FALSE,0,FALSE,14679,17934,-1878,23.3
FALSE,TRUE,0,FALSE,16978,13699,-4259,15.8,FALSE,1,FALSE,21237,17202,4259,20.3
FALSE,FALSE,0,FALSE,16577,16338,-1311,22.1,TRUE,1,TRUE,17888,17810,1311,16.9
FALSE,TRUE,0,FALSE,14706,16463,-3856,19.5,FALSE,0,FALSE,18562,18422,3856,25
FALSE,FALSE,0,FALSE,16795,18170,-1317,21.7,TRUE,1,TRUE,18112,18986,1317,24.7
FALSE,FALSE,1,TRUE,15288,18195,-1538,24.2,TRUE,0,FALSE,16826,18515,1538,22.6
TRUE,FALSE,2,TRUE,14875,17019,-1641,19.4,TRUE,0,FALSE,16516,17621,1641,21.7
TRUE,FALSE,1,FALSE,16861,17932,-1255,18.4,TRUE,0,FALSE,18116,18186,1255,19.5
FALSE,TRUE,1,TRUE,17136,17077,-1154,20.3,FALSE,0,FALSE,18290,17170,1154,18.9
TRUE,FALSE,1,TRUE,17765,19108,2312,24.2,TRUE,0,FALSE,15453,16586,-2312,17
FALSE,TRUE,0,FALSE,14555,16626,-4431,20,FALSE,1,TRUE,18986,21196,4431,25.1
FALSE,FALSE,1,TRUE,14020,15872,-4215,20.3,TRUE,1,FALSE,18235,17774,4215,22.9
TRUE,TRUE,1,TRUE,17575,18579,2658,22.8,FALSE,0,FALSE,14917,16664,-2658,21.1
FALSE,FALSE,1,TRUE,15307,17610,-2576,22.7,TRUE,0,FALSE,17883,19792,2576,24.9
TRUE,TRUE,0,FALSE,16751,19355,3029,24.5,FALSE,1,TRUE,13722,18077,-3029,18.9
TRUE,FALSE,0,FALSE,16271,17500,787,21.8,TRUE,1,TRUE,15484,16654,-787,20.8
FALSE,TRUE,0,FALSE,16420,17929,-514,20.9,FALSE,1,TRUE,16934,19394,514,23.6
TRUE,FALSE,0,FALSE,15570,17682,-227,18,TRUE,1,TRUE,15797,16759,227,22.7
FALSE,FALSE,0,FALSE,14948,17612,-347,21.8,TRUE,0,FALSE,15295,17487,347,20.4
FALSE,TRUE,1,FALSE,15167,15683,-1645,22,FALSE,0,FALSE,16812,16951,1645,19.8
TRUE,FALSE,0,FALSE,15484,18175,239,25,TRUE,2,TRUE,15245,18884,-239,20.9
TRUE,TRUE,0,FALSE,17856,18232,226,22.1,FALSE,1,TRUE,17630,19187,-226,22.1
FALSE,FALSE,0,FALSE,14767,17485,-2150,21.2,TRUE,1,TRUE,16917,18971,2150,22.5
TRUE,TRUE,1,FALSE,18474,18239,2680,21.7,FALSE,0,FALSE,15794,16722,-2680,21.9
FALSE,FALSE,0,FALSE,14183,17942,-975,24.3,TRUE,1,TRUE,15158,17608,975,20.6
TRUE,TRUE,1,FALSE,15971,18396,484,24.2,FALSE,1,TRUE,15487,19010,-484,24.2
FALSE,FALSE,0,FALSE,14319,16192,-2914,21,TRUE,0,FALSE,17233,17815,2914,19.3
FALSE,FALSE,1,TRUE,16206,18093,-795,26,TRUE,1,FALSE,17001,19278,795,24.2
FALSE,TRUE,1,TRUE,15704,18000,1208,21.3,FALSE,0,FALSE,14496,16637,-1208,20.9
TRUE,FALSE,1,TRUE,18137,19154,201,21.8,TRUE,0,FALSE,17936,17558,-201,19.7
FALSE,FALSE,0,FALSE,14944,17675,-2695,23.9,TRUE,1,TRUE,17639,18950,2695,25.2
FALSE,FALSE,0,FALSE,13172,14988,-7079,18.7,TRUE,1,TRUE,20251,19924,7079,22.2
FALSE,TRUE,1,TRUE,18363,18844,2120,22,FALSE,0,FALSE,16243,18486,-2120,21.5
FALSE,FALSE,0,FALSE,15200,17118,-1806,22.8,TRUE,0,FALSE,17006,17659,1806,22.4
FALSE,FALSE,0,FALSE,17315,18632,297,21.8,TRUE,0,FALSE,17018,18114,-297,22.1
TRUE,TRUE,1,FALSE,16516,19168,1234,25.9,FALSE,0,FALSE,15282,17313,-1234,22.9
FALSE,FALSE,0,FALSE,14010,15841,-3956,17,TRUE,1,TRUE,17966,18771,3956,20.7
FALSE,TRUE,0,FALSE,15580,17701,-731,20.5,FALSE,2,TRUE,16311,17819,731,22.9
TRUE,FALSE,1,FALSE,17731,20617,3339,23.8,TRUE,1,TRUE,14392,17438,-3339,23.6
TRUE,TRUE,1,TRUE,19186,19737,4331,26.1,FALSE,0,FALSE,14855,16310,-4331,19.9
TRUE,TRUE,0,FALSE,18135,19138,2275,25.2,FALSE,0,FALSE,15860,17778,-2275,21.2
FALSE,TRUE,0,FALSE,15947,17802,-2086,20.4,FALSE,1,TRUE,18033,19819,2086,18.8
FALSE,FALSE,1,TRUE,16681,16014,-3637,16.8,TRUE,0,FALSE,20318,18470,3637,21.9
TRUE,TRUE,1,TRUE,16733,19451,2685,23.2,FALSE,0,FALSE,14048,17144,-2685,20.7
TRUE,FALSE,0,FALSE,15233,17625,-1121,22,TRUE,1,TRUE,16354,18483,1121,21
TRUE,TRUE,0,FALSE,18406,19320,4990,24.7,FALSE,1,TRUE,13416,17265,-4990,19.6
FALSE,TRUE,0,FALSE,16711,15855,-3289,20.1,FALSE,1,FALSE,20000,20146,3289,20.1
FALSE,FALSE,0,FALSE,16093,16567,-1805,17.5,TRUE,1,TRUE,17898,18614,1805,23.8
TRUE,TRUE,0,FALSE,15563,18747,446,25.2,FALSE,0,FALSE,15117,18318,-446,22.9
FALSE,TRUE,1,FALSE,15745,17698,-859,20.3,FALSE,1,TRUE,16604,17337,859,22
FALSE,FALSE,0,FALSE,15958,17066,231,18.5,TRUE,1,TRUE,15727,17250,-231,20.8
TRUE,TRUE,1,TRUE,17501,17203,3195,19.5,FALSE,0,FALSE,14306,16147,-3195,16.6
TRUE,FALSE,1,TRUE,18038,19458,3973,24,TRUE,0,FALSE,14065,15977,-3973,19.5
FALSE,TRUE,0,FALSE,16256,17776,-2528,24.8,FALSE,2,TRUE,18784,20285,2528,22.1
TRUE,FALSE,0,FALSE,16589,18101,636,23.9,TRUE,1,TRUE,15953,18520,-636,21.6
FALSE,TRUE,1,TRUE,15258,18398,993,22.3,FALSE,0,FALSE,14265,17526,-993,22.5
TRUE,FALSE,0,FALSE,16481,17470,-246,22.3,TRUE,0,FALSE,16727,18534,246,22
FALSE,FALSE,0,FALSE,15913,17268,-125,19.5,TRUE,1,TRUE,16038,17905,125,23.2
TRUE,TRUE,1,TRUE,16162,17887,1766,25.7,FALSE,0,FALSE,14396,17168,-1766,21.5
TRUE,TRUE,0,FALSE,17264,18035,1811,21.4,FALSE,0,FALSE,15453,17160,-1811,18.6
FALSE,TRUE,1,TRUE,16700,17519,-418,24.1,FALSE,0,FALSE,17118,18839,418,22.4
FALSE,FALSE,0,FALSE,16337,17367,-38,19.7,TRUE,1,TRUE,16375,17086,38,19.2
TRUE,FALSE,0,FALSE,15790,17533,-2878,20.8,TRUE,0,FALSE,18668,18717,2878,23.4
TRUE,FALSE,0,FALSE,15970,17837,-703,21.7,TRUE,1,TRUE,16673,18490,703,22.1
FALSE,FALSE,0,FALSE,14933,18353,-1957,21.3,TRUE,2,TRUE,16890,18707,1957,22
TRUE,FALSE,2,TRUE,18060,19784,1982,24.1,TRUE,0,FALSE,16078,17541,-1982,20.6
FALSE,FALSE,0,FALSE,14732,16524,-2642,20.8,TRUE,0,FALSE,17374,18640,2642,22.7
TRUE,TRUE,1,TRUE,17121,18545,2393,24.2,FALSE,0,FALSE,14728,17820,-2393,19.4
TRUE,TRUE,1,TRUE,18913,17351,3002,22.9,FALSE,0,FALSE,15911,15769,-3002,17
TRUE,TRUE,2,TRUE,17237,18352,1346,19.6,FALSE,0,FALSE,15891,17503,-1346,24.1
FALSE,FALSE,0,FALSE,13265,15753,-6200,19.5,TRUE,1,TRUE,19465,19329,6200,24.8
TRUE,TRUE,1,TRUE,21020,21002,7166,23.7,FALSE,0,FALSE,13854,16511,-7166,19.3
FALSE,TRUE,0,FALSE,17320,18039,2199,21,FALSE,0,FALSE,15121,17580,-2199,23.4
TRUE,TRUE,1,TRUE,15586,17198,-1022,19.9,FALSE,0,FALSE,16608,18499,1022,21
FALSE,FALSE,0,FALSE,17208,20217,931,21.8,TRUE,0,FALSE,16277,19477,-931,20.9
FALSE,FALSE,0,FALSE,13282,16226,-6225,19.4,TRUE,1,TRUE,19507,20201,6225,22.6
FALSE,TRUE,1,TRUE,15555,17008,-3638,22.2,FALSE,0,FALSE,19193,20345,3638,22.7
TRUE,FALSE,1,FALSE,17008,19831,1903,25.5,TRUE,1,TRUE,15105,15808,-1903,18.2
FALSE,TRUE,1,FALSE,16050,17391,-513,19.1,FALSE,0,FALSE,16563,18447,513,23.5
FALSE,TRUE,1,FALSE,16830,18264,257,20.3,FALSE,1,TRUE,16573,17081,-257,18
TRUE,TRUE,0,FALSE,16370,17433,-633,20.9,FALSE,1,TRUE,17003,18522,633,19.5
FALSE,FALSE,0,FALSE,14851,16367,-3151,18.3,TRUE,0,FALSE,18002,20096,3151,20.7
FALSE,TRUE,0,FALSE,15325,17018,-1931,21.5,FALSE,1,TRUE,17256,18590,1931,22
TRUE,TRUE,0,FALSE,18385,19948,607,24.8,FALSE,2,TRUE,17778,18655,-607,24
FALSE,FALSE,0,FALSE,14074,16376,-3510,20.3,TRUE,1,FALSE,17584,19390,3510,26.6
FALSE,TRUE,1,TRUE,16299,18568,1063,22.5,FALSE,0,FALSE,15236,18693,-1063,20.2
FALSE,FALSE,1,TRUE,16644,17295,60,23.8,TRUE,0,FALSE,16584,17620,-60,22.9
FALSE,TRUE,2,TRUE,16997,17893,639,21.5,FALSE,0,FALSE,16358,18294,-639,22
FALSE,TRUE,0,FALSE,15360,18355,960,22,FALSE,0,FALSE,14400,18316,-960,20.6
TRUE,TRUE,1,TRUE,17141,18486,3332,23,FALSE,1,FALSE,13809,17156,-3332,21.8
TRUE,FALSE,1,FALSE,17882,19474,2689,23.3,TRUE,0,FALSE,15193,17599,-2689,21.8
FALSE,FALSE,1,TRUE,18342,19368,-30,19,TRUE,0,FALSE,18372,17954,30,16.4
FALSE,TRUE,0,FALSE,15251,18342,-2343,19.7,FALSE,2,TRUE,17594,20573,2343,23.8
TRUE,TRUE,0,FALSE,17693,18557,2501,25.1,FALSE,0,FALSE,15192,16326,-2501,17.6
FALSE,FALSE,0,FALSE,15385,17267,-2109,21.9,TRUE,1,TRUE,17494,17602,2109,22.6
TRUE,TRUE,0,FALSE,17549,19400,2588,23.9,FALSE,0,FALSE,14961,18047,-2588,19.2
FALSE,FALSE,0,FALSE,15148,16861,-4085,21.9,TRUE,2,TRUE,19233,20117,4085,22
FALSE,TRUE,2,TRUE,17558,18661,-369,17.4,FALSE,0,FALSE,17927,19040,369,18.8
FALSE,TRUE,1,TRUE,16989,18073,1359,24.2,FALSE,0,FALSE,15630,17941,-1359,23.9
TRUE,FALSE,0,FALSE,18786,19353,3559,24.4,TRUE,0,FALSE,15227,16057,-3559,18.7
FALSE,FALSE,0,FALSE,15188,17740,-1269,19.4,TRUE,1,FALSE,16457,19731,1269,21.3
TRUE,FALSE,0,FALSE,15520,18045,-2195,19.9,TRUE,0,FALSE,17715,18336,2195,25.5
TRUE,TRUE,1,TRUE,20876,21016,4988,22.6,FALSE,1,FALSE,15888,17296,-4988,21.2
TRUE,FALSE,0,FALSE,17059,18997,2714,26.8,TRUE,0,FALSE,14345,16178,-2714,20.9
FALSE,TRUE,0,FALSE,16760,17857,-1052,20.6,FALSE,1,TRUE,17812,18921,1052,23.1
FALSE,FALSE,0,FALSE,14660,17265,-3251,20.3,TRUE,1,TRUE,17911,19408,3251,23.4
FALSE,TRUE,1,FALSE,15510,17367,-264,20.2,FALSE,1,TRUE,15774,16817,264,20.2
FALSE,FALSE,1,FALSE,16897,15328,-2191,15.9,TRUE,1,TRUE,19088,16719,2191,18.5
FALSE,FALSE,0,FALSE,16861,18373,1297,22.7,TRUE,0,FALSE,15564,17809,-1297,23
TRUE,TRUE,1,TRUE,18445,19242,2691,21.8,FALSE,0,FALSE,15754,17190,-2691,20.5
FALSE,FALSE,0,FALSE,15777,18203,-2713,22.1,TRUE,1,TRUE,18490,19659,2713,21.9
FALSE,FALSE,0,FALSE,18284,19460,2748,22.4,TRUE,1,TRUE,15536,17183,-2748,21.1
FALSE,TRUE,0,FALSE,17047,17725,-537,19.2,FALSE,0,FALSE,17584,17696,537,20.7
TRUE,TRUE,1,FALSE,17606,20053,4027,22.9,FALSE,0,FALSE,13579,16768,-4027,22
FALSE,TRUE,0,FALSE,17447,17850,705,21.6,FALSE,0,FALSE,16742,16234,-705,19.4
FALSE,FALSE,1,TRUE,13789,16947,-4038,21,TRUE,0,FALSE,17827,19801,4038,25.2
FALSE,FALSE,0,FALSE,18557,18792,524,19.2,TRUE,1,TRUE,18033,18314,-524,21.3
FALSE,FALSE,0,FALSE,15568,17520,40,24.6,TRUE,0,FALSE,15528,18251,-40,21.1
FALSE,TRUE,0,FALSE,17327,18807,1291,22,FALSE,1,TRUE,16036,18787,-1291,21
FALSE,FALSE,1,TRUE,16110,17501,72,20.6,TRUE,0,FALSE,16038,17582,-72,21.7
TRUE,FALSE,0,FALSE,18209,16955,1287,20,TRUE,0,FALSE,16922,16515,-1287,19.8
TRUE,TRUE,1,FALSE,16023,17244,1299,20.7,FALSE,1,TRUE,14724,18162,-1299,17.3
TRUE,FALSE,1,TRUE,17685,19338,1218,23.1,TRUE,0,FALSE,16467,18188,-1218,22.6
TRUE,FALSE,1,TRUE,14803,17318,-1380,21.3,TRUE,0,FALSE,16183,16992,1380,23.8
FALSE,FALSE,0,FALSE,15656,16252,-1275,19.5,TRUE,1,TRUE,16931,16803,1275,20.2
TRUE,TRUE,1,TRUE,19154,20112,5664,25.8,FALSE,1,FALSE,13490,14110,-5664,17.9
TRUE,FALSE,1,TRUE,17483,18777,2186,22.2,TRUE,0,FALSE,15297,17079,-2186,23.1
FALSE,TRUE,0,FALSE,14598,17033,-2286,21.7,FALSE,1,TRUE,16884,19607,2286,22.7
FALSE,TRUE,1,TRUE,16088,17857,-769,20.5,FALSE,1,FALSE,16857,18074,769,20.2
TRUE,TRUE,0,FALSE,15812,17970,650,24.1,FALSE,1,TRUE,15162,17842,-650,19.8
TRUE,TRUE,2,TRUE,16030,19449,970,24,FALSE,0,FALSE,15060,18701,-970,21.8
FALSE,TRUE,1,TRUE,15787,18200,-1856,23,FALSE,0,FALSE,17643,20004,1856,22.5
TRUE,TRUE,1,TRUE,17870,18803,1872,17.7,FALSE,0,FALSE,15998,16934,-1872,22.5
TRUE,FALSE,0,FALSE,17875,17882,1880,20.5,TRUE,0,FALSE,15995,16409,-1880,19
TRUE,TRUE,0,FALSE,16523,18018,1652,19.6,FALSE,0,FALSE,14871,17317,-1652,23.9
TRUE,TRUE,1,TRUE,16180,18710,-1348,23.4,FALSE,0,FALSE,17528,19117,1348,24.5
FALSE,TRUE,1,TRUE,17448,17864,-102,20.5,FALSE,0,FALSE,17550,17501,102,18.1
FALSE,FALSE,0,FALSE,14493,15935,-4130,21,TRUE,1,TRUE,18623,18784,4130,22.6
TRUE,FALSE,1,FALSE,17807,17661,1383,21.7,TRUE,1,TRUE,16424,16388,-1383,19.2
FALSE,FALSE,0,FALSE,15001,18001,-1787,20.6,TRUE,1,TRUE,16788,18609,1787,25.7
TRUE,TRUE,1,FALSE,18984,18355,3522,24.6,FALSE,0,FALSE,15462,16913,-3522,18.6
FALSE,TRUE,0,FALSE,16528,17624,-449,21.2,FALSE,0,FALSE,16977,18971,449,23.5
FALSE,TRUE,0,FALSE,15020,17488,-1756,22.4,FALSE,2,TRUE,16776,18473,1756,27.5
FALSE,FALSE,0,FALSE,13657,16618,-3849,22,TRUE,1,TRUE,17506,18777,3849,23.5
TRUE,TRUE,0,FALSE,17672,18962,1121,24.5,FALSE,1,TRUE,16551,18029,-1121,23.8
TRUE,FALSE,1,TRUE,19508,19814,4882,23.3,TRUE,0,FALSE,14626,17156,-4882,21.9
TRUE,TRUE,0,FALSE,18590,18992,2945,21.5,FALSE,1,FALSE,15645,16973,-2945,20.2
TRUE,TRUE,2,TRUE,17260,16577,1006,18.7,FALSE,0,FALSE,16254,15757,-1006,20.4
TRUE,TRUE,1,TRUE,16095,18658,1287,25.4,FALSE,0,FALSE,14808,18055,-1287,24.1
FALSE,FALSE,1,FALSE,15384,17460,-1817,21.1,TRUE,1,TRUE,17201,18495,1817,24
TRUE,TRUE,0,FALSE,18795,19236,733,23.1,FALSE,1,TRUE,18062,18561,-733,21.3
TRUE,FALSE,1,TRUE,17737,18648,2413,22.4,TRUE,0,FALSE,15324,16485,-2413,17.9
FALSE,FALSE,1,FALSE,14191,16725,-1093,20.7,TRUE,0,FALSE,15284,18297,1093,23.9
FALSE,TRUE,0,FALSE,14557,15691,-3666,16.9,FALSE,0,FALSE,18223,18684,3666,23.5
FALSE,TRUE,1,TRUE,16739,17995,1569,22.9,FALSE,0,FALSE,15170,17331,-1569,25
FALSE,TRUE,1,TRUE,15230,16550,-4403,16.5,FALSE,0,FALSE,19633,20300,4403,23.8
FALSE,FALSE,0,FALSE,16600,18188,-189,25,TRUE,1,TRUE,16789,19306,189,20.7
FALSE,FALSE,0,FALSE,16240,16610,-2156,20.9,TRUE,1,TRUE,18396,17662,2156,16.7
TRUE,TRUE,1,TRUE,18722,19399,4371,21.6,FALSE,0,FALSE,14351,16300,-4371,22.8
FALSE,TRUE,0,FALSE,15640,18748,77,24.6,FALSE,1,TRUE,15563,18118,-77,24.8
TRUE,TRUE,0,FALSE,17940,19767,1938,24.2,FALSE,1,TRUE,16002,19029,-1938,22.1
FALSE,FALSE,0,FALSE,16414,18297,-58,24.7,TRUE,1,TRUE,16472,19344,58,24.4
FALSE,FALSE,0,FALSE,14207,16373,-2723,21.1,TRUE,1,TRUE,16930,17435,2723,20.8
TRUE,TRUE,1,TRUE,16737,18903,1411,24,FALSE,0,FALSE,15326,17740,-1411,17.7
FALSE,FALSE,0,FALSE,14672,16566,-2998,23.4,TRUE,0,FALSE,17670,19897,2998,25.1
TRUE,TRUE,1,TRUE,15360,17742,97,22.8,FALSE,0,FALSE,15263,18806,-97,22
TRUE,TRUE,1,TRUE,17795,19039,1395,21.3,FALSE,0,FALSE,16400,17096,-1395,19.8
TRUE,TRUE,1,TRUE,16896,18664,2438,24.6,FALSE,0,FALSE,14458,17559,-2438,21.1
FALSE,FALSE,0,FALSE,16182,18355,-925,21.6,TRUE,2,TRUE,17107,18715,925,21.2
TRUE,FALSE,1,FALSE,17729,17260,679,19,TRUE,0,FALSE,17050,17049,-679,19.2
FALSE,TRUE,1,FALSE,17552,18284,1050,22.2,FALSE,1,TRUE,16502,19554,-1050,19.2
TRUE,TRUE,2,TRUE,16491,19790,392,21.4,FALSE,0,FALSE,16099,18924,-392,24.1
FALSE,TRUE,0,FALSE,17643,18331,24,22.1,FALSE,1,TRUE,17619,17848,-24,15.3
TRUE,TRUE,0,FALSE,16247,19667,266,21.8,FALSE,1,TRUE,15981,17929,-266,21.3
TRUE,TRUE,0,FALSE,17072,16658,1396,19.2,FALSE,1,TRUE,15676,16569,-1396,17.9
TRUE,TRUE,2,TRUE,18882,18137,3807,20.2,FALSE,0,FALSE,15075,16288,-3807,18.7
FALSE,TRUE,0,FALSE,14520,17410,-1127,18.2,FALSE,0,FALSE,15647,18253,1127,23.4
TRUE,TRUE,1,TRUE,18374,20120,3823,22.9,FALSE,0,FALSE,14551,16796,-3823,17.6
FALSE,TRUE,1,TRUE,16073,17592,32,21.1,FALSE,1,FALSE,16041,16770,-32,20.7
TRUE,TRUE,1,TRUE,16448,18932,1306,24.8,FALSE,0,FALSE,15142,18501,-1306,26.2
TRUE,TRUE,1,TRUE,18821,18407,1618,20.3,FALSE,1,FALSE,17203,17893,-1618,18.1
FALSE,FALSE,1,FALSE,15485,17138,-2854,19.3,TRUE,0,FALSE,18339,19936,2854,22.5
FALSE,TRUE,1,TRUE,15129,16869,-1417,20.4,FALSE,0,FALSE,16546,16009,1417,18.2
TRUE,TRUE,0,FALSE,16329,17600,1320,20.5,FALSE,0,FALSE,15009,17778,-1320,21.8
TRUE,TRUE,0,FALSE,16807,19976,2954,26.3,FALSE,1,TRUE,13853,16246,-2954,17.7
TRUE,FALSE,0,FALSE,20330,18408,2460,23.4,TRUE,1,TRUE,17870,17910,-2460,20.5
TRUE,FALSE,1,TRUE,16666,17512,132,18.5,TRUE,0,FALSE,16534,17540,-132,23.7
TRUE,TRUE,1,TRUE,16946,17723,2276,24.7,FALSE,0,FALSE,14670,16093,-2276,19.4
TRUE,TRUE,0,FALSE,17028,19169,1586,24.7,FALSE,1,TRUE,15442,16547,-1586,21.4
FALSE,FALSE,1,FALSE,16686,19183,-418,24,TRUE,1,TRUE,17104,19123,418,27.3
TRUE,FALSE,1,TRUE,14993,16922,-1449,22.3,TRUE,0,FALSE,16442,17461,1449,25.5
TRUE,FALSE,0,FALSE,14654,17393,-663,20.1,TRUE,1,TRUE,15317,17806,663,24.8
TRUE,FALSE,0,FALSE,15570,17440,-339,23.2,TRUE,2,TRUE,15909,18969,339,24.4
TRUE,FALSE,0,FALSE,17178,18476,-597,21.6,TRUE,0,FALSE,17775,19674,597,25.3
FALSE,FALSE,0,FALSE,14333,17362,-2671,22.2,TRUE,1,TRUE,17004,18620,2671,22.4
FALSE,FALSE,0,FALSE,14453,17152,-2889,24.4,TRUE,1,TRUE,17342,20034,2889,21.6
TRUE,FALSE,1,FALSE,15932,17831,-1111,23.8,TRUE,1,TRUE,17043,17152,1111,19.1
FALSE,FALSE,0,FALSE,15101,18480,-1972,22.6,TRUE,1,TRUE,17073,19197,1972,26.3
FALSE,FALSE,0,FALSE,16628,18812,1457,21.6,TRUE,1,TRUE,15171,18097,-1457,20.8
FALSE,FALSE,2,TRUE,14997,16588,-2566,21.7,TRUE,0,FALSE,17563,18812,2566,21.6
TRUE,TRUE,1,FALSE,17664,18757,563,23.3,FALSE,0,FALSE,17101,18315,-563,21.9
TRUE,FALSE,1,TRUE,15082,17691,-2924,21.1,TRUE,0,FALSE,18006,19278,2924,21.6
FALSE,FALSE,1,TRUE,16964,18163,-2935,21.4,TRUE,0,FALSE,19899,19625,2935,23.5
TRUE,FALSE,0,FALSE,16999,17880,1671,22.8,TRUE,1,TRUE,15328,16808,-1671,20.6
TRUE,TRUE,0,FALSE,16621,17333,282,22,FALSE,0,FALSE,16339,16934,-282,21.6
TRUE,FALSE,1,TRUE,17060,17118,-896,17.9,TRUE,0,FALSE,17956,17779,896,20
FALSE,TRUE,1,TRUE,14758,15950,-2993,20.2,FALSE,1,FALSE,17751,18444,2993,21.5
TRUE,TRUE,1,TRUE,17117,18326,1810,20.4,FALSE,0,FALSE,15307,17314,-1810,21.1
TRUE,FALSE,0,FALSE,16413,17648,-2461,20.4,TRUE,1,TRUE,18874,19476,2461,22.3
FALSE,FALSE,0,FALSE,14448,15930,-1620,20.9,TRUE,1,FALSE,16068,17361,1620,20.4
TRUE,TRUE,0,FALSE,16778,18893,2375,24.7,FALSE,0,FALSE,14403,16205,-2375,23.5
FALSE,FALSE,1,TRUE,14494,18008,-618,24.4,TRUE,0,FALSE,15112,18421,618,24.7
TRUE,TRUE,0,FALSE,18267,19241,2253,22.6,FALSE,0,FALSE,16014,17159,-2253,17.8
FALSE,TRUE,1,TRUE,16440,18417,2821,20.8,FALSE,0,FALSE,13619,15663,-2821,20.3
TRUE,FALSE,2,TRUE,17390,19016,1716,21.2,TRUE,0,FALSE,15674,17179,-1716,22.6
TRUE,TRUE,0,FALSE,17035,18588,501,23.5,FALSE,0,FALSE,16534,19083,-501,20.7
FALSE,TRUE,0,FALSE,17198,15293,-2830,15.6,FALSE,1,TRUE,20028,17505,2830,17.4
TRUE,TRUE,1,FALSE,17430,18040,3140,21,FALSE,0,FALSE,14290,16216,-3140,22.8
FALSE,TRUE,1,FALSE,15320,16960,-1152,21.7,FALSE,1,TRUE,16472,18495,1152,22.5
FALSE,FALSE,0,FALSE,15347,17612,-704,24.3,TRUE,1,TRUE,16051,17805,704,22
TRUE,TRUE,0,FALSE,18002,19391,2621,19.9,FALSE,0,FALSE,15381,16908,-2621,19.5
FALSE,FALSE,0,FALSE,17901,16538,-2529,17.1,TRUE,1,FALSE,20430,18145,2529,20.5
FALSE,FALSE,0,FALSE,14205,18034,-1099,19.7,TRUE,1,TRUE,15304,18430,1099,23.6
FALSE,FALSE,0,FALSE,13772,14954,-3147,17.8,TRUE,1,FALSE,16919,18277,3147,22.3
TRUE,TRUE,1,TRUE,17231,19272,3142,23.7,FALSE,0,FALSE,14089,17235,-3142,24.5
FALSE,FALSE,0,FALSE,15983,19337,-1231,23.3,TRUE,0,FALSE,17214,18841,1231,20.1
FALSE,TRUE,0,FALSE,14651,18301,-1991,24.1,FALSE,0,FALSE,16642,19356,1991,24.8
TRUE,TRUE,1,TRUE,18789,20433,4250,23.1,FALSE,0,FALSE,14539,16517,-4250,22.3
FALSE,FALSE,0,FALSE,15485,16784,-3683,21.3,TRUE,2,TRUE,19168,20204,3683,20.9
TRUE,TRUE,1,FALSE,17992,18842,3313,21.2,FALSE,1,TRUE,14679,17377,-3313,21.7
TRUE,TRUE,1,TRUE,18828,18186,2117,19.7,FALSE,1,FALSE,16711,18006,-2117,20.9
FALSE,TRUE,0,FALSE,14797,17124,-3268,21.2,FALSE,1,TRUE,18065,21012,3268,21.8
TRUE,FALSE,1,TRUE,15524,17843,-629,22.8,TRUE,0,FALSE,16153,18052,629,19.2
TRUE,TRUE,2,TRUE,18288,20765,3184,23.4,FALSE,0,FALSE,15104,16891,-3184,20.9
FALSE,FALSE,0,FALSE,16304,18344,-890,22.2,TRUE,2,TRUE,17194,19605,890,21.8
FALSE,FALSE,1,TRUE,14974,15389,-4646,20.1,TRUE,0,FALSE,19620,18575,4646,20.1
FALSE,TRUE,0,FALSE,16598,18693,1937,25.6,FALSE,1,TRUE,14661,17674,-1937,23.9
TRUE,TRUE,0,FALSE,15273,16349,15,18.9,FALSE,1,TRUE,15258,18457,-15,21.6
FALSE,TRUE,0,FALSE,15515,18510,-44,22.2,FALSE,0,FALSE,15559,17837,44,21.8
FALSE,TRUE,0,FALSE,16024,19005,3133,22,FALSE,0,FALSE,12891,16628,-3133,20.6
FALSE,TRUE,0,FALSE,15667,17592,-2450,22.5,FALSE,1,TRUE,18117,19852,2450,25.2
TRUE,FALSE,0,FALSE,18451,19111,1309,22.6,TRUE,0,FALSE,17142,18454,-1309,20.6
FALSE,FALSE,0,FALSE,16355,17998,-994,19.8,TRUE,1,TRUE,17349,17732,994,20.2
FALSE,TRUE,1,FALSE,15140,15933,-4199,19.8,FALSE,0,FALSE,19339,19348,4199,22.1
FALSE,TRUE,0,FALSE,15755,18468,1684,25.8,FALSE,0,FALSE,14071,16695,-1684,21.2
TRUE,FALSE,0,FALSE,16302,18040,95,21.2,TRUE,1,TRUE,16207,17268,-95,20.5
FALSE,FALSE,0,FALSE,13825,16773,-3453,17.3,TRUE,0,FALSE,17278,19355,3453,23.7
FALSE,TRUE,1,TRUE,16724,18895,2432,22.9,FALSE,0,FALSE,14292,17020,-2432,22.1
TRUE,TRUE,0,FALSE,18442,19414,2680,24.8,FALSE,2,TRUE,15762,17714,-2680,24
FALSE,TRUE,0,FALSE,17008,18223,-4178,21.7,FALSE,1,TRUE,21186,19525,4178,21.9
TRUE,FALSE,1,TRUE,16513,18334,897,24.9,TRUE,0,FALSE,15616,17528,-897,20.1
FALSE,FALSE,0,FALSE,15554,18372,-1232,24.2,TRUE,1,TRUE,16786,19392,1232,23
TRUE,FALSE,0,FALSE,15400,17541,-4112,21.5,TRUE,0,FALSE,19512,20034,4112,21.9
TRUE,TRUE,1,TRUE,19052,18439,2514,24.2,FALSE,0,FALSE,16538,17023,-2514,19.7
FALSE,TRUE,1,TRUE,16039,16635,-2088,19.8,FALSE,0,FALSE,18127,18788,2088,20.1
FALSE,TRUE,1,TRUE,17093,18357,-414,23.3,FALSE,0,FALSE,17507,18958,414,24.3
FALSE,FALSE,0,FALSE,15440,16864,-3368,20.7,TRUE,0,FALSE,18808,20248,3368,21.6
TRUE,FALSE,0,FALSE,15547,18141,-539,21.4,TRUE,1,TRUE,16086,17418,539,20.7
FALSE,TRUE,0,FALSE,16275,16968,495,19,FALSE,0,FALSE,15780,16947,-495,19.7
TRUE,TRUE,1,TRUE,17627,19004,1794,20.4,FALSE,0,FALSE,15833,18077,-1794,19.4
FALSE,FALSE,1,TRUE,16641,18150,1459,22.1,TRUE,0,FALSE,15182,17180,-1459,21
TRUE,FALSE,1,TRUE,16009,17605,685,19.4,TRUE,0,FALSE,15324,17272,-685,25.2
FALSE,TRUE,1,TRUE,15010,16558,-782,21.1,FALSE,0,FALSE,15792,17989,782,24.8
TRUE,FALSE,1,TRUE,15969,18868,-876,19.5,TRUE,0,FALSE,16845,18479,876,22.8
FALSE,TRUE,0,FALSE,15007,17469,-302,23.2,FALSE,0,FALSE,15309,18115,302,24.8
FALSE,TRUE,0,FALSE,14494,15036,-4235,20.8,FALSE,1,TRUE,18729,19962,4235,25.4
TRUE,FALSE,1,FALSE,16576,18349,-316,22,TRUE,0,FALSE,16892,18286,316,21.4
FALSE,FALSE,0,FALSE,16575,18524,-2362,20.4,TRUE,0,FALSE,18937,18445,2362,24.7
FALSE,TRUE,2,TRUE,19339,19966,3708,22.5,FALSE,0,FALSE,15631,17065,-3708,20.3
TRUE,FALSE,1,TRUE,16621,19387,-258,20.6,TRUE,0,FALSE,16879,18818,258,22.5
FALSE,FALSE,1,FALSE,14308,17611,-2634,23.5,TRUE,1,TRUE,16942,18893,2634,24.7
FALSE,TRUE,0,FALSE,15165,16025,-3709,18.8,FALSE,1,TRUE,18874,20040,3709,22.7
FALSE,FALSE,0,FALSE,18754,20402,4074,20.2,TRUE,1,TRUE,14680,16481,-4074,20
FALSE,FALSE,1,TRUE,16608,18459,-26,23.3,TRUE,0,FALSE,16634,17470,26,20.3
FALSE,TRUE,1,TRUE,16375,18026,143,17.2,FALSE,1,FALSE,16232,17313,-143,21.7
TRUE,FALSE,1,FALSE,15987,17964,-155,20.7,TRUE,0,FALSE,16142,18011,155,23.1
FALSE,FALSE,1,TRUE,17027,19345,302,21.7,TRUE,1,FALSE,16725,17925,-302,23.7
FALSE,FALSE,0,FALSE,15885,16350,-1615,21.6,TRUE,2,TRUE,17500,17743,1615,22.1
FALSE,TRUE,1,TRUE,16238,18724,1443,24.1,FALSE,0,FALSE,14795,19177,-1443,21.5
FALSE,TRUE,0,FALSE,16778,17640,-1446,21.8,FALSE,2,TRUE,18224,18605,1446,23.4
FALSE,FALSE,0,FALSE,17004,19168,341,21.6,TRUE,1,TRUE,16663,19520,-341,20.7
TRUE,TRUE,0,FALSE,17668,17036,-120,18.4,FALSE,0,FALSE,17788,17429,120,19.4
TRUE,FALSE,1,TRUE,16389,18131,566,22.5,TRUE,1,FALSE,15823,18659,-566,26.1
TRUE,TRUE,0,FALSE,17252,15960,166,18.8,FALSE,1,TRUE,17086,17604,-166,19.2
TRUE,TRUE,1,TRUE,17854,16635,-49,19.5,FALSE,1,FALSE,17903,18438,49,23.8
FALSE,FALSE,0,FALSE,15431,17309,-2661,21.8,TRUE,2,TRUE,18092,20499,2661,26
FALSE,TRUE,0,FALSE,14985,17710,-1522,22.4,FALSE,1,TRUE,16507,19147,1522,25.3
TRUE,TRUE,0,FALSE,16008,18674,1060,23.7,FALSE,1,TRUE,14948,16966,-1060,21.1
TRUE,FALSE,1,FALSE,19663,19052,4043,24.7,TRUE,0,FALSE,15620,17249,-4043,21.4
TRUE,TRUE,1,TRUE,16932,19942,2699,23.5,FALSE,0,FALSE,14233,17367,-2699,24.2
TRUE,FALSE,0,FALSE,17026,18824,843,21.2,TRUE,1,TRUE,16183,17048,-843,22
TRUE,TRUE,1,TRUE,17803,20184,2193,26.7,FALSE,0,FALSE,15610,17227,-2193,20.7
TRUE,TRUE,1,TRUE,15582,18842,-18,23.4,FALSE,0,FALSE,15600,18054,18,20.2
TRUE,FALSE,0,FALSE,14808,16826,-1352,21.9,TRUE,0,FALSE,16160,19165,1352,25.7
FALSE,TRUE,1,TRUE,16497,16957,-1736,20.7,FALSE,0,FALSE,18233,19649,1736,24.6
TRUE,TRUE,0,FALSE,16503,18377,171,24,FALSE,1,TRUE,16332,18335,-171,23.2
FALSE,TRUE,0,FALSE,15522,18255,-1711,22,FALSE,1,TRUE,17233,19661,1711,23.9
FALSE,FALSE,0,FALSE,17371,17227,-2793,18.3,TRUE,0,FALSE,20164,20643,2793,22.8
FALSE,TRUE,1,TRUE,17720,19150,1549,23.2,FALSE,1,FALSE,16171,17971,-1549,21.2
TRUE,TRUE,1,TRUE,17981,19233,2565,24.5,FALSE,0,FALSE,15416,17599,-2565,19.9
FALSE,TRUE,2,TRUE,15229,16903,-174,16,FALSE,0,FALSE,15403,16973,174,23.5
FALSE,TRUE,1,FALSE,16425,18524,-1029,20.1,FALSE,1,TRUE,17454,17770,1029,22.5
FALSE,TRUE,1,TRUE,15790,17238,785,20.9,FALSE,0,FALSE,15005,17588,-785,24.1
TRUE,TRUE,0,FALSE,17339,19573,3652,23.7,FALSE,1,TRUE,13687,17630,-3652,21.7
FALSE,TRUE,0,FALSE,16487,18146,995,22.9,FALSE,0,FALSE,15492,18604,-995,23
TRUE,TRUE,0,FALSE,17922,18511,3703,22.4,FALSE,0,FALSE,14219,15393,-3703,20.6
FALSE,TRUE,2,TRUE,16778,18459,-74,23.6,FALSE,0,FALSE,16852,18941,74,21.2
TRUE,TRUE,2,TRUE,18068,18462,719,20.4,FALSE,0,FALSE,17349,18075,-719,20.3
TRUE,TRUE,1,TRUE,17366,17659,1074,22.9,FALSE,0,FALSE,16292,17607,-1074,24.5
TRUE,FALSE,1,FALSE,15041,17616,-3259,22.9,TRUE,1,TRUE,18300,18927,3259,24.9
FALSE,TRUE,0,FALSE,15135,16444,-3704,19.7,FALSE,1,TRUE,18839,20805,3704,24.4
FALSE,FALSE,1,FALSE,16083,16509,-2772,21.8,TRUE,1,TRUE,18855,19466,2772,20.7
TRUE,TRUE,1,TRUE,17446,19285,2322,22.3,FALSE,0,FALSE,15124,18237,-2322,22.2
FALSE,FALSE,0,FALSE,14284,17853,-3304,24.3,TRUE,1,TRUE,17588,19358,3304,23.7
TRUE,TRUE,0,FALSE,17585,19364,1393,21.3,FALSE,1,TRUE,16192,17693,-1393,20.7
TRUE,TRUE,2,TRUE,16537,19213,2954,23.2,FALSE,0,FALSE,13583,16769,-2954,20.2
TRUE,TRUE,1,TRUE,18895,18495,3409,24.5,FALSE,0,FALSE,15486,16531,-3409,18
FALSE,TRUE,0,FALSE,14370,15153,-5228,16.7,FALSE,0,FALSE,19598,21641,5228,25
TRUE,TRUE,0,FALSE,18274,18252,2422,24.2,FALSE,0,FALSE,15852,17596,-2422,22.8
TRUE,TRUE,1,TRUE,18286,16569,149,18.3,FALSE,1,FALSE,18137,18137,-149,20.5
FALSE,FALSE,1,TRUE,16352,18216,-435,22.4,TRUE,0,FALSE,16787,19647,435,23.3
FALSE,FALSE,0,FALSE,17546,18498,510,19.1,TRUE,1,TRUE,17036,17577,-510,21.7
FALSE,FALSE,0,FALSE,16433,18008,-2203,22.7,TRUE,1,FALSE,18636,20684,2203,20.4
TRUE,TRUE,0,FALSE,15414,18476,-304,23.2,FALSE,1,TRUE,15718,19539,304,23.7
FALSE,FALSE,0,FALSE,17737,18616,648,23.4,TRUE,1,TRUE,17089,17999,-648,20.2
FALSE,TRUE,1,TRUE,17570,18879,1365,22.2,FALSE,0,FALSE,16205,17316,-1365,22
FALSE,FALSE,0,FALSE,17131,18470,-2550,24.2,TRUE,0,FALSE,19681,20170,2550,25.8
FALSE,TRUE,1,FALSE,17237,17508,1932,22.6,FALSE,1,TRUE,15305,17340,-1932,18.2
TRUE,FALSE,0,FALSE,17814,18465,1692,20.6,TRUE,0,FALSE,16122,16690,-1692,19.6
TRUE,FALSE,1,TRUE,16738,19296,624,21.4,TRUE,0,FALSE,16114,18088,-624,22.5
TRUE,TRUE,0,FALSE,18092,18652,4024,21.3,FALSE,1,TRUE,14068,16187,-4024,21.2
FALSE,FALSE,0,FALSE,16522,17675,-1128,22.3,TRUE,1,TRUE,17650,20385,1128,22.4
TRUE,TRUE,1,TRUE,18053,18267,4135,24.7,FALSE,0,FALSE,13918,16892,-4135,21.1
FALSE,TRUE,0,FALSE,19475,18887,4765,23.3,FALSE,1,TRUE,14710,15833,-4765,20.2
FALSE,TRUE,1,TRUE,18693,19277,1581,20.6,FALSE,0,FALSE,17112,17378,-1581,20.7
TRUE,FALSE,1,TRUE,16488,18632,1603,22,TRUE,1,FALSE,14885,16805,-1603,19.7
FALSE,TRUE,0,FALSE,17531,18252,2236,23,FALSE,0,FALSE,15295,17964,-2236,21.2
TRUE,TRUE,0,FALSE,15422,16988,1391,21.5,FALSE,1,TRUE,14031,16774,-1391,23.2
FALSE,FALSE,0,FALSE,15276,18400,-1729,21.4,TRUE,1,TRUE,17005,18837,1729,25
FALSE,TRUE,2,TRUE,17390,17256,614,19.6,FALSE,0,FALSE,16776,17578,-614,21.3
FALSE,TRUE,0,FALSE,17593,17439,-1538,17.8,FALSE,2,TRUE,19131,18672,1538,20.1
FALSE,FALSE,0,FALSE,15820,18253,-2116,20.3,TRUE,1,TRUE,17936,19660,2116,22.3
TRUE,TRUE,0,FALSE,17198,17495,2973,22.6,FALSE,1,TRUE,14225,15657,-2973,14.1
TRUE,FALSE,1,TRUE,17000,18009,-149,19,TRUE,0,FALSE,17149,17582,149,21.1
FALSE,FALSE,0,FALSE,15196,18612,-1240,20.9,TRUE,1,TRUE,16436,18688,1240,21
TRUE,TRUE,0,FALSE,16358,17640,-2651,20.6,FALSE,0,FALSE,19009,19335,2651,21.8
TRUE,TRUE,1,TRUE,17469,16911,-1022,19.5,FALSE,0,FALSE,18491,18111,1022,24.8
TRUE,FALSE,1,TRUE,16031,17458,1643,21.8,TRUE,0,FALSE,14388,16576,-1643,22.5
FALSE,TRUE,1,TRUE,17070,18971,760,22.3,FALSE,0,FALSE,16310,17976,-760,23
FALSE,FALSE,0,FALSE,14782,17600,-1454,23.8,TRUE,1,TRUE,16236,18876,1454,20.4
TRUE,TRUE,1,FALSE,16610,19266,1875,24.6,FALSE,1,TRUE,14735,17192,-1875,20.7
TRUE,FALSE,1,TRUE,17255,18288,2116,23.7,TRUE,0,FALSE,15139,16675,-2116,20.3
FALSE,FALSE,0,FALSE,14259,15830,-1034,20.2,TRUE,1,TRUE,15293,16676,1034,22.9
FALSE,TRUE,0,FALSE,16100,18918,-577,22.3,FALSE,2,TRUE,16677,19597,577,23.7
TRUE,TRUE,1,TRUE,19641,19614,6310,20.7,FALSE,0,FALSE,13331,14478,-6310,19.9
TRUE,FALSE,1,TRUE,17346,18654,1482,20.8,TRUE,0,FALSE,15864,17025,-1482,21.1
TRUE,FALSE,0,FALSE,16002,19380,787,23,TRUE,1,TRUE,15215,18291,-787,23.1
TRUE,TRUE,1,TRUE,16070,19798,2170,23.6,FALSE,0,FALSE,13900,17318,-2170,24
FALSE,FALSE,0,FALSE,14227,16822,-2617,20.5,TRUE,1,TRUE,16844,19144,2617,20.8
TRUE,TRUE,0,FALSE,18715,19675,4058,22.6,FALSE,0,FALSE,14657,16268,-4058,22.9
TRUE,TRUE,1,TRUE,17375,18035,238,21.7,FALSE,0,FALSE,17137,17667,-238,20.7
FALSE,FALSE,0,FALSE,15162,18046,-1980,22.7,TRUE,0,FALSE,17142,19019,1980,25.6
FALSE,FALSE,1,TRUE,15571,16898,-1137,19,TRUE,1,FALSE,16708,17880,1137,22.8
TRUE,TRUE,1,TRUE,15070,17424,-124,21.8,FALSE,0,FALSE,15194,17171,124,19.8
TRUE,TRUE,2,TRUE,18723,18851,2246,19,FALSE,0,FALSE,16477,17586,-2246,22.7
FALSE,TRUE,1,FALSE,17258,18755,-978,21.4,FALSE,1,TRUE,18236,18677,978,20.7
FALSE,TRUE,1,FALSE,16103,18747,-2659,20.8,FALSE,0,FALSE,18762,18659,2659,24.5
FALSE,FALSE,1,FALSE,14709,17193,-3224,20.7,TRUE,1,TRUE,17933,18463,3224,23.8
FALSE,TRUE,0,FALSE,17122,17535,312,20.4,FALSE,1,TRUE,16810,18931,-312,21.1
FALSE,TRUE,1,TRUE,13696,16789,-2462,20,FALSE,1,FALSE,16158,20141,2462,20.2
TRUE,TRUE,1,TRUE,17764,19589,2617,23.5,FALSE,0,FALSE,15147,17178,-2617,22
TRUE,TRUE,0,FALSE,16275,19461,846,24.4,FALSE,0,FALSE,15429,18323,-846,23.3
TRUE,TRUE,2,TRUE,20124,19495,6450,23,FALSE,0,FALSE,13674,14438,-6450,20.5
FALSE,FALSE,0,FALSE,15775,17025,-2861,20.6,TRUE,1,TRUE,18636,18676,2861,21
TRUE,TRUE,2,TRUE,15693,17206,355,19.9,FALSE,0,FALSE,15338,16388,-355,19.2
TRUE,TRUE,0,FALSE,17479,18923,2305,24.6,FALSE,2,TRUE,15174,18441,-2305,22.6
TRUE,FALSE,1,FALSE,17840,19273,-359,22.6,TRUE,1,TRUE,18199,18489,359,20.7
FALSE,FALSE,0,FALSE,15259,15471,-3967,18,TRUE,0,FALSE,19226,18585,3967,24.7
FALSE,FALSE,1,TRUE,15225,16104,-5182,18.7,TRUE,1,FALSE,20407,19988,5182,24.6
TRUE,TRUE,0,FALSE,17312,19125,2344,21.7,FALSE,0,FALSE,14968,17608,-2344,20.1
FALSE,FALSE,1,FALSE,16696,17832,865,20.6,TRUE,0,FALSE,15831,16826,-865,22
TRUE,FALSE,0,FALSE,16690,18319,-516,23.5,TRUE,1,TRUE,17206,18322,516,23.5
FALSE,FALSE,0,FALSE,16225,18754,-38,21.9,TRUE,0,FALSE,16263,17587,38,23.9
FALSE,TRUE,0,FALSE,15720,15834,-2510,21.2,FALSE,2,TRUE,18230,20080,2510,24.9
FALSE,FALSE,0,FALSE,13738,15483,-6260,16.9,TRUE,0,FALSE,19998,18847,6260,23.8
TRUE,TRUE,1,TRUE,18240,19116,2953,25.9,FALSE,0,FALSE,15287,17136,-2953,19.7
TRUE,TRUE,1,TRUE,16439,18635,1603,22,FALSE,1,FALSE,14836,16836,-1603,21.3
FALSE,TRUE,0,FALSE,15761,18196,-1454,25.3,FALSE,0,FALSE,17215,19401,1454,23.3
FALSE,TRUE,1,FALSE,18529,18459,1550,22.7,FALSE,1,TRUE,16979,17549,-1550,20.6
FALSE,FALSE,0,FALSE,16996,18052,-1065,22.7,TRUE,0,FALSE,18061,17426,1065,21.6
TRUE,TRUE,0,FALSE,17665,17473,753,20.7,FALSE,0,FALSE,16912,18060,-753,19.1
TRUE,TRUE,1,TRUE,16969,18900,-877,19.8,FALSE,0,FALSE,17846,18482,877,22.9
FALSE,FALSE,1,TRUE,15474,19351,-902,24.4,TRUE,1,FALSE,16376,18966,902,23.7
TRUE,FALSE,1,TRUE,18204,18154,1790,18.6,TRUE,0,FALSE,16414,17804,-1790,22.9
FALSE,FALSE,0,FALSE,17160,18228,1497,24.1,TRUE,1,TRUE,15663,17511,-1497,21.8
TRUE,TRUE,0,FALSE,16876,18664,2717,25.6,FALSE,0,FALSE,14159,15849,-2717,20.5
TRUE,FALSE,0,FALSE,18129,19644,2428,23,TRUE,1,TRUE,15701,17458,-2428,21.2
TRUE,FALSE,0,FALSE,17210,19805,42,24.3,TRUE,1,TRUE,17168,18438,-42,25.5
TRUE,FALSE,0,FALSE,15067,16500,-3574,20.3,TRUE,1,FALSE,18641,16887,3574,21.8
FALSE,FALSE,1,TRUE,15013,17384,-1008,19.8,TRUE,0,FALSE,16021,18101,1008,22.5
TRUE,TRUE,0,FALSE,16946,19649,714,22.1,FALSE,0,FALSE,16232,17999,-714,21.5
TRUE,FALSE,0,FALSE,18403,19486,2239,23.9,TRUE,1,TRUE,16164,17947,-2239,23.1
FALSE,FALSE,1,FALSE,14115,16918,-1909,19.9,TRUE,1,TRUE,16024,18200,1909,22.9
TRUE,TRUE,0,FALSE,15321,18162,305,25.5,FALSE,1,TRUE,15016,17170,-305,22.2
FALSE,TRUE,0,FALSE,15850,18559,144,21.6,FALSE,1,TRUE,15706,18247,-144,23.8
TRUE,FALSE,0,FALSE,15704,17817,789,24.6,TRUE,1,TRUE,14915,17992,-789,23.2
TRUE,FALSE,1,FALSE,17716,17963,8,21.6,TRUE,1,TRUE,17708,18588,-8,24.9
FALSE,TRUE,1,FALSE,16604,18077,-754,23.5,FALSE,0,FALSE,17358,18234,754,24.3
FALSE,TRUE,0,FALSE,14808,16376,-3363,18,FALSE,0,FALSE,18171,18296,3363,21.2
TRUE,FALSE,0,FALSE,15924,17006,-510,19.1,TRUE,1,TRUE,16434,17843,510,22.5
FALSE,TRUE,0,FALSE,14994,16731,-1080,19.9,FALSE,1,FALSE,16074,18395,1080,23.5
FALSE,FALSE,0,FALSE,13533,15497,-2191,21.2,TRUE,1,TRUE,15724,16995,2191,20.7
TRUE,FALSE,0,FALSE,18314,21257,3274,25.7,TRUE,1,TRUE,15040,17995,-3274,19.5
FALSE,FALSE,0,FALSE,16387,18488,149,23.5,TRUE,1,TRUE,16238,18278,-149,20.2
FALSE,FALSE,0,FALSE,15629,17035,-317,21.2,TRUE,1,TRUE,15946,17062,317,20
TRUE,TRUE,1,TRUE,16070,18706,2422,25.1,FALSE,0,FALSE,13648,16940,-2422,19.9
FALSE,TRUE,1,TRUE,15596,18105,370,22.3,FALSE,0,FALSE,15226,18171,-370,20
TRUE,TRUE,1,TRUE,17010,18660,2312,25,FALSE,0,FALSE,14698,17485,-2312,22
FALSE,FALSE,1,FALSE,17431,17957,-96,20.8,TRUE,1,TRUE,17527,17680,96,21.5
FALSE,FALSE,0,FALSE,16664,17627,-2262,21.4,TRUE,1,TRUE,18926,19390,2262,19.5
FALSE,TRUE,0,FALSE,15144,16164,-4293,19.7,FALSE,0,FALSE,19437,19895,4293,24.1
FALSE,TRUE,0,FALSE,15703,17085,-1085,19.5,FALSE,2,TRUE,16788,18954,1085,22.9
TRUE,TRUE,0,FALSE,18062,17582,2301,22,FALSE,1,TRUE,15761,16915,-2301,20.4
FALSE,FALSE,1,TRUE,16787,17483,800,20.8,TRUE,0,FALSE,15987,17720,-800,23.6
TRUE,FALSE,1,FALSE,19785,20587,2510,22.1,TRUE,1,TRUE,17275,18070,-2510,21.3
TRUE,TRUE,2,TRUE,18408,19955,1917,20.8,FALSE,0,FALSE,16491,18769,-1917,21.1
FALSE,FALSE,1,TRUE,18614,18540,-558,20.8,TRUE,0,FALSE,19172,20022,558,22.7
TRUE,TRUE,1,FALSE,19704,18253,3067,20.9,FALSE,1,TRUE,16637,17750,-3067,17.4
FALSE,FALSE,1,TRUE,15281,17495,-1201,24.8,TRUE,0,FALSE,16482,18414,1201,24.7
FALSE,FALSE,1,TRUE,13253,16475,-2310,19,TRUE,0,FALSE,15563,18765,2310,24.8
FALSE,FALSE,1,TRUE,17192,17774,203,19,TRUE,0,FALSE,16989,17217,-203,23.5
FALSE,FALSE,1,TRUE,16796,18185,117,23.2,TRUE,0,FALSE,16679,17937,-117,22.1
TRUE,FALSE,1,TRUE,18582,18084,2419,20.7,TRUE,0,FALSE,16163,16966,-2419,19.3
FALSE,FALSE,1,FALSE,17098,20021,447,24.3,TRUE,0,FALSE,16651,19102,-447,22
FALSE,FALSE,1,FALSE,15766,17649,-1219,20.9,TRUE,1,TRUE,16985,18408,1219,22.7
TRUE,TRUE,1,TRUE,14767,16754,-1371,21.4,FALSE,0,FALSE,16138,18705,1371,25.6
TRUE,TRUE,2,TRUE,18929,18674,3235,17,FALSE,0,FALSE,15694,17506,-3235,24.1
TRUE,TRUE,1,TRUE,18046,19739,2299,22.6,FALSE,0,FALSE,15747,17935,-2299,22.9
FALSE,FALSE,1,TRUE,17035,17308,-1556,20.4,TRUE,0,FALSE,18591,20489,1556,21.3
FALSE,FALSE,0,FALSE,15992,17572,-1323,25.1,TRUE,2,TRUE,17315,19194,1323,21.8
TRUE,TRUE,0,FALSE,17791,18244,1625,21.6,FALSE,1,TRUE,16166,17692,-1625,21.5
TRUE,FALSE,1,TRUE,16517,17812,819,24.6,TRUE,0,FALSE,15698,17860,-819,24.5
FALSE,TRUE,1,TRUE,15863,18126,-735,17.8,FALSE,0,FALSE,16598,18868,735,23.1
TRUE,TRUE,0,FALSE,16779,18382,2386,26.8,FALSE,0,FALSE,14393,17987,-2386,20.4
FALSE,FALSE,0,FALSE,17145,18179,-1281,18,TRUE,0,FALSE,18426,18704,1281,21.2
TRUE,FALSE,0,FALSE,15161,17998,-786,19.4,TRUE,1,TRUE,15947,18835,786,23.1
TRUE,TRUE,1,TRUE,17451,18484,-224,24.9,FALSE,0,FALSE,17675,20365,224,20.5
TRUE,TRUE,0,FALSE,18342,20325,2587,22.4,FALSE,1,TRUE,15755,17566,-2587,21.3
TRUE,FALSE,1,TRUE,16498,18296,460,25.9,TRUE,0,FALSE,16038,18113,-460,21.3
FALSE,FALSE,0,FALSE,14975,17721,-3348,22.7,TRUE,1,FALSE,18323,19516,3348,22.4
TRUE,TRUE,1,FALSE,17017,19023,2350,20.4,FALSE,1,TRUE,14667,16318,-2350,22
FALSE,FALSE,0,FALSE,13872,17095,-6115,19.7,TRUE,0,FALSE,19987,20304,6115,26.4
TRUE,FALSE,2,TRUE,17940,19545,1340,21.6,TRUE,0,FALSE,16600,17719,-1340,21.9
FALSE,TRUE,0,FALSE,14037,15309,-2491,16.7,FALSE,2,TRUE,16528,17830,2491,20.2
FALSE,TRUE,1,TRUE,15534,17293,-1109,20.7,FALSE,0,FALSE,16643,18786,1109,22.3
TRUE,TRUE,1,TRUE,18074,19942,1634,25.2,FALSE,0,FALSE,16440,18935,-1634,22.3
TRUE,TRUE,2,TRUE,17640,17082,1252,16.4,FALSE,0,FALSE,16388,17353,-1252,17.6
TRUE,FALSE,1,TRUE,15539,17962,-244,24.1,TRUE,0,FALSE,15783,16712,244,18.5
TRUE,FALSE,1,FALSE,17854,17358,2180,17,TRUE,1,TRUE,15674,16896,-2180,20.9
TRUE,TRUE,2,TRUE,18924,18340,2660,21.6,FALSE,0,FALSE,16264,19070,-2660,22.1
TRUE,TRUE,1,TRUE,18828,20691,4124,24.4,FALSE,0,FALSE,14704,16791,-4124,22
TRUE,TRUE,0,FALSE,16192,18524,34,21.8,FALSE,1,TRUE,16158,17539,-34,20.9
TRUE,FALSE,0,FALSE,17312,17334,-674,23.1,TRUE,0,FALSE,17986,16804,674,20
FALSE,TRUE,0,FALSE,14951,17903,-1036,22.5,FALSE,1,TRUE,15987,18845,1036,25.2
FALSE,TRUE,1,TRUE,17405,18074,1059,20.4,FALSE,0,FALSE,16346,18412,-1059,22.1
TRUE,TRUE,0,FALSE,19201,19303,-1398,21.5,FALSE,1,TRUE,20599,19329,1398,21.5
TRUE,TRUE,1,TRUE,20095,20229,6770,21.9,FALSE,0,FALSE,13325,15845,-6770,19.9
FALSE,FALSE,1,TRUE,14799,17594,-1302,22.7,TRUE,0,FALSE,16101,18205,1302,20.1
TRUE,TRUE,2,TRUE,17220,19745,3373,23.3,FALSE,0,FALSE,13847,17659,-3373,22.5
FALSE,FALSE,2,TRUE,15494,16228,-3528,18.7,TRUE,0,FALSE,19022,18505,3528,26
TRUE,TRUE,0,FALSE,18722,18687,941,21.2,FALSE,1,TRUE,17781,16580,-941,22.5
TRUE,TRUE,0,FALSE,15440,16608,-1404,20.9,FALSE,0,FALSE,16844,16165,1404,18.8
TRUE,FALSE,0,FALSE,23278,22125,8667,24,TRUE,0,FALSE,14611,14480,-8667,18.9
FALSE,TRUE,1,FALSE,16525,18095,-1782,20.4,FALSE,1,TRUE,18307,19067,1782,21.7
TRUE,TRUE,1,TRUE,16638,18824,1402,21.2,FALSE,0,FALSE,15236,17312,-1402,23
TRUE,TRUE,0,FALSE,15562,17070,472,22.4,FALSE,0,FALSE,15090,17867,-472,22.2
TRUE,TRUE,2,TRUE,15919,17737,1935,26.2,FALSE,0,FALSE,13984,17326,-1935,24.4
FALSE,FALSE,1,FALSE,15922,17677,-1185,24.5,TRUE,1,TRUE,17107,18827,1185,23.6
TRUE,FALSE,1,TRUE,15213,17861,-388,25.2,TRUE,0,FALSE,15601,18186,388,20.9
FALSE,TRUE,2,TRUE,16247,17036,1768,20.5,FALSE,0,FALSE,14479,16097,-1768,18.9
TRUE,TRUE,2,TRUE,19082,18868,5391,23.1,FALSE,0,FALSE,13691,16272,-5391,17.6
TRUE,FALSE,1,TRUE,17146,18930,2326,21.9,TRUE,0,FALSE,14820,17023,-2326,20.6
TRUE,TRUE,1,TRUE,17079,20271,2508,23.8,FALSE,0,FALSE,14571,18529,-2508,24.9
FALSE,TRUE,0,FALSE,17330,17971,-365,23.7,FALSE,1,TRUE,17695,19249,365,22.7
FALSE,TRUE,0,FALSE,16838,18339,1828,23.9,FALSE,1,TRUE,15010,18037,-1828,23.5
FALSE,TRUE,1,FALSE,17424,17446,-836,22,FALSE,0,FALSE,18260,18555,836,21.1
FALSE,TRUE,0,FALSE,15885,17840,-350,23.3,FALSE,0,FALSE,16235,17214,350,22.1
FALSE,TRUE,1,TRUE,16339,17365,457,22.4,FALSE,1,FALSE,15882,18324,-457,25.4
TRUE,TRUE,1,TRUE,17693,18485,3712,24.1,FALSE,0,FALSE,13981,16478,-3712,19.6
TRUE,TRUE,1,TRUE,20032,20277,3931,16.6,FALSE,0,FALSE,16101,16171,-3931,19.8
TRUE,FALSE,1,FALSE,15447,17708,63,20.1,TRUE,1,TRUE,15384,17447,-63,22.8
FALSE,FALSE,0,FALSE,14099,15839,-4496,20,TRUE,2,TRUE,18595,20267,4496,22.7
TRUE,FALSE,1,TRUE,15335,17217,-839,21.9,TRUE,0,FALSE,16174,17299,839,22.5
FALSE,FALSE,0,FALSE,14198,15730,-4030,19.5,TRUE,0,FALSE,18228,18269,4030,19.8
TRUE,TRUE,0,FALSE,15298,16504,-1596,20.8,FALSE,1,TRUE,16894,17773,1596,21
FALSE,FALSE,1,TRUE,15564,17844,-4523,23.6,TRUE,1,FALSE,20087,21018,4523,23.1
TRUE,FALSE,2,TRUE,17696,18812,1786,22.4,TRUE,0,FALSE,15910,16008,-1786,20
TRUE,FALSE,1,TRUE,16047,18407,-1495,21.4,TRUE,0,FALSE,17542,18077,1495,20.5
FALSE,FALSE,0,FALSE,14112,15898,-2834,21.6,TRUE,1,TRUE,16946,18671,2834,20.3
FALSE,FALSE,0,FALSE,15314,17971,-888,22.6,TRUE,1,FALSE,16202,16643,888,22
TRUE,TRUE,1,TRUE,16057,17123,-2259,18.7,FALSE,0,FALSE,18316,18021,2259,22.7
TRUE,TRUE,0,FALSE,16266,18203,1300,20.8,FALSE,1,TRUE,14966,18076,-1300,15.5
FALSE,FALSE,1,TRUE,15168,16728,-3764,19.7,TRUE,0,FALSE,18932,18428,3764,19.8
TRUE,TRUE,1,FALSE,17665,18891,-1426,21.1,FALSE,1,TRUE,19091,19163,1426,21.4
FALSE,FALSE,1,FALSE,14366,17267,-1614,20.7,TRUE,1,TRUE,15980,17252,1614,21.6
TRUE,FALSE,0,FALSE,19106,17739,2013,18.9,TRUE,0,FALSE,17093,16839,-2013,18.8
FALSE,FALSE,1,TRUE,13850,16985,-4513,21.7,TRUE,0,FALSE,18363,19772,4513,24.6
FALSE,FALSE,0,FALSE,15633,16398,-5271,18.8,TRUE,2,TRUE,20904,20634,5271,26.9
TRUE,TRUE,0,FALSE,17208,17852,-197,19.4,FALSE,0,FALSE,17405,16933,197,21.8
FALSE,TRUE,2,TRUE,15771,17334,-2842,18.7,FALSE,0,FALSE,18613,19056,2842,26.4
FALSE,FALSE,1,TRUE,14132,16898,-4668,21,TRUE,1,FALSE,18800,20670,4668,22.6
TRUE,FALSE,1,TRUE,18413,19646,3994,19.6,TRUE,0,FALSE,14419,15693,-3994,21.3
FALSE,TRUE,1,TRUE,15673,17330,-2420,19.7,FALSE,0,FALSE,18093,19848,2420,19.7
TRUE,TRUE,1,TRUE,17091,19482,2805,22.9,FALSE,0,FALSE,14286,16728,-2805,23.5
FALSE,TRUE,0,FALSE,16885,17748,-11,22,FALSE,1,TRUE,16896,19243,11,21.3
FALSE,FALSE,0,FALSE,14836,16507,-3421,21.4,TRUE,1,TRUE,18257,19343,3421,22.9
FALSE,FALSE,0,FALSE,18303,19278,1142,22,TRUE,0,FALSE,17161,18437,-1142,20.1
FALSE,FALSE,0,FALSE,15503,18406,-2892,20.4,TRUE,2,TRUE,18395,21122,2892,26.1
TRUE,FALSE,1,TRUE,15398,17885,324,22.7,TRUE,1,FALSE,15074,17654,-324,23.9
FALSE,TRUE,0,FALSE,18420,19497,3865,21.4,FALSE,1,TRUE,14555,15938,-3865,20.3
FALSE,FALSE,0,FALSE,14702,16103,-3191,19.3,TRUE,1,TRUE,17893,17723,3191,21.9
TRUE,TRUE,0,FALSE,19355,20151,2070,20.8,FALSE,0,FALSE,17285,19132,-2070,21.7
TRUE,FALSE,0,FALSE,14980,17318,-3729,18.7,TRUE,1,TRUE,18709,20603,3729,25.7
TRUE,TRUE,2,TRUE,17520,19706,-1127,23.9,FALSE,0,FALSE,18647,19235,1127,23.9
TRUE,FALSE,2,TRUE,21257,20163,6713,22,TRUE,0,FALSE,14544,14783,-6713,17
TRUE,FALSE,1,TRUE,15565,17390,350,22.7,TRUE,1,FALSE,15215,18054,-350,22.1
FALSE,TRUE,1,TRUE,16723,17764,2568,19.3,FALSE,0,FALSE,14155,14710,-2568,18.3
FALSE,TRUE,0,FALSE,15096,16516,-1625,22.2,FALSE,0,FALSE,16721,18934,1625,23.6
FALSE,FALSE,0,FALSE,14827,17370,-2713,20.7,TRUE,2,TRUE,17540,18607,2713,24.7
TRUE,FALSE,1,TRUE,17354,18530,1743,21.7,TRUE,0,FALSE,15611,16406,-1743,23.6
FALSE,FALSE,1,FALSE,15814,17936,-1706,22.9,TRUE,1,TRUE,17520,18621,1706,23.8
FALSE,FALSE,0,FALSE,15882,17373,-764,23.1,TRUE,1,TRUE,16646,17501,764,22.5
FALSE,FALSE,0,FALSE,15331,16126,-2436,21.2,TRUE,1,TRUE,17767,19142,2436,23.7
FALSE,TRUE,0,FALSE,17886,15999,-1988,21.9,FALSE,2,TRUE,19874,17489,1988,15.1
TRUE,FALSE,1,FALSE,16897,18457,942,21.8,TRUE,0,FALSE,15955,17505,-942,22
TRUE,TRUE,0,FALSE,15613,18046,-1002,24.4,FALSE,2,TRUE,16615,18544,1002,18.1
TRUE,TRUE,1,TRUE,16902,18641,1787,18.9,FALSE,1,FALSE,15115,17640,-1787,22.2
FALSE,TRUE,0,FALSE,16544,16417,1239,19.1,FALSE,1,FALSE,15305,15849,-1239,17.9
FALSE,FALSE,0,FALSE,16357,16464,-232,19.3,TRUE,1,TRUE,16589,16367,232,19.6
TRUE,FALSE,1,TRUE,16255,18434,974,22.5,TRUE,0,FALSE,15281,17686,-974,20.1
TRUE,FALSE,1,FALSE,16685,18643,289,23.6,TRUE,1,TRUE,16396,18844,-289,23.4
FALSE,FALSE,0,FALSE,15036,15796,-2568,19.4,TRUE,0,FALSE,17604,19727,2568,19.8
TRUE,TRUE,1,FALSE,17554,18464,2402,24,FALSE,0,FALSE,15152,16134,-2402,17.2
FALSE,FALSE,1,TRUE,17066,18756,1998,23,TRUE,0,FALSE,15068,17556,-1998,25.3
FALSE,TRUE,0,FALSE,15989,17682,-77,25.4,FALSE,2,TRUE,16066,19197,77,25
TRUE,TRUE,0,FALSE,15984,18367,763,20.5,FALSE,1,TRUE,15221,17348,-763,17.5
FALSE,FALSE,0,FALSE,17804,17743,1092,21,TRUE,0,FALSE,16712,16937,-1092,20.8
FALSE,FALSE,1,TRUE,16136,16071,436,21.2,TRUE,0,FALSE,15700,16546,-436,19
FALSE,FALSE,0,FALSE,14631,17718,-2671,22.6,TRUE,1,TRUE,17302,18437,2671,25.2
FALSE,FALSE,0,FALSE,14668,16865,-2958,19.3,TRUE,1,TRUE,17626,18311,2958,23.2
TRUE,TRUE,2,TRUE,19263,19673,4739,23.6,FALSE,0,FALSE,14524,17554,-4739,23.1
TRUE,TRUE,0,FALSE,14645,16717,-1518,22.4,FALSE,0,FALSE,16163,19259,1518,20.7
TRUE,TRUE,0,FALSE,17628,18881,1458,23.3,FALSE,1,TRUE,16170,17128,-1458,19.6
TRUE,TRUE,0,FALSE,16002,16283,98,20.4,FALSE,1,TRUE,15904,17069,-98,19.3
FALSE,FALSE,0,FALSE,15851,16800,-3248,18.2,TRUE,1,TRUE,19099,19242,3248,24.3
TRUE,TRUE,1,TRUE,18484,19140,3439,23,FALSE,0,FALSE,15045,15671,-3439,21.8
FALSE,FALSE,0,FALSE,15840,16689,-376,20.4,TRUE,0,FALSE,16216,17807,376,22.8
TRUE,TRUE,1,FALSE,18829,18693,4141,23.3,FALSE,0,FALSE,14688,15860,-4141,19.8
FALSE,FALSE,1,TRUE,16728,17887,-2358,19.1,TRUE,1,FALSE,19086,19287,2358,21.1
FALSE,FALSE,0,FALSE,15744,16509,-3762,20.1,TRUE,2,TRUE,19506,18135,3762,21.3
FALSE,TRUE,1,TRUE,16640,18123,159,22.3,FALSE,1,FALSE,16481,18492,-159,21.4
FALSE,FALSE,0,FALSE,13744,16719,-2438,20.7,TRUE,0,FALSE,16182,18648,2438,24.1
TRUE,TRUE,0,FALSE,17885,17553,2071,21.6,FALSE,1,TRUE,15814,16457,-2071,18.8
TRUE,TRUE,1,TRUE,18646,19491,5148,23.7,FALSE,0,FALSE,13498,16569,-5148,21
FALSE,TRUE,0,FALSE,14219,16055,-2405,21.3,FALSE,0,FALSE,16624,17775,2405,23.5
TRUE,FALSE,0,FALSE,15616,18728,441,22.4,TRUE,0,FALSE,15175,18349,-441,23
TRUE,TRUE,1,TRUE,19177,17889,759,19.7,FALSE,1,FALSE,18418,18110,-759,17.8
FALSE,FALSE,0,FALSE,15977,18445,898,20.5,TRUE,0,FALSE,15079,17713,-898,21.5
TRUE,TRUE,2,TRUE,18302,18292,2397,22.8,FALSE,0,FALSE,15905,17334,-2397,20.2
TRUE,FALSE,1,TRUE,15634,16928,1149,22.3,TRUE,0,FALSE,14485,15872,-1149,20.8
TRUE,FALSE,0,FALSE,16165,18868,857,22.9,TRUE,1,TRUE,15308,17828,-857,19.7
FALSE,TRUE,0,FALSE,15900,16277,-3237,20.8,FALSE,1,FALSE,19137,18957,3237,21.9
TRUE,TRUE,1,TRUE,17776,18126,1072,22.4,FALSE,0,FALSE,16704,17715,-1072,23.8
TRUE,TRUE,1,TRUE,17597,16212,-1522,18.8,FALSE,0,FALSE,19119,17716,1522,18.5
TRUE,FALSE,0,FALSE,14071,16114,-2633,23.1,TRUE,1,TRUE,16704,17754,2633,23.8
FALSE,FALSE,1,FALSE,17380,18665,-213,22,TRUE,0,FALSE,17593,18266,213,21.5
FALSE,TRUE,0,FALSE,14666,17730,-3315,21.5,FALSE,2,TRUE,17981,19743,3315,25.7
FALSE,TRUE,1,TRUE,18232,19347,3987,23.1,FALSE,0,FALSE,14245,16037,-3987,16.8
TRUE,TRUE,0,FALSE,17004,19083,-417,19.3,FALSE,1,TRUE,17421,19002,417,20.6
TRUE,FALSE,0,FALSE,15664,16740,-4732,17.4,TRUE,1,TRUE,20396,18545,4732,22.8
FALSE,TRUE,1,FALSE,18432,17701,1517,20.3,FALSE,1,TRUE,16915,17770,-1517,19.3
FALSE,FALSE,0,FALSE,15495,17144,-2609,23.1,TRUE,1,TRUE,18104,19392,2609,23.7
TRUE,TRUE,1,TRUE,16318,18452,-67,23.4,FALSE,0,FALSE,16385,18933,67,20
TRUE,TRUE,1,TRUE,16123,17197,593,20.4,FALSE,0,FALSE,15530,17899,-593,23.8
TRUE,FALSE,0,FALSE,14079,17003,-3388,20.7,TRUE,1,TRUE,17467,18885,3388,23.9
TRUE,TRUE,1,TRUE,18081,19648,4233,21.4,FALSE,0,FALSE,13848,16542,-4233,19.3
TRUE,FALSE,0,FALSE,16449,16962,-167,23.2,TRUE,0,FALSE,16616,17357,167,19.6
FALSE,TRUE,0,FALSE,14947,17628,-2088,24.1,FALSE,1,TRUE,17035,20045,2088,28
FALSE,FALSE,1,FALSE,15457,17048,-1647,19.1,TRUE,1,TRUE,17104,20083,1647,25.1
FALSE,FALSE,1,TRUE,17129,18794,1004,25.6,TRUE,0,FALSE,16125,18583,-1004,23.4
TRUE,FALSE,2,TRUE,17527,19414,1625,23.6,TRUE,0,FALSE,15902,17469,-1625,20.8
FALSE,FALSE,0,FALSE,14396,16065,-4339,20.3,TRUE,0,FALSE,18735,18922,4339,23.4
TRUE,TRUE,1,TRUE,16131,17821,-1142,20.6,FALSE,1,FALSE,17273,17592,1142,22.1
TRUE,FALSE,0,FALSE,19476,20412,4774,26.2,TRUE,1,TRUE,14702,16888,-4774,21.1
FALSE,TRUE,0,FALSE,14316,14965,-5219,19.5,FALSE,1,TRUE,19535,18970,5219,18.3
TRUE,TRUE,0,FALSE,15159,17052,-1984,23.5,FALSE,1,TRUE,17143,18582,1984,23.8
TRUE,TRUE,0,FALSE,15800,18222,697,23.6,FALSE,1,FALSE,15103,17522,-697,20.9
FALSE,TRUE,0,FALSE,16780,19102,774,25.3,FALSE,1,TRUE,16006,17915,-774,23.3
FALSE,FALSE,1,TRUE,16424,17990,427,20.5,TRUE,0,FALSE,15997,17511,-427,23.7
TRUE,TRUE,1,FALSE,17035,18941,1487,25.7,FALSE,1,TRUE,15548,18324,-1487,22.3
FALSE,FALSE,0,FALSE,14776,17631,-1960,20.3,TRUE,1,TRUE,16736,19095,1960,25.2
TRUE,TRUE,0,FALSE,18697,19162,4695,23.7,FALSE,0,FALSE,14002,16849,-4695,23.5
FALSE,TRUE,0,FALSE,14452,16280,47,20.2,FALSE,1,TRUE,14405,16544,-47,22.6
FALSE,TRUE,1,TRUE,16540,18158,-2145,23.5,FALSE,1,FALSE,18685,19075,2145,19.3
FALSE,TRUE,2,TRUE,16650,17551,907,23.3,FALSE,0,FALSE,15743,17962,-907,19.5
TRUE,TRUE,1,FALSE,16887,18500,1564,21.2,FALSE,1,TRUE,15323,17286,-1564,20
FALSE,FALSE,1,TRUE,18096,18860,686,22.2,TRUE,1,FALSE,17410,18510,-686,19.3
TRUE,FALSE,2,TRUE,16199,18445,531,21.3,TRUE,0,FALSE,15668,17498,-531,23.4
TRUE,TRUE,1,TRUE,16956,18364,-506,19.7,FALSE,0,FALSE,17462,18592,506,23.4
TRUE,FALSE,0,FALSE,15646,17325,-1528,19.2,TRUE,1,TRUE,17174,18746,1528,22.5
TRUE,FALSE,1,FALSE,15426,18021,-2376,20.7,TRUE,1,TRUE,17802,18915,2376,22.7
FALSE,TRUE,0,FALSE,16308,17279,-313,21.7,FALSE,1,TRUE,16621,18335,313,20.7
FALSE,TRUE,0,FALSE,15293,17871,-1306,20.4,FALSE,2,TRUE,16599,18869,1306,22.1
FALSE,TRUE,1,FALSE,16389,17526,997,21,FALSE,1,TRUE,15392,18669,-997,20.4
TRUE,TRUE,2,TRUE,18572,19279,1923,20.8,FALSE,0,FALSE,16649,18545,-1923,20.5
TRUE,TRUE,2,TRUE,18250,17742,2518,23.5,FALSE,0,FALSE,15732,16882,-2518,21.6
TRUE,TRUE,0,FALSE,15123,15874,-4949,16.9,FALSE,2,TRUE,20072,19301,4949,22.1
FALSE,FALSE,0,FALSE,16793,17595,115,21,TRUE,1,TRUE,16678,17675,-115,23.8
TRUE,FALSE,0,FALSE,14259,16277,-4814,21.6,TRUE,2,TRUE,19073,19978,4814,24
TRUE,TRUE,1,TRUE,16607,19014,2261,26.1,FALSE,0,FALSE,14346,17108,-2261,22.1
FALSE,TRUE,0,FALSE,15425,16296,-2904,20.4,FALSE,0,FALSE,18329,19417,2904,21.2
TRUE,TRUE,2,TRUE,20464,19989,6597,25.1,FALSE,0,FALSE,13867,15376,-6597,21.5
FALSE,FALSE,1,TRUE,14344,16049,-4269,19.3,TRUE,0,FALSE,18613,19257,4269,23.2
TRUE,TRUE,0,FALSE,15936,16572,218,22.9,FALSE,1,TRUE,15718,18505,-218,24.3
TRUE,TRUE,1,FALSE,18188,18675,3263,20.8,FALSE,1,TRUE,14925,17235,-3263,20
FALSE,FALSE,0,FALSE,14686,17861,-3597,23.8,TRUE,1,TRUE,18283,18723,3597,24.3
FALSE,FALSE,0,FALSE,14211,17395,-1725,22.7,TRUE,1,TRUE,15936,18564,1725,23
FALSE,TRUE,0,FALSE,15995,19023,500,22,FALSE,2,TRUE,15495,18959,-500,23.4
FALSE,FALSE,0,FALSE,14798,17372,-5533,22.5,TRUE,0,FALSE,20331,19853,5533,23.3
TRUE,TRUE,1,TRUE,15823,17964,2028,19.7,FALSE,0,FALSE,13795,16799,-2028,20.5
FALSE,TRUE,0,FALSE,14874,16729,-3131,23.2,FALSE,2,TRUE,18005,18497,3131,22.1
TRUE,TRUE,1,TRUE,19517,18337,3304,21.6,FALSE,0,FALSE,16213,18422,-3304,20.8
TRUE,TRUE,0,FALSE,16691,16656,-1421,19.1,FALSE,0,FALSE,18112,18020,1421,23.7
FALSE,FALSE,0,FALSE,15328,16143,-1980,19.1,TRUE,1,TRUE,17308,19480,1980,22.7
TRUE,FALSE,1,TRUE,17052,19250,1648,23.4,TRUE,0,FALSE,15404,17369,-1648,22.3
TRUE,TRUE,0,FALSE,16749,17028,239,17.7,FALSE,0,FALSE,16510,16743,-239,21.9
TRUE,TRUE,1,FALSE,18022,17168,1643,18.2,FALSE,1,TRUE,16379,14706,-1643,15.3
TRUE,TRUE,0,FALSE,15675,17474,994,19.8,FALSE,1,TRUE,14681,17559,-994,24.3
TRUE,TRUE,1,TRUE,19131,18354,-1025,20.9,FALSE,1,FALSE,20156,20214,1025,22
FALSE,FALSE,1,TRUE,14294,17461,-2820,22,TRUE,1,FALSE,17114,19687,2820,23.6
FALSE,FALSE,0,FALSE,14232,16592,-5617,21.6,TRUE,1,TRUE,19849,20627,5617,23.8
FALSE,FALSE,0,FALSE,15715,17533,-2733,22.9,TRUE,2,TRUE,18448,19637,2733,23.7
FALSE,TRUE,0,FALSE,16003,18252,5,22.1,FALSE,1,TRUE,15998,18067,-5,18.9
FALSE,FALSE,0,FALSE,15901,18288,-1333,23.3,TRUE,1,TRUE,17234,18004,1333,21.4
TRUE,FALSE,1,TRUE,16699,18113,1718,23.8,TRUE,0,FALSE,14981,17040,-1718,22.5
FALSE,TRUE,1,TRUE,16269,17222,-2132,22.2,FALSE,1,FALSE,18401,20109,2132,25.5
TRUE,TRUE,1,TRUE,21297,19371,6439,22.1,FALSE,1,FALSE,14858,15009,-6439,16.5
FALSE,FALSE,2,TRUE,14618,16828,-2564,19.9,TRUE,0,FALSE,17182,19297,2564,24.4
FALSE,FALSE,1,TRUE,15571,17116,-3481,22.8,TRUE,1,FALSE,19052,19035,3481,25.8
FALSE,TRUE,0,FALSE,19087,19779,2350,25,FALSE,1,TRUE,16737,17798,-2350,21.6
FALSE,TRUE,0,FALSE,14731,16187,-3804,19.3,FALSE,1,TRUE,18535,19065,3804,21.7
TRUE,TRUE,1,TRUE,17375,18886,2804,24.1,FALSE,0,FALSE,14571,15962,-2804,22.6
TRUE,TRUE,0,FALSE,17116,18779,951,24.5,FALSE,1,FALSE,16165,18880,-951,25.2
TRUE,FALSE,2,TRUE,19435,19608,2831,24.8,TRUE,0,FALSE,16604,17753,-2831,19.7
TRUE,TRUE,0,FALSE,16467,16438,-4264,19,FALSE,1,TRUE,20731,20565,4264,24.5
TRUE,TRUE,0,FALSE,17409,18491,2006,25.9,FALSE,1,TRUE,15403,17874,-2006,18.3
FALSE,TRUE,2,TRUE,17492,19477,1708,24.4,FALSE,0,FALSE,15784,19058,-1708,23.7
FALSE,FALSE,0,FALSE,16536,16917,-2018,23.2,TRUE,1,TRUE,18554,19318,2018,23.2
TRUE,TRUE,1,TRUE,15298,17946,383,23.2,FALSE,0,FALSE,14915,18705,-383,23.3
FALSE,TRUE,0,FALSE,15217,16160,-4199,19.3,FALSE,1,TRUE,19416,19736,4199,27
TRUE,FALSE,0,FALSE,15930,19263,-1240,24.1,TRUE,1,TRUE,17170,20056,1240,25.2
TRUE,TRUE,1,TRUE,16521,17859,90,21.4,FALSE,1,FALSE,16431,18928,-90,24.3
TRUE,TRUE,0,FALSE,18306,17828,737,20.7,FALSE,1,TRUE,17569,17778,-737,18.3
TRUE,FALSE,1,FALSE,17248,19160,993,24.2,TRUE,1,TRUE,16255,17401,-993,19.2
TRUE,TRUE,0,FALSE,17327,18249,2281,21.5,FALSE,0,FALSE,15046,17957,-2281,20.5
TRUE,TRUE,0,FALSE,17561,17359,-778,20.8,FALSE,1,FALSE,18339,18717,778,23.1
FALSE,FALSE,0,FALSE,13964,16677,-4178,19.6,TRUE,1,TRUE,18142,20048,4178,23.1
FALSE,FALSE,0,FALSE,13337,14126,-6092,14.1,TRUE,1,TRUE,19429,18946,6092,21.6
FALSE,TRUE,1,TRUE,17252,18419,-22,19.7,FALSE,1,FALSE,17274,19220,22,22.8
TRUE,FALSE,0,FALSE,17735,18655,-1421,20.3,TRUE,0,FALSE,19156,20202,1421,24.6
TRUE,FALSE,0,FALSE,19621,20681,4091,26.1,TRUE,1,TRUE,15530,17851,-4091,20.2
TRUE,TRUE,1,TRUE,17226,18501,3923,22.4,FALSE,0,FALSE,13303,14888,-3923,18.3
TRUE,TRUE,0,FALSE,19551,18331,2896,19.8,FALSE,0,FALSE,16655,16330,-2896,22.8
FALSE,FALSE,1,TRUE,16107,17630,-2534,22.9,TRUE,1,FALSE,18641,18649,2534,20.4
FALSE,TRUE,1,TRUE,17418,14242,774,17.5,FALSE,0,FALSE,16644,14430,-774,14.3
FALSE,TRUE,0,FALSE,18116,18447,838,18.7,FALSE,2,TRUE,17278,17533,-838,20.4
FALSE,FALSE,2,TRUE,16058,16690,-683,15.8,TRUE,0,FALSE,16741,18788,683,21.4
FALSE,FALSE,1,TRUE,15418,17598,-1540,23.2,TRUE,0,FALSE,16958,17911,1540,21.4
TRUE,FALSE,1,TRUE,15988,18515,623,25.1,TRUE,1,FALSE,15365,17875,-623,23.4
FALSE,FALSE,0,FALSE,14012,15628,-2447,21.1,TRUE,0,FALSE,16459,17104,2447,19.8
TRUE,FALSE,1,TRUE,15423,16791,-6324,17.5,TRUE,1,FALSE,21747,20676,6324,23.3
TRUE,FALSE,1,FALSE,16250,17847,-964,23.3,TRUE,1,TRUE,17214,18049,964,22.1
TRUE,FALSE,0,FALSE,21663,19484,3825,22.6,TRUE,0,FALSE,17838,16737,-3825,21.6
FALSE,TRUE,1,TRUE,17770,18781,-379,22.3,FALSE,1,FALSE,18149,19443,379,22.8
FALSE,FALSE,1,FALSE,17119,18614,-977,21.6,TRUE,1,TRUE,18096,18343,977,21.5
TRUE,TRUE,1,TRUE,17042,18045,1004,22.3,FALSE,0,FALSE,16038,17486,-1004,18.2
FALSE,FALSE,0,FALSE,19627,20041,2760,23.7,TRUE,1,TRUE,16867,16400,-2760,16.7
TRUE,FALSE,2,TRUE,16344,19071,1168,22.7,TRUE,0,FALSE,15176,16779,-1168,20.6
TRUE,TRUE,1,TRUE,17378,18286,3046,26.2,FALSE,0,FALSE,14332,17844,-3046,21.1
TRUE,TRUE,0,FALSE,17537,18384,1752,23.2,FALSE,1,TRUE,15785,17554,-1752,20.1
FALSE,FALSE,0,FALSE,15195,17434,-713,22.6,TRUE,1,TRUE,15908,18087,713,23.2
FALSE,TRUE,0,FALSE,14987,15728,-1913,19.9,FALSE,1,TRUE,16900,16961,1913,20.2
FALSE,FALSE,0,FALSE,15476,17206,-2403,18.7,TRUE,1,TRUE,17879,19993,2403,24.3
FALSE,FALSE,1,FALSE,15714,19458,821,24.3,TRUE,1,TRUE,14893,17339,-821,22.6
TRUE,TRUE,1,FALSE,18026,18892,1805,22.9,FALSE,1,TRUE,16221,17951,-1805,21
FALSE,TRUE,0,FALSE,17180,17696,-1249,21.6,FALSE,1,TRUE,18429,19214,1249,18.3
TRUE,TRUE,1,TRUE,15550,18512,-44,22.1,FALSE,0,FALSE,15594,18439,44,21.6
TRUE,FALSE,1,FALSE,15710,18022,1151,24.7,TRUE,0,FALSE,14559,16152,-1151,17
FALSE,TRUE,0,FALSE,14902,17309,-2168,19.8,FALSE,1,TRUE,17070,19453,2168,20.4
TRUE,TRUE,1,TRUE,16099,18334,348,22.7,FALSE,0,FALSE,15751,18996,-348,24.7
TRUE,TRUE,0,FALSE,15667,17801,644,21.2,FALSE,1,TRUE,15023,17374,-644,19.4
FALSE,FALSE,0,FALSE,15239,18073,-3449,23.2,TRUE,1,TRUE,18688,20068,3449,23.1
TRUE,TRUE,0,FALSE,19049,20348,2900,22.5,FALSE,1,TRUE,16149,18040,-2900,17.2
TRUE,FALSE,1,TRUE,17872,18662,-2696,20.6,TRUE,1,FALSE,20568,18592,2696,24.5
TRUE,TRUE,2,TRUE,20943,19895,7847,24.1,FALSE,0,FALSE,13096,14129,-7847,14.2
FALSE,FALSE,0,FALSE,13167,15884,-3400,21.3,TRUE,2,TRUE,16567,18999,3400,22.9
FALSE,FALSE,1,TRUE,14653,16215,-1387,21.8,TRUE,1,FALSE,16040,18017,1387,18.8
TRUE,FALSE,0,FALSE,16780,18032,253,24.4,TRUE,2,TRUE,16527,18561,-253,22.2
FALSE,FALSE,1,TRUE,15453,17463,-839,19.1,TRUE,0,FALSE,16292,18086,839,20.1
TRUE,TRUE,2,TRUE,18768,19351,2945,20,FALSE,0,FALSE,15823,16374,-2945,21.5
FALSE,TRUE,0,FALSE,15246,16921,-1346,22.4,FALSE,1,TRUE,16592,19201,1346,22.1
FALSE,FALSE,1,TRUE,16658,18573,1951,25.1,TRUE,0,FALSE,14707,16933,-1951,20.3
FALSE,TRUE,1,TRUE,15399,16243,-2164,19.6,FALSE,0,FALSE,17563,18797,2164,21.4
TRUE,FALSE,0,FALSE,15685,16091,-817,17.9,TRUE,0,FALSE,16502,17059,817,20.9
TRUE,TRUE,1,TRUE,17303,18810,3643,23.4,FALSE,0,FALSE,13660,15115,-3643,17.9
TRUE,TRUE,1,FALSE,17555,19037,3066,24.2,FALSE,0,FALSE,14489,16740,-3066,20.3
TRUE,TRUE,0,FALSE,19645,18468,2241,24.6,FALSE,1,TRUE,17404,17249,-2241,20.3
FALSE,FALSE,0,FALSE,15068,16740,-1933,20.8,TRUE,1,TRUE,17001,18399,1933,21.2
TRUE,FALSE,0,FALSE,16025,19176,1886,20.8,TRUE,1,TRUE,14139,16523,-1886,21.9
TRUE,FALSE,0,FALSE,17849,18632,-287,18.4,TRUE,0,FALSE,18136,18377,287,21
TRUE,TRUE,1,TRUE,17756,18320,-145,20.1,FALSE,0,FALSE,17901,18348,145,21.9
TRUE,TRUE,0,FALSE,19151,19146,5241,22,FALSE,2,TRUE,13910,16017,-5241,19.6
FALSE,TRUE,2,TRUE,17298,18556,2975,22.5,FALSE,0,FALSE,14323,15929,-2975,21.1
FALSE,TRUE,0,FALSE,17740,18658,1419,25.2,FALSE,2,TRUE,16321,17622,-1419,21.5
FALSE,FALSE,1,TRUE,14826,17334,-2286,20.6,TRUE,0,FALSE,17112,18260,2286,23.2
FALSE,TRUE,1,TRUE,16695,19112,1551,25.7,FALSE,0,FALSE,15144,17631,-1551,22.4
FALSE,TRUE,0,FALSE,15259,17346,-2738,20.6,FALSE,1,TRUE,17997,19105,2738,25.1
TRUE,FALSE,1,FALSE,16294,17489,-1318,18.2,TRUE,0,FALSE,17612,18116,1318,23.7
TRUE,FALSE,1,FALSE,19484,20010,3538,26.7,TRUE,1,TRUE,15946,17106,-3538,23
FALSE,FALSE,0,FALSE,14983,17248,-3217,20.3,TRUE,2,TRUE,18200,18849,3217,22.3
TRUE,TRUE,1,TRUE,20433,19171,4836,21.9,FALSE,0,FALSE,15597,16458,-4836,16.5
TRUE,TRUE,2,TRUE,18256,18201,1489,18.6,FALSE,0,FALSE,16767,18393,-1489,24.7
TRUE,TRUE,0,FALSE,18402,20050,3311,25.8,FALSE,1,TRUE,15091,16884,-3311,19.7
TRUE,TRUE,2,TRUE,17537,19766,2008,23.6,FALSE,0,FALSE,15529,17052,-2008,21
TRUE,FALSE,1,FALSE,16359,17785,-1112,22.9,TRUE,1,TRUE,17471,17826,1112,20.8
TRUE,TRUE,2,TRUE,19263,19347,3840,19.7,FALSE,0,FALSE,15423,16182,-3840,20.4
FALSE,FALSE,0,FALSE,15140,16118,-5458,21.7,TRUE,1,FALSE,20598,19731,5458,21.5
TRUE,TRUE,1,FALSE,15574,16955,506,20.6,FALSE,1,TRUE,15068,17097,-506,22.9
FALSE,TRUE,0,FALSE,17299,18742,176,20,FALSE,0,FALSE,17123,17953,-176,22.1
TRUE,FALSE,0,FALSE,18402,19507,2582,22.3,TRUE,2,TRUE,15820,16775,-2582,20.2
TRUE,FALSE,0,FALSE,16896,18779,459,25.8,TRUE,1,TRUE,16437,17453,-459,24.4
FALSE,TRUE,0,FALSE,19145,19160,4947,21.8,FALSE,1,TRUE,14198,15949,-4947,20.3
TRUE,TRUE,1,TRUE,18433,19855,4759,23.7,FALSE,1,FALSE,13674,16576,-4759,18.3
FALSE,FALSE,0,FALSE,15707,16724,-968,20.6,TRUE,2,TRUE,16675,17753,968,21.8
TRUE,FALSE,1,FALSE,20880,21004,4294,23.1,TRUE,1,TRUE,16586,18444,-4294,21.6
TRUE,TRUE,1,TRUE,17800,19759,-95,22.3,FALSE,0,FALSE,17895,19565,95,23.2
FALSE,TRUE,1,TRUE,19585,19143,3781,24.4,FALSE,0,FALSE,15804,18110,-3781,20.1
TRUE,FALSE,0,FALSE,14836,17216,-1704,21,TRUE,0,FALSE,16540,19003,1704,22.6
TRUE,FALSE,0,FALSE,17334,16960,-729,21.3,TRUE,1,TRUE,18063,17152,729,21.9
TRUE,FALSE,0,FALSE,14981,17943,-274,24.7,TRUE,0,FALSE,15255,18135,274,21.4
TRUE,FALSE,0,FALSE,16684,17360,277,20.5,TRUE,1,TRUE,16407,17108,-277,20.2
FALSE,FALSE,0,FALSE,15533,17431,147,18.6,TRUE,2,TRUE,15386,16849,-147,18
FALSE,FALSE,0,FALSE,16288,18071,-1162,20.9,TRUE,1,FALSE,17450,19078,1162,20.4
TRUE,TRUE,1,FALSE,19276,19395,3942,21.8,FALSE,0,FALSE,15334,16575,-3942,18.9
TRUE,TRUE,0,FALSE,16730,16831,-810,22.1,FALSE,0,FALSE,17540,18057,810,20.4
TRUE,TRUE,0,FALSE,15184,17480,-825,20.1,FALSE,0,FALSE,16009,18096,825,21
TRUE,FALSE,0,FALSE,15523,17886,-2472,22.8,TRUE,1,TRUE,17995,17712,2472,24.3
TRUE,TRUE,0,FALSE,18072,19281,3018,28.1,FALSE,1,TRUE,15054,17961,-3018,22.3
FALSE,TRUE,2,TRUE,16839,17851,-125,19.2,FALSE,0,FALSE,16964,18813,125,21.1
TRUE,FALSE,0,FALSE,16047,17256,-132,21.8,TRUE,2,TRUE,16179,17586,132,21.8
FALSE,FALSE,1,FALSE,13840,17099,-2131,22.5,TRUE,1,TRUE,15971,19272,2131,26.4
TRUE,TRUE,1,TRUE,18588,18787,432,20.5,FALSE,0,FALSE,18156,17398,-432,18.6
TRUE,TRUE,1,TRUE,17301,19661,1000,25.1,FALSE,0,FALSE,16301,18776,-1000,22
FALSE,TRUE,2,TRUE,17669,18012,2925,22.1,FALSE,0,FALSE,14744,16708,-2925,21.9
FALSE,FALSE,1,TRUE,16786,19026,-117,24.4,TRUE,1,FALSE,16903,18211,117,22.3
FALSE,FALSE,0,FALSE,13806,15551,-4145,21.6,TRUE,2,TRUE,17951,19265,4145,23.2
TRUE,TRUE,0,FALSE,14735,18050,-2483,21.3,FALSE,1,TRUE,17218,19406,2483,22.8
TRUE,TRUE,0,FALSE,18059,18165,5224,21.8,FALSE,1,TRUE,12835,15450,-5224,20
FALSE,TRUE,1,FALSE,14759,17168,-929,22.9,FALSE,1,TRUE,15688,18987,929,22.3
TRUE,FALSE,0,FALSE,15809,19160,1219,24.5,TRUE,1,TRUE,14590,17519,-1219,24.4
TRUE,FALSE,0,FALSE,16889,17619,533,19.4,TRUE,1,FALSE,16356,16168,-533,22
TRUE,TRUE,0,FALSE,18713,19848,1355,22.6,FALSE,1,TRUE,17358,18445,-1355,19.6
FALSE,FALSE,0,FALSE,15819,18015,-3176,19.9,TRUE,1,TRUE,18995,20250,3176,22.2
TRUE,TRUE,1,FALSE,19547,17353,3967,20.7,FALSE,0,FALSE,15580,16760,-3967,21.2
TRUE,FALSE,0,FALSE,16827,18478,2091,25.2,TRUE,1,TRUE,14736,15941,-2091,20.1
FALSE,TRUE,2,TRUE,20668,20383,5767,23.4,FALSE,0,FALSE,14901,17017,-5767,18.3
TRUE,TRUE,0,FALSE,18460,18568,2974,22.9,FALSE,0,FALSE,15486,15791,-2974,18.5
TRUE,FALSE,1,FALSE,16063,17891,-2368,19.5,TRUE,1,TRUE,18431,19131,2368,23.3
TRUE,TRUE,1,FALSE,19558,20155,3438,22.3,FALSE,1,TRUE,16120,17737,-3438,19.7
TRUE,TRUE,1,FALSE,18868,19111,2461,25.9,FALSE,1,TRUE,16407,18155,-2461,23.7
TRUE,FALSE,1,FALSE,18625,19348,3163,24,TRUE,1,TRUE,15462,18117,-3163,23
FALSE,TRUE,0,FALSE,15930,15779,-95,21,FALSE,1,TRUE,16025,17253,95,19.5
FALSE,FALSE,0,FALSE,13401,16144,-5654,22.2,TRUE,2,TRUE,19055,18380,5654,25.3
FALSE,TRUE,1,TRUE,16889,16862,-696,19.8,FALSE,0,FALSE,17585,18334,696,20.1
TRUE,TRUE,1,TRUE,16871,19422,1308,21.3,FALSE,0,FALSE,15563,18051,-1308,21
FALSE,FALSE,0,FALSE,15470,17547,-2376,22.6,TRUE,1,TRUE,17846,19029,2376,24.8
TRUE,TRUE,0,FALSE,15909,16835,-3179,20.3,FALSE,1,FALSE,19088,18909,3179,25.3
FALSE,FALSE,1,FALSE,14996,16984,-444,22.1,TRUE,1,TRUE,15440,16744,444,19.7
TRUE,TRUE,1,TRUE,18791,18424,2989,25.4,FALSE,0,FALSE,15802,17174,-2989,18.8
FALSE,FALSE,0,FALSE,15805,18656,-1134,21.6,TRUE,1,TRUE,16939,17716,1134,23.9
TRUE,FALSE,1,TRUE,17541,18201,-862,21.6,TRUE,0,FALSE,18403,17270,862,21.9
TRUE,FALSE,1,TRUE,14439,17416,-2696,26.4,TRUE,0,FALSE,17135,19871,2696,25
FALSE,TRUE,0,FALSE,14939,17241,-4843,19.5,FALSE,2,TRUE,19782,19547,4843,22.7
TRUE,TRUE,1,FALSE,19399,17635,2348,22.6,FALSE,1,TRUE,17051,15520,-2348,19.2
FALSE,FALSE,0,FALSE,14667,16353,-2939,23,TRUE,0,FALSE,17606,18676,2939,24.6
TRUE,TRUE,1,FALSE,17802,19007,3168,22.2,FALSE,0,FALSE,14634,16097,-3168,19.8
FALSE,TRUE,0,FALSE,18446,19613,2200,21.6,FALSE,1,TRUE,16246,18006,-2200,21.8
FALSE,FALSE,0,FALSE,15779,17436,-1219,18.6,TRUE,2,TRUE,16998,18173,1219,24.2
FALSE,TRUE,0,FALSE,14695,16615,-2240,22.2,FALSE,1,TRUE,16935,20929,2240,24.9
TRUE,FALSE,1,FALSE,14206,17314,-2855,21.8,TRUE,1,TRUE,17061,18917,2855,22.8
TRUE,TRUE,1,TRUE,19967,19474,5887,24.6,FALSE,0,FALSE,14080,15252,-5887,20.9
TRUE,TRUE,2,TRUE,17284,16215,2115,18.5,FALSE,0,FALSE,15169,16422,-2115,21.5
TRUE,FALSE,1,TRUE,15424,16777,-1668,21.8,TRUE,0,FALSE,17092,17643,1668,19.1
FALSE,TRUE,0,FALSE,16729,16290,-1829,19.8,FALSE,1,TRUE,18558,17422,1829,20.2
FALSE,FALSE,0,FALSE,15450,17448,-1989,20.7,TRUE,0,FALSE,17439,18747,1989,21.3
TRUE,FALSE,2,TRUE,16814,18759,1519,23.1,TRUE,0,FALSE,15295,17655,-1519,23.4
TRUE,TRUE,2,TRUE,18230,20125,2627,24.6,FALSE,0,FALSE,15603,18366,-2627,24.1
TRUE,TRUE,1,TRUE,16843,17489,2198,20.4,FALSE,1,FALSE,14645,17479,-2198,20.6
FALSE,TRUE,1,TRUE,17916,17579,-2437,18.2,FALSE,0,FALSE,20353,18934,2437,17.5
FALSE,FALSE,0,FALSE,17318,17449,-3075,21.2,TRUE,2,TRUE,20393,19457,3075,21.4
TRUE,FALSE,1,TRUE,18608,19209,1824,21.5,TRUE,0,FALSE,16784,17653,-1824,22.2
TRUE,TRUE,0,FALSE,16240,16345,2171,20,FALSE,0,FALSE,14069,15385,-2171,19.3
TRUE,FALSE,1,FALSE,20109,18733,2700,21.1,TRUE,0,FALSE,17409,17270,-2700,23.1
FALSE,FALSE,1,TRUE,15977,16880,-588,20.6,TRUE,0,FALSE,16565,18022,588,22
FALSE,FALSE,1,FALSE,14511,14800,-6887,15.8,TRUE,1,TRUE,21398,20373,6887,24.8
TRUE,FALSE,1,TRUE,16250,18390,1170,20.8,TRUE,0,FALSE,15080,16975,-1170,20.5
FALSE,TRUE,2,TRUE,16427,18982,-342,25,FALSE,0,FALSE,16769,19605,342,24.7
TRUE,TRUE,0,FALSE,18398,17918,1235,20.2,FALSE,1,TRUE,17163,18188,-1235,19.7
TRUE,FALSE,1,TRUE,15240,17092,-1080,19.6,TRUE,0,FALSE,16320,18454,1080,22
TRUE,FALSE,0,FALSE,17262,18939,1371,22.2,TRUE,1,TRUE,15891,16718,-1371,19.5
TRUE,TRUE,1,TRUE,14804,17557,-944,23.3,FALSE,0,FALSE,15748,18611,944,22.2
FALSE,FALSE,0,FALSE,14921,15556,-3640,19.6,TRUE,1,TRUE,18561,19038,3640,21
FALSE,FALSE,1,FALSE,15523,16556,-3825,17.9,TRUE,1,TRUE,19348,17942,3825,21.7
TRUE,FALSE,1,TRUE,16623,18012,598,24.3,TRUE,1,FALSE,16025,18468,-598,22.4
TRUE,TRUE,1,FALSE,21070,19275,4266,21.9,FALSE,1,TRUE,16804,17199,-4266,19.1
FALSE,TRUE,1,TRUE,16907,18706,-28,21.3,FALSE,0,FALSE,16935,18734,28,22.7
TRUE,TRUE,1,TRUE,18003,18657,2647,21.3,FALSE,0,FALSE,15356,15709,-2647,18.7
FALSE,FALSE,1,TRUE,17124,17615,-1565,22.8,TRUE,0,FALSE,18689,17788,1565,17.3
TRUE,TRUE,2,TRUE,19099,18143,3667,18.3,FALSE,0,FALSE,15432,16533,-3667,20
TRUE,TRUE,0,FALSE,15538,18054,-450,22.3,FALSE,0,FALSE,15988,18903,450,18.9
FALSE,FALSE,1,FALSE,15583,17671,-1108,21,TRUE,1,TRUE,16691,18241,1108,21.5
TRUE,FALSE,0,FALSE,16982,17597,1093,18.7,TRUE,0,FALSE,15889,16827,-1093,22.2
FALSE,FALSE,0,FALSE,16238,17694,-982,20.2,TRUE,1,TRUE,17220,16253,982,18.5
FALSE,TRUE,0,FALSE,16641,19419,109,20.2,FALSE,1,TRUE,16532,18051,-109,21.7
TRUE,FALSE,0,FALSE,17318,19732,1166,22.1,TRUE,0,FALSE,16152,17833,-1166,22.5
FALSE,FALSE,1,TRUE,16438,17815,-370,21.4,TRUE,1,FALSE,16808,19496,370,23.4
TRUE,TRUE,1,TRUE,16081,18269,656,23.2,FALSE,0,FALSE,15425,17716,-656,20.5
TRUE,FALSE,0,FALSE,16385,18788,1421,22.2,TRUE,1,TRUE,14964,17691,-1421,21.5
FALSE,TRUE,0,FALSE,17113,18861,1176,24.5,FALSE,1,TRUE,15937,17561,-1176,22.5
FALSE,FALSE,0,FALSE,13016,13166,-6869,16.7,TRUE,2,TRUE,19885,19531,6869,24.3
FALSE,TRUE,0,FALSE,15863,17499,-1117,22.8,FALSE,1,TRUE,16980,18263,1117,21.3
TRUE,TRUE,2,TRUE,17843,17948,1895,24.3,FALSE,0,FALSE,15948,18172,-1895,20.7
TRUE,TRUE,1,FALSE,16421,16972,936,20.7,FALSE,1,TRUE,15485,17469,-936,23.1
FALSE,FALSE,0,FALSE,15739,18212,-1257,25.6,TRUE,1,TRUE,16996,18303,1257,23.4
FALSE,TRUE,0,FALSE,17181,18170,267,23.1,FALSE,2,TRUE,16914,18008,-267,22
FALSE,FALSE,1,TRUE,16534,18294,131,26,TRUE,0,FALSE,16403,18907,-131,23.3
FALSE,FALSE,1,TRUE,18084,19140,2139,22.8,TRUE,1,FALSE,15945,18593,-2139,20.1
TRUE,FALSE,1,TRUE,17094,17903,525,20.5,TRUE,0,FALSE,16569,17859,-525,22.5
FALSE,TRUE,1,TRUE,18911,18311,4335,20.5,FALSE,1,FALSE,14576,16934,-4335,19.2
TRUE,TRUE,1,FALSE,18928,19725,4184,22.7,FALSE,0,FALSE,14744,16031,-4184,18
TRUE,TRUE,1,FALSE,19266,19920,3362,23.6,FALSE,0,FALSE,15904,17286,-3362,20.4
FALSE,FALSE,0,FALSE,14415,17028,-2534,23.8,TRUE,0,FALSE,16949,20059,2534,23.3
TRUE,TRUE,1,FALSE,19987,19679,4805,19.4,FALSE,1,TRUE,15182,15871,-4805,19.4
TRUE,TRUE,1,TRUE,18464,18681,1259,23.4,FALSE,0,FALSE,17205,17227,-1259,19.2
FALSE,TRUE,0,FALSE,17467,19153,1299,24.4,FALSE,0,FALSE,16168,18274,-1299,24.1
FALSE,FALSE,1,FALSE,14686,17187,-1592,22.8,TRUE,1,TRUE,16278,19304,1592,24.7
TRUE,TRUE,1,TRUE,17202,19917,1360,22.9,FALSE,0,FALSE,15842,17643,-1360,22
TRUE,FALSE,0,FALSE,15810,18914,-866,20.8,TRUE,1,TRUE,16676,18526,866,25.3
TRUE,FALSE,0,FALSE,18886,20642,3634,24,TRUE,0,FALSE,15252,17083,-3634,17.5
TRUE,TRUE,0,FALSE,16668,18572,1401,26.1,FALSE,0,FALSE,15267,18487,-1401,20.3
FALSE,FALSE,0,FALSE,13794,15813,-4192,19,TRUE,1,TRUE,17986,19797,4192,22
TRUE,TRUE,0,FALSE,19292,18153,4641,21,FALSE,1,TRUE,14651,15862,-4641,17.2
FALSE,TRUE,1,TRUE,17004,17216,2253,18.5,FALSE,0,FALSE,14751,16444,-2253,16.3
TRUE,TRUE,2,TRUE,17231,17207,3203,24,FALSE,0,FALSE,14028,15377,-3203,18.6
TRUE,TRUE,2,TRUE,19383,21403,4656,27.1,FALSE,0,FALSE,14727,17627,-4656,24.9
TRUE,TRUE,1,TRUE,16417,17202,161,20.5,FALSE,0,FALSE,16256,17072,-161,20.9
TRUE,FALSE,0,FALSE,17281,18317,-65,22.8,TRUE,1,TRUE,17346,18750,65,24.6
FALSE,FALSE,0,FALSE,15195,16429,-2539,18.7,TRUE,0,FALSE,17734,18066,2539,22.3
TRUE,TRUE,0,FALSE,15091,14181,-2623,17.2,FALSE,1,TRUE,17714,17617,2623,21.1
TRUE,TRUE,1,TRUE,18456,19034,2724,21.4,FALSE,0,FALSE,15732,16864,-2724,21.8
TRUE,TRUE,1,TRUE,17196,18109,2177,20.4,FALSE,0,FALSE,15019,17923,-2177,23.7
FALSE,FALSE,0,FALSE,15534,15681,-2840,20.9,TRUE,0,FALSE,18374,17041,2840,19.8
FALSE,FALSE,1,FALSE,15067,17908,-2718,20.1,TRUE,1,TRUE,17785,18908,2718,23.8
FALSE,TRUE,1,TRUE,15295,15416,-2783,15.7,FALSE,1,FALSE,18078,17433,2783,21.3
FALSE,FALSE,0,FALSE,18501,17881,-939,20.7,TRUE,1,TRUE,19440,20478,939,21.4
FALSE,FALSE,0,FALSE,15119,16068,-3770,20.1,TRUE,0,FALSE,18889,19027,3770,21.3
FALSE,TRUE,0,FALSE,15294,16497,-3442,20.2,FALSE,0,FALSE,18736,19412,3442,22.1
TRUE,TRUE,1,FALSE,18099,18678,3236,20.3,FALSE,0,FALSE,14863,15214,-3236,16.3
TRUE,TRUE,0,FALSE,16790,17505,382,19.3,FALSE,0,FALSE,16408,17569,-382,20.8
TRUE,TRUE,0,FALSE,17467,18794,2135,23.8,FALSE,0,FALSE,15332,16896,-2135,19.4
FALSE,FALSE,1,FALSE,16338,18577,-524,22.3,TRUE,1,TRUE,16862,18109,524,20.9
TRUE,TRUE,1,TRUE,15471,15785,-3033,19.2,FALSE,0,FALSE,18504,19560,3033,20.7
FALSE,FALSE,1,TRUE,14322,16812,-3441,18.6,TRUE,1,FALSE,17763,18544,3441,22.7
TRUE,TRUE,1,TRUE,18266,19178,3360,25.4,FALSE,0,FALSE,14906,17485,-3360,23.5
TRUE,TRUE,1,TRUE,22697,21092,8553,25.4,FALSE,0,FALSE,14144,16219,-8553,16.6
TRUE,TRUE,0,FALSE,16538,17488,-571,20.4,FALSE,1,TRUE,17109,17889,571,22.2
FALSE,FALSE,0,FALSE,16373,18479,-2027,22.1,TRUE,2,TRUE,18400,18593,2027,23.5
TRUE,TRUE,0,FALSE,15029,16462,-29,24.4,FALSE,1,TRUE,15058,17243,29,20.7
FALSE,FALSE,1,TRUE,15412,17055,-709,18,TRUE,1,FALSE,16121,17713,709,23.1
TRUE,TRUE,0,FALSE,16478,18363,707,22.4,FALSE,1,TRUE,15771,19151,-707,22.5
FALSE,TRUE,0,FALSE,17488,19282,2435,24.3,FALSE,0,FALSE,15053,18043,-2435,23.7
FALSE,TRUE,0,FALSE,18105,18937,2627,25.4,FALSE,0,FALSE,15478,17611,-2627,21.6
TRUE,TRUE,1,TRUE,17465,18926,1968,17.6,FALSE,0,FALSE,15497,17753,-1968,19.7
FALSE,FALSE,0,FALSE,14735,18220,-665,23.4,TRUE,1,TRUE,15400,18557,665,22.7
TRUE,FALSE,1,FALSE,14529,17127,-2930,21.8,TRUE,0,FALSE,17459,19021,2930,20.7
FALSE,FALSE,1,FALSE,14311,17028,-5821,21.7,TRUE,1,TRUE,20132,20258,5821,25.1
TRUE,TRUE,2,TRUE,14820,17885,-2497,21.1,FALSE,0,FALSE,17317,20285,2497,26
TRUE,TRUE,2,TRUE,23701,21188,8863,23.9,FALSE,0,FALSE,14838,15777,-8863,19.7
FALSE,FALSE,0,FALSE,15078,17979,-1823,21.9,TRUE,1,TRUE,16901,18789,1823,22.5
TRUE,FALSE,1,FALSE,15844,17574,1147,22.5,TRUE,1,TRUE,14697,17320,-1147,18.6
FALSE,FALSE,2,TRUE,14285,16387,-4177,18.2,TRUE,0,FALSE,18462,18027,4177,20.9
TRUE,FALSE,1,TRUE,15596,15360,-2600,19.7,TRUE,1,FALSE,18196,17472,2600,18.5
TRUE,TRUE,1,TRUE,18089,19431,2696,23.5,FALSE,0,FALSE,15393,16979,-2696,19.6
TRUE,TRUE,2,TRUE,18320,19311,3413,26.8,FALSE,0,FALSE,14907,17008,-3413,15.1
FALSE,FALSE,0,FALSE,12837,15086,-5369,19.6,TRUE,2,TRUE,18206,20279,5369,24.2
FALSE,TRUE,1,TRUE,16135,17299,-153,21.6,FALSE,0,FALSE,16288,18404,153,24.1
FALSE,FALSE,0,FALSE,13599,15596,-5031,22.9,TRUE,0,FALSE,18630,20807,5031,24.1
TRUE,FALSE,0,FALSE,14732,17531,-1461,21,TRUE,1,TRUE,16193,18330,1461,24
FALSE,FALSE,0,FALSE,15529,17787,-522,23.7,TRUE,1,TRUE,16051,19160,522,22.2
FALSE,TRUE,1,TRUE,15909,17578,257,20.8,FALSE,0,FALSE,15652,18703,-257,23.3
FALSE,TRUE,0,FALSE,15953,18137,1496,20.7,FALSE,1,TRUE,14457,16679,-1496,20.1
FALSE,FALSE,0,FALSE,17867,17671,-1354,21.8,TRUE,0,FALSE,19221,18469,1354,21.4
FALSE,TRUE,0,FALSE,16324,17343,-683,21.6,FALSE,0,FALSE,17007,18019,683,24.8
FALSE,FALSE,0,FALSE,13006,14750,-6892,20.1,TRUE,2,TRUE,19898,20121,6892,23.3
FALSE,FALSE,0,FALSE,16165,17638,-2163,22,TRUE,1,TRUE,18328,18377,2163,21.3
FALSE,FALSE,1,TRUE,14205,15571,-4462,20.4,TRUE,0,FALSE,18667,19024,4462,26.9
TRUE,TRUE,0,FALSE,16882,17922,-2059,20.4,FALSE,0,FALSE,18941,20267,2059,22
TRUE,FALSE,0,FALSE,14871,16941,-1682,18,TRUE,1,TRUE,16553,17504,1682,19.1
TRUE,TRUE,2,TRUE,20860,21006,8027,26.8,FALSE,0,FALSE,12833,13385,-8027,16.5
TRUE,TRUE,0,FALSE,15379,18530,995,23.8,FALSE,0,FALSE,14384,16881,-995,23.2
TRUE,TRUE,1,TRUE,15814,17846,1012,24,FALSE,0,FALSE,14802,17655,-1012,22.9
FALSE,FALSE,0,FALSE,17252,18777,-1287,20.5,TRUE,0,FALSE,18539,18783,1287,21.7
FALSE,TRUE,0,FALSE,16451,16842,359,19.1,FALSE,0,FALSE,16092,17614,-359,19.5
TRUE,FALSE,0,FALSE,16991,16213,803,18,TRUE,0,FALSE,16188,15723,-803,17.7
FALSE,FALSE,1,TRUE,14695,17395,-3426,22.3,TRUE,0,FALSE,18121,19934,3426,23.6
TRUE,TRUE,0,FALSE,16333,18597,1315,24.4,FALSE,1,FALSE,15018,17195,-1315,20.6
TRUE,TRUE,0,FALSE,17875,17347,1171,21.2,FALSE,0,FALSE,16704,18188,-1171,19
TRUE,FALSE,1,TRUE,18912,20086,3970,24.4,TRUE,0,FALSE,14942,17268,-3970,21
TRUE,FALSE,0,FALSE,16791,17929,482,22.5,TRUE,1,TRUE,16309,17312,-482,20.7
FALSE,TRUE,1,FALSE,15198,17307,-2090,21.4,FALSE,1,TRUE,17288,19495,2090,22.2
TRUE,TRUE,0,FALSE,18156,19293,2052,23.8,FALSE,0,FALSE,16104,18209,-2052,24
TRUE,FALSE,0,FALSE,18334,19209,3770,23.2,TRUE,1,TRUE,14564,17653,-3770,19.5
FALSE,TRUE,0,FALSE,16054,17023,-849,20.2,FALSE,1,TRUE,16903,17626,849,21.5
TRUE,TRUE,1,FALSE,18271,18004,1656,22.3,FALSE,1,TRUE,16615,17909,-1656,22.6
FALSE,FALSE,0,FALSE,15645,16821,-2328,20.3,TRUE,1,TRUE,17973,18345,2328,20.9
TRUE,TRUE,1,TRUE,17816,20228,4677,24.4,FALSE,0,FALSE,13139,15640,-4677,21.6
TRUE,FALSE,1,TRUE,15237,17965,724,20.5,TRUE,1,FALSE,14513,15940,-724,20.6
TRUE,TRUE,1,FALSE,15740,17908,1154,22,FALSE,1,TRUE,14586,16937,-1154,22.5
FALSE,FALSE,1,TRUE,15949,17392,919,19.8,TRUE,0,FALSE,15030,17428,-919,21.1
TRUE,FALSE,0,FALSE,17250,18870,160,25.5,TRUE,0,FALSE,17090,17871,-160,23.1
FALSE,TRUE,1,TRUE,17191,17267,-347,20.6,FALSE,0,FALSE,17538,20020,347,21.2
TRUE,FALSE,0,FALSE,17512,20540,3122,28.3,TRUE,1,TRUE,14390,17264,-3122,24.4
FALSE,TRUE,0,FALSE,15336,17953,-761,25.3,FALSE,1,FALSE,16097,17963,761,21.9
FALSE,FALSE,1,TRUE,14143,15352,-6445,20.5,TRUE,1,FALSE,20588,19681,6445,20.9
TRUE,TRUE,0,FALSE,16092,18020,262,22.2,FALSE,1,TRUE,15830,17409,-262,19.1
TRUE,TRUE,1,FALSE,17505,19027,1014,23.6,FALSE,1,TRUE,16491,18177,-1014,20.1
FALSE,TRUE,0,FALSE,15005,17143,-1022,21.3,FALSE,2,TRUE,16027,18396,1022,23
FALSE,FALSE,0,FALSE,15189,17359,-4907,19.5,TRUE,1,TRUE,20096,20060,4907,25
FALSE,FALSE,0,FALSE,16945,18652,1978,21.8,TRUE,0,FALSE,14967,16716,-1978,18.8
FALSE,TRUE,0,FALSE,18269,16542,1032,19.8,FALSE,0,FALSE,17237,17159,-1032,20.2
TRUE,FALSE,1,FALSE,16697,19455,2799,23.5,TRUE,1,TRUE,13898,16490,-2799,20
FALSE,TRUE,1,TRUE,15179,16562,-2967,22,FALSE,0,FALSE,18146,20771,2967,26.6
FALSE,TRUE,1,TRUE,14664,16863,-1770,21.8,FALSE,1,FALSE,16434,18139,1770,21.9
TRUE,TRUE,1,TRUE,17375,17881,1825,22.5,FALSE,0,FALSE,15550,17638,-1825,19.9
TRUE,FALSE,1,TRUE,17524,18825,2764,25.8,TRUE,0,FALSE,14760,16704,-2764,20.8
TRUE,FALSE,0,FALSE,18033,18634,1324,20.1,TRUE,1,FALSE,16709,16942,-1324,18.5
TRUE,TRUE,0,FALSE,18880,19278,2690,23.5,FALSE,1,TRUE,16190,16764,-2690,19.3
TRUE,FALSE,1,TRUE,18751,19155,1520,23.2,TRUE,0,FALSE,17231,17987,-1520,23.2
TRUE,FALSE,1,FALSE,16150,18167,-830,21.3,TRUE,0,FALSE,16980,18615,830,22.6
FALSE,TRUE,1,TRUE,13769,15094,-4147,17.4,FALSE,0,FALSE,17916,18117,4147,21.7
TRUE,FALSE,1,TRUE,15202,18246,-947,24,TRUE,0,FALSE,16149,17230,947,23.1
FALSE,FALSE,1,TRUE,14885,15463,-3695,17,TRUE,1,FALSE,18580,19481,3695,24.1
FALSE,FALSE,0,FALSE,15847,16305,-1252,19.9,TRUE,1,FALSE,17099,17495,1252,23.1
TRUE,TRUE,0,FALSE,16708,19294,1371,21.2,FALSE,0,FALSE,15337,18115,-1371,23.8
TRUE,TRUE,2,TRUE,17788,18965,1767,24.8,FALSE,0,FALSE,16021,17557,-1767,22.1
TRUE,TRUE,0,FALSE,16988,17774,1605,21.3,FALSE,2,TRUE,15383,17019,-1605,20.3
TRUE,TRUE,1,TRUE,22049,19632,8532,24.3,FALSE,0,FALSE,13517,13756,-8532,16.5
TRUE,TRUE,0,FALSE,16752,18525,-753,22.6,FALSE,0,FALSE,17505,18824,753,22.5
TRUE,TRUE,2,TRUE,18318,19194,4446,22.8,FALSE,0,FALSE,13872,15746,-4446,18.8
FALSE,FALSE,0,FALSE,14655,16541,-3142,20.8,TRUE,1,FALSE,17797,19174,3142,21.6
TRUE,FALSE,0,FALSE,14321,15077,-2695,16.7,TRUE,0,FALSE,17016,17649,2695,18.1
FALSE,FALSE,0,FALSE,14434,15829,-4603,18.3,TRUE,2,TRUE,19037,18496,4603,21.2
FALSE,TRUE,1,TRUE,18910,18538,1454,20.3,FALSE,0,FALSE,17456,17351,-1454,18.5
FALSE,FALSE,1,TRUE,15740,17449,-312,20.6,TRUE,0,FALSE,16052,17922,312,22.9
FALSE,TRUE,0,FALSE,15428,16724,-491,20.1,FALSE,1,TRUE,15919,18141,491,21.1
FALSE,FALSE,0,FALSE,15577,17244,124,20.7,TRUE,2,TRUE,15453,17290,-124,22
FALSE,TRUE,1,FALSE,17282,17712,-1008,22.2,FALSE,1,TRUE,18290,18522,1008,22
TRUE,FALSE,1,TRUE,17009,17881,1121,22.2,TRUE,0,FALSE,15888,17045,-1121,22.8
FALSE,FALSE,0,FALSE,16345,17662,-2154,20.9,TRUE,0,FALSE,18499,20010,2154,22.5
TRUE,FALSE,0,FALSE,16142,17532,-1711,23.7,TRUE,2,TRUE,17853,18618,1711,19.5
FALSE,TRUE,1,TRUE,18839,18977,1144,18.9,FALSE,0,FALSE,17695,18033,-1144,22.8
TRUE,TRUE,1,TRUE,17570,18349,2414,22.6,FALSE,0,FALSE,15156,15942,-2414,21.9
FALSE,FALSE,0,FALSE,15265,14533,-2627,16.1,TRUE,0,FALSE,17892,16991,2627,21.8
TRUE,FALSE,2,TRUE,15581,18847,-353,23.3,TRUE,0,FALSE,15934,19127,353,22.8
FALSE,FALSE,0,FALSE,16514,18198,1232,21.1,TRUE,1,TRUE,15282,16840,-1232,21.5
TRUE,TRUE,2,TRUE,16127,18248,1071,23.5,FALSE,0,FALSE,15056,17604,-1071,21.2
TRUE,FALSE,1,TRUE,17831,19052,2233,19.8,TRUE,0,FALSE,15598,15943,-2233,20.4
TRUE,TRUE,1,TRUE,17002,19584,4376,22.7,FALSE,0,FALSE,12626,15478,-4376,18.4
TRUE,FALSE,0,FALSE,16931,19352,1931,22.2,TRUE,0,FALSE,15000,17268,-1931,22.2
TRUE,TRUE,0,FALSE,19267,19780,2669,25.7,FALSE,2,TRUE,16598,17037,-2669,20.5
TRUE,TRUE,1,TRUE,17593,17874,2596,19,FALSE,0,FALSE,14997,16822,-2596,20.7
TRUE,FALSE,0,FALSE,16950,18151,1081,21.8,TRUE,1,TRUE,15869,16394,-1081,18.3
FALSE,TRUE,0,FALSE,13829,16293,-2523,17.1,FALSE,1,TRUE,16352,18373,2523,22.2
FALSE,TRUE,0,FALSE,16478,17590,1207,25.4,FALSE,2,TRUE,15271,18078,-1207,21.2
TRUE,FALSE,1,TRUE,16338,19137,1106,23.4,TRUE,0,FALSE,15232,17828,-1106,22.8
TRUE,FALSE,1,TRUE,14972,17357,-266,20.1,TRUE,1,FALSE,15238,17970,266,23.3
TRUE,FALSE,1,TRUE,16152,18649,1069,22.8,TRUE,0,FALSE,15083,17545,-1069,23.8
FALSE,FALSE,1,TRUE,17209,17808,1710,22.9,TRUE,0,FALSE,15499,16510,-1710,16.6
FALSE,FALSE,0,FALSE,17084,17884,-100,22.4,TRUE,1,TRUE,17184,18004,100,20.7
TRUE,TRUE,0,FALSE,15073,17942,-556,19.8,FALSE,1,TRUE,15629,18384,556,22.6
TRUE,TRUE,0,FALSE,17795,18920,-274,16.4,FALSE,0,FALSE,18069,18616,274,23.7
FALSE,FALSE,0,FALSE,16404,18053,-554,23.1,TRUE,2,TRUE,16958,17879,554,20.4
FALSE,TRUE,0,FALSE,15119,18065,-542,21.1,FALSE,1,TRUE,15661,19300,542,22.4
TRUE,FALSE,0,FALSE,17770,17974,1753,22.8,TRUE,0,FALSE,16017,17011,-1753,23.3
FALSE,TRUE,0,FALSE,15212,17204,-1718,20.2,FALSE,1,FALSE,16930,19126,1718,20.1
FALSE,TRUE,1,TRUE,15781,17614,-1980,20.3,FALSE,0,FALSE,17761,19209,1980,22.8
FALSE,FALSE,1,FALSE,15524,17326,-645,21.7,TRUE,1,TRUE,16169,18821,645,20
TRUE,FALSE,0,FALSE,15473,17556,-1174,19.5,TRUE,0,FALSE,16647,18334,1174,22.1
FALSE,TRUE,0,FALSE,18034,17170,1179,21.1,FALSE,0,FALSE,16855,17845,-1179,22.2
TRUE,TRUE,1,TRUE,16646,17451,1308,18.8,FALSE,1,FALSE,15338,16155,-1308,22.7
FALSE,TRUE,1,TRUE,18185,19320,1340,21.3,FALSE,0,FALSE,16845,18002,-1340,21.6
FALSE,TRUE,0,FALSE,15761,18094,-983,23.9,FALSE,1,TRUE,16744,19668,983,21.8
TRUE,TRUE,2,TRUE,16243,19006,855,24.5,FALSE,0,FALSE,15388,16126,-855,20.4
FALSE,FALSE,1,FALSE,18909,18843,3023,23.7,TRUE,1,TRUE,15886,16728,-3023,21.1
FALSE,FALSE,0,FALSE,17014,17257,-426,22.1,TRUE,0,FALSE,17440,18312,426,20.4
TRUE,TRUE,2,TRUE,18820,19789,1991,20.7,FALSE,0,FALSE,16829,17315,-1991,20.7
TRUE,TRUE,1,TRUE,18257,19371,3149,24.6,FALSE,0,FALSE,15108,17858,-3149,22.7
FALSE,TRUE,0,FALSE,13860,16122,-5214,20.3,FALSE,1,FALSE,19074,19282,5214,23.3
TRUE,FALSE,0,FALSE,14942,17678,-763,20,TRUE,1,TRUE,15705,17283,763,24.1
FALSE,FALSE,0,FALSE,14056,16342,-2129,19.3,TRUE,1,TRUE,16185,17884,2129,21.7
TRUE,FALSE,1,TRUE,18534,19784,2361,20.8,TRUE,0,FALSE,16173,17295,-2361,23.3
FALSE,TRUE,1,TRUE,16118,17602,-1209,20,FALSE,0,FALSE,17327,19158,1209,25.1
TRUE,FALSE,1,FALSE,17135,19139,1046,24.2,TRUE,1,TRUE,16089,18324,-1046,23.3
FALSE,FALSE,1,FALSE,15293,17145,-1809,19.2,TRUE,1,TRUE,17102,18576,1809,21.5
FALSE,TRUE,0,FALSE,15555,15866,-2286,20,FALSE,1,TRUE,17841,19801,2286,22
TRUE,FALSE,0,FALSE,19907,20865,3079,23.1,TRUE,1,TRUE,16828,18767,-3079,18.6
TRUE,FALSE,1,TRUE,15593,16199,-3101,20.4,TRUE,0,FALSE,18694,19096,3101,22.3
TRUE,TRUE,1,TRUE,16305,18828,713,19.1,FALSE,0,FALSE,15592,17977,-713,22.9
TRUE,TRUE,0,FALSE,16344,19039,1108,23.8,FALSE,2,TRUE,15236,19020,-1108,24.4
TRUE,FALSE,1,TRUE,18863,19070,4747,22.8,TRUE,0,FALSE,14116,16146,-4747,18.9
TRUE,TRUE,1,TRUE,18266,19333,3160,23.9,FALSE,0,FALSE,15106,16872,-3160,20.6
FALSE,TRUE,0,FALSE,14528,16573,-2377,20.3,FALSE,1,TRUE,16905,18911,2377,25.1
TRUE,TRUE,1,FALSE,17131,17701,1254,22.9,FALSE,1,TRUE,15877,17782,-1254,19.9
TRUE,FALSE,1,TRUE,19273,18465,5784,22.6,TRUE,0,FALSE,13489,13710,-5784,16.8
TRUE,FALSE,0,FALSE,15555,19127,1019,25.4,TRUE,1,TRUE,14536,17759,-1019,21.7
TRUE,TRUE,1,TRUE,18265,19323,2520,20.4,FALSE,1,FALSE,15745,16123,-2520,16.3
TRUE,TRUE,1,TRUE,15343,17430,1184,21,FALSE,0,FALSE,14159,16582,-1184,21.3
TRUE,TRUE,0,FALSE,18631,19460,4089,24.5,FALSE,1,TRUE,14542,16088,-4089,19.3
FALSE,TRUE,0,FALSE,17245,17559,-1300,20.7,FALSE,1,TRUE,18545,18914,1300,24.4
TRUE,TRUE,0,FALSE,17670,18217,32,20.1,FALSE,0,FALSE,17638,19169,-32,24.7
TRUE,TRUE,0,FALSE,18100,18030,2690,19.7,FALSE,1,FALSE,15410,17794,-2690,21.1
TRUE,FALSE,1,TRUE,17499,18873,2282,21.7,TRUE,0,FALSE,15217,17608,-2282,23.7
FALSE,TRUE,1,TRUE,16940,18041,-896,19.1,FALSE,0,FALSE,17836,18434,896,23.5
TRUE,TRUE,0,FALSE,17960,17948,2873,22.6,FALSE,1,TRUE,15087,16098,-2873,19.3
FALSE,FALSE,0,FALSE,15637,16547,-1960,20.5,TRUE,1,TRUE,17597,17256,1960,22.3
TRUE,TRUE,1,TRUE,18726,20142,2673,25.7,FALSE,0,FALSE,16053,17419,-2673,19.6
TRUE,TRUE,0,FALSE,17244,18750,1091,22.1,FALSE,2,TRUE,16153,17666,-1091,23.5
TRUE,FALSE,1,TRUE,15038,17122,-2755,19.4,TRUE,0,FALSE,17793,17991,2755,21.8
FALSE,FALSE,0,FALSE,17490,18680,-905,19.8,TRUE,1,TRUE,18395,18709,905,19.6
FALSE,FALSE,0,FALSE,15970,17608,-2046,19.6,TRUE,0,FALSE,18016,18299,2046,22.6
TRUE,FALSE,1,TRUE,16435,19956,1527,25,TRUE,0,FALSE,14908,18327,-1527,22.8
TRUE,FALSE,0,FALSE,17562,17442,1975,20.3,TRUE,1,TRUE,15587,16630,-1975,20.8
FALSE,FALSE,0,FALSE,16786,16781,-1739,18.9,TRUE,1,TRUE,18525,17619,1739,19.6
FALSE,TRUE,0,FALSE,18193,18289,4939,22.5,FALSE,0,FALSE,13254,16216,-4939,17.5
FALSE,TRUE,0,FALSE,16061,17642,-717,23,FALSE,1,TRUE,16778,18639,717,23.6
FALSE,FALSE,0,FALSE,17517,19291,-1567,17.9,TRUE,0,FALSE,19084,18786,1567,21.9
TRUE,TRUE,1,TRUE,17696,18389,3650,22.3,FALSE,0,FALSE,14046,15677,-3650,23.7
FALSE,TRUE,0,FALSE,15777,17772,-2930,21.5,FALSE,1,TRUE,18707,17636,2930,21.5
FALSE,FALSE,0,FALSE,14494,15666,-5290,18.1,TRUE,1,TRUE,19784,18776,5290,19.2
FALSE,TRUE,1,TRUE,18385,19050,2957,24.4,FALSE,0,FALSE,15428,17373,-2957,21
FALSE,TRUE,0,FALSE,15081,17777,-66,20.6,FALSE,0,FALSE,15147,16962,66,21.5
TRUE,TRUE,0,FALSE,16702,17865,1713,20.3,FALSE,0,FALSE,14989,16474,-1713,22.8
TRUE,FALSE,1,FALSE,17481,19040,1784,24.8,TRUE,1,TRUE,15697,17847,-1784,21.6
TRUE,TRUE,0,FALSE,16445,18995,214,22.4,FALSE,0,FALSE,16231,17427,-214,21.5
FALSE,FALSE,0,FALSE,14387,15777,-3214,15.8,TRUE,2,TRUE,17601,17972,3214,22.6
TRUE,TRUE,2,TRUE,18261,19979,4062,24.8,FALSE,0,FALSE,14199,17361,-4062,22.8
TRUE,TRUE,2,TRUE,20151,20475,4296,26.1,FALSE,0,FALSE,15855,17441,-4296,17.3
TRUE,TRUE,1,FALSE,16232,18631,319,20,FALSE,1,TRUE,15913,17072,-319,22.4
TRUE,FALSE,0,FALSE,13775,17208,-2217,20.6,TRUE,1,TRUE,15992,17923,2217,24.2
FALSE,FALSE,1,TRUE,14771,17669,-916,23.4,TRUE,0,FALSE,15687,17479,916,24.2
TRUE,TRUE,1,FALSE,15538,18222,982,26.4,FALSE,1,TRUE,14556,17540,-982,25.8
FALSE,FALSE,0,FALSE,19390,18011,993,20,TRUE,0,FALSE,18397,17586,-993,19
TRUE,FALSE,1,TRUE,16474,17494,-912,20.9,TRUE,1,FALSE,17386,18233,912,24.4
TRUE,TRUE,1,TRUE,19267,20141,4538,23,FALSE,0,FALSE,14729,16558,-4538,20.1
FALSE,TRUE,0,FALSE,16367,17910,-1761,21.8,FALSE,2,TRUE,18128,18136,1761,23.3
TRUE,FALSE,1,FALSE,16066,18218,-1826,19.5,TRUE,1,TRUE,17892,18221,1826,18.3
FALSE,FALSE,0,FALSE,14790,16619,-1967,21.7,TRUE,1,TRUE,16757,17911,1967,20.4
FALSE,FALSE,0,FALSE,14417,17488,-2984,23.7,TRUE,1,TRUE,17401,18954,2984,24.8
FALSE,FALSE,0,FALSE,16365,18280,94,19.5,TRUE,1,TRUE,16271,16384,-94,19.1
TRUE,TRUE,1,FALSE,16647,17867,-206,21.4,FALSE,1,TRUE,16853,18230,206,23.8
FALSE,FALSE,1,TRUE,15058,17113,-2588,22.3,TRUE,0,FALSE,17646,17610,2588,22.3
FALSE,FALSE,1,FALSE,20419,20428,5113,24.6,TRUE,1,TRUE,15306,16400,-5113,18.6
FALSE,TRUE,1,TRUE,16224,18284,586,25.4,FALSE,0,FALSE,15638,17936,-586,24.5
FALSE,TRUE,1,TRUE,16338,16019,-577,19.1,FALSE,0,FALSE,16915,18240,577,20.4
TRUE,TRUE,2,TRUE,19557,18070,4380,19.1,FALSE,0,FALSE,15177,14828,-4380,18.4
FALSE,FALSE,0,FALSE,14125,16758,-2858,17,TRUE,1,TRUE,16983,17278,2858,22.4
TRUE,FALSE,0,FALSE,15125,17843,-712,19.7,TRUE,1,TRUE,15837,16866,712,21.6
FALSE,TRUE,0,FALSE,17297,18422,-2526,22.8,FALSE,2,TRUE,19823,20233,2526,22.1
TRUE,TRUE,1,TRUE,16437,16958,-222,19.5,FALSE,0,FALSE,16659,16941,222,20.8
TRUE,FALSE,0,FALSE,15689,16026,-1544,18.7,TRUE,1,TRUE,17233,16818,1544,18
TRUE,FALSE,0,FALSE,16281,17598,127,21.6,TRUE,2,TRUE,16154,18539,-127,19.4
TRUE,TRUE,0,FALSE,17464,18187,1579,21.7,FALSE,1,TRUE,15885,18358,-1579,20.5
TRUE,TRUE,1,FALSE,19978,19500,5201,25.1,FALSE,1,TRUE,14777,17844,-5201,17.9
TRUE,TRUE,1,TRUE,18142,18432,3680,22.4,FALSE,0,FALSE,14462,15902,-3680,19
TRUE,TRUE,2,TRUE,18375,19454,4941,22.2,FALSE,0,FALSE,13434,16027,-4941,20
TRUE,FALSE,0,FALSE,16507,18941,479,21.6,TRUE,0,FALSE,16028,18591,-479,21.2
TRUE,FALSE,1,TRUE,14988,15830,-1093,21.4,TRUE,0,FALSE,16081,17788,1093,23.7
FALSE,FALSE,1,TRUE,16203,18321,2,22.8,TRUE,0,FALSE,16201,18686,-2,22.8
TRUE,FALSE,0,FALSE,16522,18641,1958,23.6,TRUE,0,FALSE,14564,16261,-1958,19.5
FALSE,TRUE,0,FALSE,18306,16973,1898,21.4,FALSE,1,TRUE,16408,16699,-1898,19.7
FALSE,TRUE,0,FALSE,17573,17180,-81,20.5,FALSE,1,TRUE,17654,18646,81,22.7
TRUE,TRUE,2,TRUE,17827,19215,3073,22.9,FALSE,0,FALSE,14754,17287,-3073,18.2
FALSE,TRUE,1,TRUE,16182,17560,-320,20.4,FALSE,0,FALSE,16502,17680,320,19.5
FALSE,FALSE,1,TRUE,15309,17455,-1069,24.5,TRUE,0,FALSE,16378,17753,1069,24.1
FALSE,FALSE,0,FALSE,15594,17492,366,23.3,TRUE,1,TRUE,15228,16262,-366,20.5
TRUE,TRUE,0,FALSE,18340,18533,1899,20.1,FALSE,0,FALSE,16441,17637,-1899,19.8
TRUE,FALSE,2,TRUE,17486,17915,1389,21.5,TRUE,0,FALSE,16097,17425,-1389,19.8
TRUE,TRUE,0,FALSE,16911,17768,-1165,20.7,FALSE,0,FALSE,18076,17039,1165,20.1
FALSE,TRUE,1,FALSE,18107,18102,2002,23.6,FALSE,0,FALSE,16105,17801,-2002,21.7
FALSE,FALSE,0,FALSE,16649,18909,-360,23,TRUE,0,FALSE,17009,18251,360,20.3
TRUE,TRUE,0,FALSE,18322,20963,4100,25.8,FALSE,0,FALSE,14222,16060,-4100,20.4
FALSE,TRUE,1,TRUE,17366,17609,629,21.3,FALSE,0,FALSE,16737,18496,-629,22.3
FALSE,FALSE,1,FALSE,14984,18050,-1287,23.5,TRUE,1,TRUE,16271,18796,1287,23.7
TRUE,FALSE,0,FALSE,18945,18908,3107,24.1,TRUE,0,FALSE,15838,16776,-3107,19.9
FALSE,FALSE,0,FALSE,17851,19947,1051,25.7,TRUE,1,TRUE,16800,18723,-1051,24.7
FALSE,FALSE,0,FALSE,16900,16827,-1920,16.1,TRUE,1,TRUE,18820,19882,1920,22.5
FALSE,FALSE,0,FALSE,14923,17661,-1899,22.9,TRUE,0,FALSE,16822,19951,1899,24.4
FALSE,TRUE,0,FALSE,14790,16593,-3951,18.5,FALSE,1,TRUE,18741,19201,3951,22.5
TRUE,TRUE,0,FALSE,18035,18668,1977,25,FALSE,0,FALSE,16058,17033,-1977,18.3
TRUE,TRUE,1,TRUE,17193,18554,577,25.7,FALSE,0,FALSE,16616,17183,-577,22.8
TRUE,TRUE,0,FALSE,19536,20584,5452,21.7,FALSE,0,FALSE,14084,16074,-5452,17.8
FALSE,FALSE,2,TRUE,16444,18995,1415,22.9,TRUE,0,FALSE,15029,17044,-1415,22.5
FALSE,FALSE,0,FALSE,13177,15610,-7314,17.7,TRUE,1,TRUE,20491,21644,7314,25.8
TRUE,TRUE,1,TRUE,17564,15596,2032,16.7,FALSE,0,FALSE,15532,14403,-2032,17
FALSE,TRUE,1,TRUE,17281,17509,-1125,20.3,FALSE,1,FALSE,18406,18835,1125,22.9
FALSE,FALSE,0,FALSE,15818,17864,-60,23.3,TRUE,1,TRUE,15878,16517,60,18.6
FALSE,FALSE,0,FALSE,16208,18110,-1656,21.8,TRUE,1,TRUE,17864,19473,1656,24.2
FALSE,TRUE,1,FALSE,17174,18458,507,23.1,FALSE,1,TRUE,16667,17948,-507,23.3
TRUE,FALSE,1,TRUE,17920,18730,2536,22.4,TRUE,0,FALSE,15384,17984,-2536,22
TRUE,FALSE,1,TRUE,15882,18675,-1019,19.8,TRUE,0,FALSE,16901,19036,1019,24
FALSE,FALSE,0,FALSE,15801,17010,-1603,20.9,TRUE,2,TRUE,17404,17819,1603,20.4
FALSE,TRUE,0,FALSE,18866,19651,3412,25.2,FALSE,0,FALSE,15454,17565,-3412,20.7
FALSE,TRUE,2,TRUE,14056,16260,-1903,22.3,FALSE,0,FALSE,15959,18797,1903,23.1
FALSE,FALSE,1,TRUE,15876,17206,-2266,22.4,TRUE,1,FALSE,18142,19253,2266,22.1
FALSE,TRUE,1,FALSE,15567,18798,62,23.2,FALSE,0,FALSE,15505,17450,-62,23.7
FALSE,FALSE,0,FALSE,15979,16648,-3456,19,TRUE,2,TRUE,19435,18077,3456,18.9
FALSE,FALSE,1,TRUE,16398,17974,768,23.6,TRUE,0,FALSE,15630,17469,-768,21.8
FALSE,TRUE,1,FALSE,15721,18756,-1050,21.3,FALSE,1,TRUE,16771,18667,1050,23.8
FALSE,FALSE,0,FALSE,14206,16793,-3427,20,TRUE,1,TRUE,17633,18585,3427,25.3
TRUE,TRUE,1,TRUE,20844,18777,6672,25,FALSE,1,FALSE,14172,15016,-6672,17.1
TRUE,TRUE,1,TRUE,17428,19729,2087,22,FALSE,0,FALSE,15341,17151,-2087,22.9
TRUE,FALSE,0,FALSE,16879,18526,2053,21.1,TRUE,1,TRUE,14826,17400,-2053,23.2
TRUE,TRUE,1,TRUE,17422,17192,2394,21.1,FALSE,0,FALSE,15028,18484,-2394,21
FALSE,FALSE,0,FALSE,15255,18312,-112,22.8,TRUE,0,FALSE,15367,18079,112,23.4
FALSE,FALSE,1,TRUE,16978,19145,-1712,20.5,TRUE,0,FALSE,18690,19539,1712,20.8
FALSE,FALSE,1,TRUE,15738,16512,-2550,18.8,TRUE,0,FALSE,18288,18497,2550,22.4
FALSE,FALSE,0,FALSE,17079,18150,899,20.3,TRUE,1,TRUE,16180,17855,-899,22.5
TRUE,TRUE,0,FALSE,14761,17655,-294,23,FALSE,0,FALSE,15055,18932,294,19.3
TRUE,TRUE,1,TRUE,19724,20621,4999,26.3,FALSE,1,FALSE,14725,17313,-4999,14.8
FALSE,TRUE,1,TRUE,17479,19021,2143,24.3,FALSE,0,FALSE,15336,17706,-2143,20.3
TRUE,FALSE,2,TRUE,20344,18646,3175,19.3,TRUE,0,FALSE,17169,16671,-3175,16.2
FALSE,FALSE,0,FALSE,15141,18537,-2506,23,TRUE,1,TRUE,17647,20516,2506,25
FALSE,FALSE,0,FALSE,15793,17950,848,24.6,TRUE,1,TRUE,14945,17487,-848,21
TRUE,TRUE,0,FALSE,15653,16241,-2026,20.3,FALSE,1,TRUE,17679,17476,2026,21.6
TRUE,TRUE,1,TRUE,15836,18174,813,22.3,FALSE,0,FALSE,15023,17687,-813,21.9
TRUE,TRUE,0,FALSE,14673,16034,-110,18.3,FALSE,2,TRUE,14783,17503,110,21.4
TRUE,TRUE,0,FALSE,18270,18656,3134,24.9,FALSE,1,TRUE,15136,17587,-3134,21.7
FALSE,TRUE,0,FALSE,19362,17316,965,19.5,FALSE,1,FALSE,18397,15460,-965,18
FALSE,TRUE,1,TRUE,15820,17954,40,20,FALSE,0,FALSE,15780,16614,-40,21.2
TRUE,TRUE,1,TRUE,16583,17825,961,21.9,FALSE,1,FALSE,15622,18725,-961,23.4
TRUE,TRUE,1,TRUE,18558,19625,3958,26.9,FALSE,1,FALSE,14600,15744,-3958,19.4
TRUE,TRUE,0,FALSE,17477,19006,1814,23.2,FALSE,1,TRUE,15663,18933,-1814,21
TRUE,TRUE,0,FALSE,14935,18365,-3469,19.8,FALSE,2,TRUE,18404,20052,3469,26.3
TRUE,TRUE,1,FALSE,19203,20047,3548,22,FALSE,1,TRUE,15655,16488,-3548,20.4
TRUE,TRUE,0,FALSE,16701,17820,882,23.7,FALSE,0,FALSE,15819,17370,-882,19.2
FALSE,TRUE,1,FALSE,17529,17038,1530,13.8,FALSE,1,TRUE,15999,18233,-1530,24.3
FALSE,FALSE,0,FALSE,15264,16327,-3212,20.8,TRUE,0,FALSE,18476,17988,3212,21.7
FALSE,TRUE,1,TRUE,17403,19112,1518,21.5,FALSE,0,FALSE,15885,17238,-1518,19.2
TRUE,TRUE,1,FALSE,15500,17374,-1006,21.8,FALSE,1,TRUE,16506,18980,1006,22.1
FALSE,FALSE,0,FALSE,12886,14091,-3117,16.5,TRUE,1,TRUE,16003,17890,3117,20.6
TRUE,TRUE,1,TRUE,17780,18440,3170,22.1,FALSE,0,FALSE,14610,16360,-3170,21.3
TRUE,FALSE,0,FALSE,15632,18400,-1822,23.2,TRUE,2,TRUE,17454,19867,1822,24.4
TRUE,TRUE,1,TRUE,16230,17203,-726,19,FALSE,0,FALSE,16956,18452,726,23
TRUE,FALSE,1,TRUE,15346,18388,1342,23.2,TRUE,0,FALSE,14004,16502,-1342,20.6
FALSE,TRUE,1,TRUE,15718,17991,1464,25,FALSE,0,FALSE,14254,17066,-1464,21.5
TRUE,TRUE,1,TRUE,17620,19434,2387,23.3,FALSE,0,FALSE,15233,18023,-2387,20.1
FALSE,FALSE,0,FALSE,14958,16993,-4629,20.7,TRUE,1,TRUE,19587,20386,4629,23.9
FALSE,FALSE,0,FALSE,14025,16510,-2846,20.5,TRUE,1,TRUE,16871,18474,2846,21.8
TRUE,TRUE,2,TRUE,15656,17844,85,22.7,FALSE,0,FALSE,15571,18550,-85,21.7
FALSE,TRUE,0,FALSE,17155,16245,-4473,18.3,FALSE,2,TRUE,21628,19221,4473,21.4
TRUE,TRUE,1,TRUE,16595,18940,859,21,FALSE,0,FALSE,15736,16259,-859,20.3
TRUE,TRUE,1,TRUE,17283,16810,-428,20.5,FALSE,1,FALSE,17711,16805,428,21.3
FALSE,FALSE,0,FALSE,15388,15598,-4104,17.9,TRUE,0,FALSE,19492,19056,4104,26.4
FALSE,TRUE,1,FALSE,17797,17892,354,19.1,FALSE,0,FALSE,17443,17644,-354,19.8
TRUE,FALSE,0,FALSE,17170,18110,959,24.3,TRUE,0,FALSE,16211,15927,-959,19.4
TRUE,TRUE,0,FALSE,16729,18725,1970,22.7,FALSE,0,FALSE,14759,17921,-1970,22.8
FALSE,TRUE,0,FALSE,17424,18146,-618,22.4,FALSE,0,FALSE,18042,18815,618,22.3
FALSE,TRUE,2,TRUE,16912,17022,106,21.3,FALSE,0,FALSE,16806,18120,-106,17.9
FALSE,TRUE,1,FALSE,19426,18749,4146,21.8,FALSE,1,TRUE,15280,15608,-4146,19.1
FALSE,TRUE,0,FALSE,16062,17907,39,19.5,FALSE,1,TRUE,16023,18982,-39,23.7
TRUE,FALSE,1,FALSE,17440,18208,2367,19.7,TRUE,1,TRUE,15073,16262,-2367,17.8
FALSE,TRUE,0,FALSE,15273,16831,-2111,22.7,FALSE,1,TRUE,17384,18438,2111,21.8
TRUE,FALSE,0,FALSE,16571,19112,-528,21.2,TRUE,2,TRUE,17099,17356,528,21
TRUE,TRUE,1,FALSE,19204,20182,4424,22.8,FALSE,1,TRUE,14780,15213,-4424,18.7
FALSE,TRUE,0,FALSE,15210,17457,262,22.2,FALSE,2,TRUE,14948,17871,-262,21.6
FALSE,TRUE,0,FALSE,17190,17552,777,22.6,FALSE,0,FALSE,16413,16976,-777,19
FALSE,FALSE,0,FALSE,16839,18230,468,22.2,TRUE,1,TRUE,16371,17860,-468,21.1
FALSE,FALSE,0,FALSE,14552,16760,-3408,22.2,TRUE,2,TRUE,17960,18250,3408,22.8
TRUE,FALSE,1,TRUE,19359,19182,4424,24.3,TRUE,0,FALSE,14935,16519,-4424,18.9
TRUE,TRUE,2,TRUE,16043,18113,-76,21.3,FALSE,0,FALSE,16119,16393,76,20.6
FALSE,FALSE,0,FALSE,15723,15978,-5601,19.6,TRUE,1,TRUE,21324,20920,5601,21
FALSE,FALSE,0,FALSE,17924,18749,870,24.8,TRUE,0,FALSE,17054,18046,-870,24.1
TRUE,TRUE,1,FALSE,15833,18396,904,25,FALSE,1,TRUE,14929,17353,-904,21.3
TRUE,TRUE,1,FALSE,16691,19203,1814,22.6,FALSE,0,FALSE,14877,17441,-1814,21.4
FALSE,TRUE,0,FALSE,15301,18098,166,24.9,FALSE,1,TRUE,15135,18534,-166,23
FALSE,TRUE,0,FALSE,16132,17360,-1211,20.7,FALSE,1,FALSE,17343,19617,1211,24.4
FALSE,TRUE,0,FALSE,17513,18336,1941,22.8,FALSE,1,FALSE,15572,17490,-1941,18.8
TRUE,FALSE,1,TRUE,17108,18548,990,23,TRUE,0,FALSE,16118,16750,-990,21.8
TRUE,FALSE,2,TRUE,17178,18411,2614,23.4,TRUE,0,FALSE,14564,16126,-2614,17
FALSE,FALSE,0,FALSE,14511,16462,-342,21.2,TRUE,1,TRUE,14853,18707,342,21.2
FALSE,FALSE,1,FALSE,13199,15949,-6134,17.3,TRUE,0,FALSE,19333,20609,6134,25.5
TRUE,FALSE,0,FALSE,17107,17665,-1661,21.5,TRUE,2,TRUE,18768,18924,1661,23.9
FALSE,FALSE,0,FALSE,14731,15155,-6086,15.4,TRUE,0,FALSE,20817,18267,6086,23.7
FALSE,TRUE,0,FALSE,14937,16417,-2601,21.1,FALSE,2,TRUE,17538,20111,2601,23.2
FALSE,FALSE,0,FALSE,13340,15466,-3586,22.3,TRUE,1,TRUE,16926,17737,3586,18.9
TRUE,FALSE,1,FALSE,19684,20073,3920,21.7,TRUE,1,TRUE,15764,16771,-3920,21.9
FALSE,FALSE,0,FALSE,15461,17683,-1912,20.6,TRUE,2,TRUE,17373,19940,1912,24.3
TRUE,TRUE,1,TRUE,14700,17577,203,23.4,FALSE,0,FALSE,14497,17166,-203,25.3
FALSE,FALSE,1,TRUE,17026,18231,17,21.3,TRUE,1,FALSE,17009,18634,-17,21.8
TRUE,FALSE,1,TRUE,15357,17204,1273,20,TRUE,0,FALSE,14084,16143,-1273,23.9
TRUE,TRUE,0,FALSE,17498,17932,1023,20,FALSE,1,FALSE,16475,17913,-1023,19.6
FALSE,FALSE,0,FALSE,15140,15745,-3371,19.8,TRUE,1,TRUE,18511,17839,3371,21.7
TRUE,FALSE,1,TRUE,16398,17450,455,21.8,TRUE,0,FALSE,15943,16926,-455,18.4
TRUE,TRUE,1,TRUE,16972,18007,891,18.4,FALSE,0,FALSE,16081,16953,-891,19.6
TRUE,TRUE,0,FALSE,17777,19414,3361,23.8,FALSE,0,FALSE,14416,15869,-3361,20.8
TRUE,TRUE,1,TRUE,16184,18007,2813,22.3,FALSE,0,FALSE,13371,16785,-2813,21
FALSE,FALSE,0,FALSE,14085,15408,-3803,22,TRUE,2,TRUE,17888,19428,3803,24.5
FALSE,FALSE,0,FALSE,13944,15850,-3179,18.5,TRUE,1,TRUE,17123,18424,3179,23
TRUE,FALSE,1,FALSE,16730,17875,913,24.6,TRUE,0,FALSE,15817,17861,-913,20.5
FALSE,FALSE,1,TRUE,14507,16400,-2328,21.5,TRUE,1,FALSE,16835,17553,2328,18.9
FALSE,FALSE,0,FALSE,14327,16104,-3392,19.4,TRUE,1,TRUE,17719,18220,3392,22.3
FALSE,FALSE,1,TRUE,17048,18361,171,23,TRUE,0,FALSE,16877,17203,-171,18.5
FALSE,TRUE,0,FALSE,16103,17909,1119,23.8,FALSE,0,FALSE,14984,17921,-1119,24.5
TRUE,FALSE,0,FALSE,16413,18104,-3036,22.5,TRUE,1,TRUE,19449,20192,3036,25.1
TRUE,TRUE,1,FALSE,18122,19174,2195,23.3,FALSE,0,FALSE,15927,18620,-2195,20
TRUE,FALSE,0,FALSE,17166,17136,-1030,16.5,TRUE,1,FALSE,18196,17455,1030,20.3
FALSE,TRUE,1,FALSE,15079,15930,607,21.2,FALSE,1,TRUE,14472,17098,-607,21
TRUE,TRUE,1,FALSE,18766,17630,2343,21.6,FALSE,1,TRUE,16423,19144,-2343,20.2
FALSE,TRUE,0,FALSE,13802,15735,-4177,21.2,FALSE,1,TRUE,17979,18721,4177,24.7
TRUE,FALSE,1,TRUE,16044,18612,1223,23.7,TRUE,1,FALSE,14821,16489,-1223,23.1
FALSE,FALSE,0,FALSE,14535,16907,-6147,19.5,TRUE,2,TRUE,20682,18122,6147,18.9
FALSE,FALSE,2,TRUE,16936,16881,-865,20.9,TRUE,0,FALSE,17801,17361,865,18.8
FALSE,TRUE,0,FALSE,16082,17246,-974,22,FALSE,0,FALSE,17056,18552,974,22.8
TRUE,TRUE,0,FALSE,18346,18224,3454,22.8,FALSE,2,TRUE,14892,16342,-3454,19.2
TRUE,FALSE,2,TRUE,19437,18500,546,18.8,TRUE,0,FALSE,18891,17820,-546,19.1
FALSE,FALSE,1,FALSE,16145,19030,-1580,19.2,TRUE,1,TRUE,17725,18672,1580,22.4
TRUE,TRUE,1,TRUE,16600,18185,1825,23.8,FALSE,0,FALSE,14775,17189,-1825,22.8
FALSE,FALSE,0,FALSE,17944,17835,901,21.4,TRUE,0,FALSE,17043,17691,-901,23
TRUE,FALSE,0,FALSE,14439,16062,-3435,17.1,TRUE,1,TRUE,17874,17694,3435,23
TRUE,FALSE,0,FALSE,15008,17439,-3688,21.4,TRUE,1,TRUE,18696,20247,3688,25.8
FALSE,TRUE,0,FALSE,15262,17524,-1033,23.2,FALSE,1,TRUE,16295,17628,1033,21.1
TRUE,TRUE,1,TRUE,16305,18269,1947,21.7,FALSE,0,FALSE,14358,16402,-1947,18
FALSE,TRUE,0,FALSE,13908,12798,-4561,16.7,FALSE,1,TRUE,18469,17829,4561,18.7
FALSE,TRUE,1,TRUE,17554,19243,3255,20.4,FALSE,0,FALSE,14299,17519,-3255,21.1
FALSE,FALSE,0,FALSE,15543,15357,-3333,19.3,TRUE,0,FALSE,18876,17925,3333,23.4
TRUE,TRUE,1,TRUE,17519,19252,3272,22.2,FALSE,0,FALSE,14247,17338,-3272,23.2
TRUE,TRUE,2,TRUE,17788,17625,1655,17.8,FALSE,0,FALSE,16133,15611,-1655,19.5
TRUE,FALSE,0,FALSE,17261,17685,-112,21.9,TRUE,1,TRUE,17373,17883,112,22.1
FALSE,TRUE,1,FALSE,16313,17999,-220,23.4,FALSE,1,TRUE,16533,17932,220,23.2
FALSE,FALSE,0,FALSE,12774,15643,-4538,19.9,TRUE,1,TRUE,17312,18519,4538,25
FALSE,FALSE,0,FALSE,16003,18376,-1515,22.9,TRUE,2,TRUE,17518,18380,1515,21.9
FALSE,TRUE,1,TRUE,15472,17032,-1851,18.1,FALSE,0,FALSE,17323,18907,1851,21.1
TRUE,FALSE,1,FALSE,16697,19148,601,23.3,TRUE,1,TRUE,16096,19451,-601,23
TRUE,TRUE,1,TRUE,17065,18597,878,22.9,FALSE,0,FALSE,16187,18137,-878,20.4
FALSE,FALSE,0,FALSE,15374,17614,405,22.1,TRUE,0,FALSE,14969,17603,-405,20.5
TRUE,FALSE,2,TRUE,17882,17930,1667,20.5,TRUE,0,FALSE,16215,16747,-1667,19.4
TRUE,TRUE,0,FALSE,17803,18782,2197,24.2,FALSE,0,FALSE,15606,17266,-2197,22.8
FALSE,FALSE,1,FALSE,16548,17321,-2775,19.2,TRUE,1,TRUE,19323,20193,2775,22
TRUE,TRUE,1,TRUE,19433,18610,4483,21.3,FALSE,0,FALSE,14950,15478,-4483,17.6
TRUE,TRUE,1,TRUE,17790,17688,1837,19,FALSE,1,FALSE,15953,17230,-1837,17.6
FALSE,TRUE,1,TRUE,14719,16802,-2317,20,FALSE,1,FALSE,17036,18602,2317,19.4
FALSE,FALSE,0,FALSE,16418,17424,-1517,19.9,TRUE,1,TRUE,17935,17486,1517,21.1
FALSE,FALSE,0,FALSE,16566,18441,-418,21.6,TRUE,1,TRUE,16984,19052,418,20.8
TRUE,TRUE,1,FALSE,20356,17899,5305,22.5,FALSE,1,TRUE,15051,17517,-5305,18.4
FALSE,FALSE,1,FALSE,18524,18597,85,19.4,TRUE,1,TRUE,18439,17354,-85,18.2
TRUE,TRUE,2,TRUE,17507,19641,2790,25,FALSE,0,FALSE,14717,16568,-2790,20.9
FALSE,TRUE,2,TRUE,16774,18465,300,24,FALSE,0,FALSE,16474,19033,-300,23.1
FALSE,FALSE,1,FALSE,15527,18231,-564,22.3,TRUE,1,TRUE,16091,18529,564,24.6
FALSE,FALSE,1,FALSE,14154,17350,-3597,20.6,TRUE,1,TRUE,17751,20107,3597,24.3
TRUE,FALSE,0,FALSE,14783,18120,-2003,24.8,TRUE,0,FALSE,16786,19490,2003,26.4
TRUE,FALSE,1,TRUE,18070,19549,1263,23.7,TRUE,0,FALSE,16807,18959,-1263,20.5
FALSE,FALSE,1,TRUE,15689,17178,-808,17.1,TRUE,0,FALSE,16497,17444,808,21.1
FALSE,TRUE,1,TRUE,17090,18470,989,21.6,FALSE,0,FALSE,16101,17715,-989,21.3
FALSE,TRUE,1,TRUE,14524,16989,-2527,23.4,FALSE,1,FALSE,17051,18686,2527,23.8
FALSE,TRUE,1,TRUE,15496,16404,1559,23.8,FALSE,1,FALSE,13937,16273,-1559,19.7
TRUE,TRUE,0,FALSE,17972,19649,2455,25.4,FALSE,0,FALSE,15517,17569,-2455,21.4
FALSE,FALSE,0,FALSE,15124,16323,-2588,18.5,TRUE,0,FALSE,17712,17678,2588,21.7
TRUE,TRUE,0,FALSE,16784,18335,992,26.7,FALSE,1,TRUE,15792,19196,-992,22.4
FALSE,FALSE,1,FALSE,14157,15002,-3948,15.8,TRUE,1,TRUE,18105,19657,3948,24.3
TRUE,FALSE,1,TRUE,19296,18995,3611,22.2,TRUE,0,FALSE,15685,16859,-3611,18
TRUE,TRUE,1,TRUE,22134,20809,8151,23.4,FALSE,0,FALSE,13983,15695,-8151,17.6
TRUE,FALSE,0,FALSE,18734,19093,2355,18.7,TRUE,1,TRUE,16379,18209,-2355,20
TRUE,TRUE,1,TRUE,17914,18528,3410,24,FALSE,0,FALSE,14504,16004,-3410,18.7
TRUE,FALSE,0,FALSE,17892,18432,1017,19.7,TRUE,1,TRUE,16875,17885,-1017,20.1
TRUE,FALSE,1,FALSE,19969,19752,6763,25.5,TRUE,0,FALSE,13206,13264,-6763,19.2
FALSE,TRUE,1,TRUE,16250,17320,-1497,23.6,FALSE,0,FALSE,17747,18572,1497,22.5
FALSE,TRUE,1,TRUE,15850,15600,29,21,FALSE,0,FALSE,15821,17152,-29,22.2
FALSE,FALSE,1,TRUE,16505,18233,1110,24.5,TRUE,0,FALSE,15395,18458,-1110,21.2
FALSE,TRUE,1,FALSE,18741,19102,3447,24.3,FALSE,1,TRUE,15294,17126,-3447,21
FALSE,FALSE,0,FALSE,17051,17619,-530,20.8,TRUE,1,TRUE,17581,17134,530,19.1
TRUE,TRUE,1,TRUE,18936,19738,4798,25.3,FALSE,0,FALSE,14138,14642,-4798,17.6
FALSE,FALSE,0,FALSE,15551,15956,-259,17.6,TRUE,0,FALSE,15810,16532,259,17.3
FALSE,TRUE,1,TRUE,16455,18317,-411,21.7,FALSE,0,FALSE,16866,17943,411,21.5
FALSE,TRUE,1,TRUE,17357,18388,-310,19.1,FALSE,1,FALSE,17667,17818,310,19.4
FALSE,FALSE,1,FALSE,16293,18893,929,22.9,TRUE,0,FALSE,15364,17885,-929,22.7
TRUE,TRUE,1,TRUE,16541,17961,1568,21.1,FALSE,0,FALSE,14973,15922,-1568,20.8
TRUE,TRUE,0,FALSE,19477,18390,5099,22.4,FALSE,1,TRUE,14378,15823,-5099,17.6
TRUE,FALSE,1,TRUE,16331,18927,-462,24.6,TRUE,0,FALSE,16793,18385,462,27.3
FALSE,FALSE,0,FALSE,16115,17647,-3032,19.3,TRUE,0,FALSE,19147,19506,3032,24.3
FALSE,TRUE,0,FALSE,16575,18673,-134,23.3,FALSE,1,TRUE,16709,18819,134,24.2
FALSE,TRUE,0,FALSE,15161,17135,-106,17.4,FALSE,1,TRUE,15267,17962,106,20.7
FALSE,FALSE,2,TRUE,15097,17461,-971,22.6,TRUE,0,FALSE,16068,18908,971,25.3
FALSE,FALSE,2,TRUE,16514,17281,-594,21.6,TRUE,0,FALSE,17108,18625,594,24.2
TRUE,TRUE,0,FALSE,19770,19116,5120,23.2,FALSE,2,TRUE,14650,15979,-5120,19.1
TRUE,TRUE,1,TRUE,17915,19615,1963,22.5,FALSE,0,FALSE,15952,18834,-1963,25.8
TRUE,FALSE,0,FALSE,16450,18742,296,22.2,TRUE,2,TRUE,16154,17696,-296,22
FALSE,TRUE,0,FALSE,16007,17907,1201,22.1,FALSE,1,TRUE,14806,17212,-1201,20.9
FALSE,TRUE,2,TRUE,16552,18731,334,22.7,FALSE,0,FALSE,16218,18586,-334,22.5
FALSE,FALSE,0,FALSE,15750,16898,259,21.6,TRUE,0,FALSE,15491,16425,-259,20
TRUE,TRUE,2,TRUE,17162,20178,3035,24.9,FALSE,0,FALSE,14127,16386,-3035,17
FALSE,FALSE,2,TRUE,17743,17923,-1223,19.4,TRUE,0,FALSE,18966,18969,1223,19.8
FALSE,TRUE,1,TRUE,15527,16705,625,18.5,FALSE,0,FALSE,14902,17578,-625,22.6
FALSE,FALSE,0,FALSE,15585,18357,-2017,21.6,TRUE,0,FALSE,17602,19016,2017,22
TRUE,FALSE,1,FALSE,17026,18847,2439,25.4,TRUE,0,FALSE,14587,16487,-2439,23
TRUE,TRUE,1,TRUE,16149,18253,-549,21.7,FALSE,0,FALSE,16698,18576,549,23.3
FALSE,FALSE,0,FALSE,13728,17193,-3675,20.4,TRUE,0,FALSE,17403,19647,3675,24
TRUE,FALSE,1,TRUE,18003,20207,3034,24.8,TRUE,0,FALSE,14969,18224,-3034,21.1
TRUE,TRUE,1,TRUE,16497,17789,787,20.1,FALSE,0,FALSE,15710,18364,-787,23.2
FALSE,FALSE,0,FALSE,17666,17054,846,19.5,TRUE,0,FALSE,16820,17082,-846,24.7
TRUE,TRUE,1,FALSE,16711,17375,-927,21.7,FALSE,1,TRUE,17638,17575,927,22.9
FALSE,TRUE,1,TRUE,15414,17454,-599,20.8,FALSE,0,FALSE,16013,17742,599,21.8
FALSE,FALSE,0,FALSE,19372,18078,1734,20.1,TRUE,1,TRUE,17638,16905,-1734,19.5
FALSE,FALSE,0,FALSE,15207,16955,-5324,21.3,TRUE,2,TRUE,20531,19869,5324,20.5
TRUE,FALSE,0,FALSE,16378,16097,-4552,18.9,TRUE,1,TRUE,20930,20305,4552,23.4
TRUE,TRUE,1,TRUE,16683,19168,1828,22.3,FALSE,0,FALSE,14855,17034,-1828,22.4
TRUE,FALSE,1,FALSE,17215,18989,324,25.6,TRUE,0,FALSE,16891,16913,-324,23.4
FALSE,FALSE,0,FALSE,17177,18796,-1885,22.8,TRUE,1,TRUE,19062,19006,1885,23.6
FALSE,TRUE,1,TRUE,17682,17214,724,19.5,FALSE,0,FALSE,16958,16973,-724,22.9
FALSE,FALSE,0,FALSE,16744,19007,-645,18.3,TRUE,0,FALSE,17389,18581,645,22.4
FALSE,FALSE,1,FALSE,17812,19113,2554,23.4,TRUE,1,TRUE,15258,17067,-2554,21.2
FALSE,FALSE,0,FALSE,14971,17477,-1390,25.5,TRUE,2,TRUE,16361,17923,1390,22.6
FALSE,FALSE,1,TRUE,17432,17080,-399,20,TRUE,0,FALSE,17831,18428,399,20.3
TRUE,FALSE,1,FALSE,15341,18065,-85,21.5,TRUE,1,TRUE,15426,16400,85,20.2
TRUE,TRUE,0,FALSE,17357,19151,4111,23.4,FALSE,1,TRUE,13246,16328,-4111,20.8
FALSE,FALSE,0,FALSE,14747,18401,-1356,24.5,TRUE,1,TRUE,16103,18902,1356,26.1
FALSE,FALSE,1,TRUE,15368,16039,71,16.9,TRUE,0,FALSE,15297,16718,-71,19.8
TRUE,TRUE,1,TRUE,15931,17840,393,23.1,FALSE,0,FALSE,15538,17729,-393,25.5
FALSE,FALSE,0,FALSE,17188,17474,809,22.9,TRUE,1,FALSE,16379,16829,-809,19.1
TRUE,FALSE,1,TRUE,17737,18873,1126,22,TRUE,0,FALSE,16611,18324,-1126,22.8
TRUE,FALSE,1,TRUE,15024,17340,-1243,21.7,TRUE,1,FALSE,16267,18601,1243,22.1
TRUE,FALSE,1,FALSE,19659,19474,3745,24.1,TRUE,0,FALSE,15914,17847,-3745,23
FALSE,TRUE,1,FALSE,17562,18086,1269,20.3,FALSE,1,TRUE,16293,17347,-1269,19.9
FALSE,FALSE,1,TRUE,14527,16646,-4267,22.1,TRUE,1,FALSE,18794,19392,4267,23.8
FALSE,FALSE,0,FALSE,14509,16800,-1749,19.1,TRUE,2,TRUE,16258,18047,1749,25.1
TRUE,TRUE,1,FALSE,18650,20053,4128,23.4,FALSE,0,FALSE,14522,16925,-4128,24.3
TRUE,TRUE,0,FALSE,15818,16786,656,20.5,FALSE,0,FALSE,15162,17225,-656,20
FALSE,FALSE,1,FALSE,15550,17793,-1324,21.8,TRUE,1,TRUE,16874,18408,1324,25.7
FALSE,TRUE,0,FALSE,16655,18948,791,20.8,FALSE,2,TRUE,15864,17884,-791,21.2
TRUE,FALSE,0,FALSE,14790,18612,-3075,22.3,TRUE,1,TRUE,17865,18856,3075,26.6
TRUE,TRUE,0,FALSE,17755,19403,2864,25.4,FALSE,0,FALSE,14891,16210,-2864,22.1
TRUE,TRUE,2,TRUE,17973,17436,2038,22.3,FALSE,0,FALSE,15935,16407,-2038,20.7
FALSE,TRUE,1,FALSE,14566,16031,-2061,18.2,FALSE,1,TRUE,16627,18077,2061,20
TRUE,TRUE,1,TRUE,15983,17134,544,21.9,FALSE,0,FALSE,15439,17423,-544,21.8
FALSE,FALSE,1,TRUE,15655,17386,-693,20.3,TRUE,0,FALSE,16348,18305,693,23.4
TRUE,TRUE,0,FALSE,17840,18356,3047,23.3,FALSE,1,TRUE,14793,16740,-3047,22.9
FALSE,TRUE,2,TRUE,16018,18223,-599,21.5,FALSE,0,FALSE,16617,18031,599,24.2
TRUE,FALSE,0,FALSE,13719,15044,-3247,21.3,TRUE,2,TRUE,16966,18827,3247,23.7
TRUE,FALSE,0,FALSE,17633,18808,1703,20.6,TRUE,0,FALSE,15930,16999,-1703,21
TRUE,TRUE,0,FALSE,17552,16611,1189,20.1,FALSE,1,FALSE,16363,17432,-1189,19.1
TRUE,TRUE,1,TRUE,20236,18074,3424,20.3,FALSE,0,FALSE,16812,16610,-3424,16.9
TRUE,FALSE,1,TRUE,14558,17024,-2564,20.6,TRUE,1,FALSE,17122,18983,2564,22.2
FALSE,FALSE,1,TRUE,15080,18378,-401,20.8,TRUE,0,FALSE,15481,18817,401,23.2
TRUE,TRUE,1,FALSE,19621,19733,6703,20.9,FALSE,0,FALSE,12918,14129,-6703,14
TRUE,FALSE,0,FALSE,15970,18425,24,24.5,TRUE,0,FALSE,15946,18711,-24,24.9
FALSE,FALSE,1,TRUE,15581,18725,-460,23.9,TRUE,1,FALSE,16041,17790,460,22.3
TRUE,TRUE,0,FALSE,21278,20007,6968,25.3,FALSE,1,TRUE,14310,15628,-6968,18.5
TRUE,TRUE,1,TRUE,17352,18631,1963,25.7,FALSE,0,FALSE,15389,17827,-1963,21
TRUE,TRUE,1,FALSE,15289,16623,-1041,21,FALSE,1,TRUE,16330,17737,1041,19.6
TRUE,TRUE,1,FALSE,17819,19319,2979,23.6,FALSE,1,TRUE,14840,18136,-2979,22.3
TRUE,TRUE,1,FALSE,16723,17883,1489,23.3,FALSE,0,FALSE,15234,17279,-1489,22.8
FALSE,TRUE,1,TRUE,17857,19272,2374,23.9,FALSE,0,FALSE,15483,17940,-2374,23.9
FALSE,TRUE,1,FALSE,16940,16731,1523,23.2,FALSE,1,TRUE,15417,17307,-1523,18.5
FALSE,FALSE,1,TRUE,17059,18302,977,21.4,TRUE,0,FALSE,16082,17055,-977,20.3
FALSE,TRUE,0,FALSE,15593,17750,-416,22.5,FALSE,1,TRUE,16009,19389,416,22.1
TRUE,FALSE,0,FALSE,17074,18861,519,24.2,TRUE,1,TRUE,16555,17425,-519,23.2
TRUE,TRUE,0,FALSE,16466,16798,59,18.5,FALSE,2,TRUE,16407,17103,-59,21
TRUE,FALSE,2,TRUE,19082,18970,4305,22.6,TRUE,0,FALSE,14777,16726,-4305,21.6
TRUE,TRUE,1,TRUE,16961,17778,-33,23.8,FALSE,1,FALSE,16994,18776,33,21.3
FALSE,TRUE,0,FALSE,16864,18195,874,24.7,FALSE,2,TRUE,15990,18749,-874,23.2
FALSE,FALSE,0,FALSE,14988,16513,-2824,20,TRUE,0,FALSE,17812,18534,2824,22.2
TRUE,FALSE,0,FALSE,18886,18539,845,18.8,TRUE,0,FALSE,18041,17490,-845,21.4
TRUE,TRUE,0,FALSE,15223,17348,-713,21.3,FALSE,0,FALSE,15936,18245,713,22.8
TRUE,FALSE,2,TRUE,15947,18280,402,21.9,TRUE,0,FALSE,15545,17390,-402,23.7
FALSE,TRUE,0,FALSE,14473,17358,-2485,18.5,FALSE,1,TRUE,16958,18928,2485,26.3
FALSE,TRUE,1,TRUE,17214,19173,1746,23.5,FALSE,0,FALSE,15468,16900,-1746,20.5
FALSE,FALSE,0,FALSE,14515,16542,-4152,17.5,TRUE,1,TRUE,18667,18490,4152,25.3
FALSE,FALSE,1,TRUE,15463,16652,-1846,16.1,TRUE,1,FALSE,17309,18014,1846,19.4
FALSE,FALSE,0,FALSE,15032,16564,-4481,20.3,TRUE,1,TRUE,19513,18094,4481,24.5
FALSE,FALSE,0,FALSE,14979,16961,-4686,19.4,TRUE,1,TRUE,19665,19898,4686,20.8
FALSE,FALSE,0,FALSE,13863,17182,-1336,21.9,TRUE,1,TRUE,15199,18424,1336,22.6
TRUE,TRUE,0,FALSE,15736,18522,2112,21.6,FALSE,1,TRUE,13624,15956,-2112,19.7
FALSE,TRUE,0,FALSE,15978,17338,455,22.5,FALSE,0,FALSE,15523,18476,-455,19.1
FALSE,TRUE,0,FALSE,18400,18909,2746,22.1,FALSE,1,TRUE,15654,16934,-2746,16.4
FALSE,FALSE,2,TRUE,15573,18078,-4673,19.4,TRUE,0,FALSE,20246,19303,4673,24.6
FALSE,FALSE,1,TRUE,15520,17369,-1949,20.7,TRUE,1,FALSE,17469,19352,1949,23
FALSE,TRUE,0,FALSE,13367,15834,-4081,15.7,FALSE,1,TRUE,17448,17828,4081,21.6
TRUE,FALSE,1,TRUE,17687,18625,2159,21.3,TRUE,0,FALSE,15528,16525,-2159,18
TRUE,FALSE,0,FALSE,17663,16879,16,19.3,TRUE,2,TRUE,17647,17518,-16,22.7
FALSE,FALSE,0,FALSE,16108,16262,-1701,21.1,TRUE,0,FALSE,17809,17033,1701,19
TRUE,FALSE,1,TRUE,14697,16968,-780,22.9,TRUE,1,FALSE,15477,18036,780,23.6
FALSE,FALSE,0,FALSE,15106,17323,-2793,20,TRUE,1,FALSE,17899,17240,2793,21.5
FALSE,TRUE,0,FALSE,16175,16320,1426,20.2,FALSE,0,FALSE,14749,15796,-1426,20.4
TRUE,TRUE,1,TRUE,18787,18529,1876,23.1,FALSE,0,FALSE,16911,16861,-1876,20.3
TRUE,FALSE,0,FALSE,17460,17575,2338,21.7,TRUE,1,FALSE,15122,16566,-2338,19.2
FALSE,FALSE,1,FALSE,16835,17752,606,20,TRUE,0,FALSE,16229,17219,-606,21.1
FALSE,FALSE,2,TRUE,17351,16649,-780,20.4,TRUE,0,FALSE,18131,16586,780,19.3
TRUE,TRUE,0,FALSE,16412,17900,1211,23.5,FALSE,1,TRUE,15201,17149,-1211,24.9
TRUE,FALSE,1,FALSE,15040,18066,-1964,19.7,TRUE,0,FALSE,17004,19029,1964,26
FALSE,FALSE,0,FALSE,16293,17793,1006,21.8,TRUE,1,TRUE,15287,16622,-1006,20.7
FALSE,FALSE,1,TRUE,16249,18007,444,22.1,TRUE,1,FALSE,15805,16951,-444,21.3
TRUE,FALSE,1,TRUE,15312,18210,-961,25,TRUE,0,FALSE,16273,18935,961,25
TRUE,TRUE,1,TRUE,16432,18560,1804,24,FALSE,0,FALSE,14628,17013,-1804,20
TRUE,TRUE,2,TRUE,18122,20449,2696,24.7,FALSE,0,FALSE,15426,17368,-2696,22.2
FALSE,FALSE,0,FALSE,16223,17056,-605,19.6,TRUE,1,TRUE,16828,17838,605,20.3
FALSE,FALSE,1,TRUE,16326,17923,-1114,23.6,TRUE,0,FALSE,17440,18340,1114,24.1
FALSE,FALSE,0,FALSE,13561,16518,-1958,22,TRUE,1,TRUE,15519,18293,1958,22.3
TRUE,FALSE,0,FALSE,15897,18131,-453,21.9,TRUE,1,TRUE,16350,17472,453,18.8
FALSE,FALSE,1,FALSE,16005,17346,-1205,18.8,TRUE,1,TRUE,17210,18388,1205,23.2
FALSE,TRUE,1,TRUE,15907,16474,-393,21.1,FALSE,0,FALSE,16300,19193,393,21.1
FALSE,TRUE,0,FALSE,17440,18112,3422,21.3,FALSE,0,FALSE,14018,17021,-3422,21.6
FALSE,FALSE,0,FALSE,14257,17053,-3234,23,TRUE,0,FALSE,17491,19942,3234,24.7
FALSE,FALSE,0,FALSE,15723,15809,-4307,15.9,TRUE,1,FALSE,20030,18069,4307,25.3
FALSE,FALSE,0,FALSE,14817,16953,-3264,21.2,TRUE,1,TRUE,18081,18460,3264,21.1
FALSE,FALSE,0,FALSE,14713,17547,-388,26.1,TRUE,1,TRUE,15101,18551,388,26.4
FALSE,FALSE,0,FALSE,16319,17353,52,21.4,TRUE,1,FALSE,16267,16799,-52,23.5
FALSE,FALSE,1,TRUE,18294,18581,1058,20.4,TRUE,0,FALSE,17236,18054,-1058,21
FALSE,FALSE,0,FALSE,14415,17890,-3505,21.3,TRUE,1,TRUE,17920,19363,3505,22.6
FALSE,TRUE,0,FALSE,17634,16665,2031,19.3,FALSE,0,FALSE,15603,15661,-2031,19.6
TRUE,FALSE,1,TRUE,17062,20216,2436,23.5,TRUE,1,FALSE,14626,17608,-2436,20.3
FALSE,TRUE,0,FALSE,19098,18390,1769,23,FALSE,1,TRUE,17329,16096,-1769,16.6
FALSE,TRUE,0,FALSE,17237,18392,-1133,21.3,FALSE,1,TRUE,18370,19106,1133,19.6
TRUE,TRUE,0,FALSE,18093,18871,1864,22.2,FALSE,1,TRUE,16229,16994,-1864,18.9
FALSE,TRUE,0,FALSE,16276,17546,273,21.5,FALSE,1,FALSE,16003,18741,-273,19.6
TRUE,TRUE,0,FALSE,16471,17952,1450,24.6,FALSE,0,FALSE,15021,17189,-1450,20
FALSE,TRUE,0,FALSE,15246,15419,-4370,15.1,FALSE,1,TRUE,19616,19923,4370,23.5
TRUE,FALSE,1,FALSE,18656,19071,3761,22.9,TRUE,0,FALSE,14895,17802,-3761,24.1
TRUE,TRUE,2,TRUE,16951,18681,1341,27,FALSE,0,FALSE,15610,18766,-1341,25.4
TRUE,FALSE,0,FALSE,17830,18550,1299,21.4,TRUE,2,TRUE,16531,18542,-1299,21.7
FALSE,TRUE,0,FALSE,16886,16618,-2107,17.2,FALSE,1,TRUE,18993,18076,2107,18.9
FALSE,TRUE,1,TRUE,16122,17673,385,22.3,FALSE,1,FALSE,15737,19119,-385,24
TRUE,TRUE,0,FALSE,19367,19595,4507,25.9,FALSE,1,TRUE,14860,17505,-4507,20.2
TRUE,TRUE,1,FALSE,20027,19439,6790,25.7,FALSE,1,TRUE,13237,14550,-6790,16.5
FALSE,TRUE,1,FALSE,19784,18582,1680,24.1,FALSE,0,FALSE,18104,18109,-1680,19.7
TRUE,FALSE,1,TRUE,15118,18628,-769,22.2,TRUE,1,FALSE,15887,17737,769,20.8
TRUE,TRUE,0,FALSE,16195,17940,2254,21.4,FALSE,0,FALSE,13941,16070,-2254,19.3
TRUE,FALSE,0,FALSE,15423,18333,699,22.7,TRUE,1,TRUE,14724,17580,-699,23.2
FALSE,TRUE,0,FALSE,18174,18815,3242,23.2,FALSE,1,TRUE,14932,16588,-3242,19.1
TRUE,TRUE,0,FALSE,16649,17555,1535,21.2,FALSE,2,TRUE,15114,17335,-1535,22.2
TRUE,TRUE,0,FALSE,16818,16998,-141,20.8,FALSE,1,TRUE,16959,16776,141,16.4
FALSE,FALSE,0,FALSE,15829,17626,-3567,23.6,TRUE,2,TRUE,19396,19454,3567,23.4
FALSE,FALSE,0,FALSE,15604,18013,-557,22.7,TRUE,2,TRUE,16161,17388,557,21.6
TRUE,FALSE,0,FALSE,14927,16195,-2597,19.5,TRUE,1,TRUE,17524,17913,2597,22.1
TRUE,TRUE,0,FALSE,16247,17790,-820,18.9,FALSE,1,TRUE,17067,18365,820,22.2
TRUE,TRUE,1,TRUE,20070,20194,4235,21.1,FALSE,0,FALSE,15835,16357,-4235,18.8
FALSE,TRUE,0,FALSE,16166,17990,180,19.8,FALSE,1,TRUE,15986,18182,-180,21.2
FALSE,FALSE,0,FALSE,15630,18378,-1092,25.4,TRUE,0,FALSE,16722,18702,1092,26.4
TRUE,TRUE,1,TRUE,18744,18677,2858,21,FALSE,0,FALSE,15886,16689,-2858,17.4
FALSE,TRUE,0,FALSE,15815,18120,-2234,20.2,FALSE,2,TRUE,18049,19384,2234,25.8
TRUE,TRUE,0,FALSE,16246,17593,-766,19.3,FALSE,1,TRUE,17012,18170,766,20.4
FALSE,TRUE,0,FALSE,15701,17899,-662,21.2,FALSE,2,TRUE,16363,18850,662,24.3
FALSE,FALSE,0,FALSE,16024,17294,-2370,21.2,TRUE,1,TRUE,18394,19398,2370,19.4
FALSE,TRUE,0,FALSE,15539,17438,-4311,20.2,FALSE,1,TRUE,19850,19970,4311,23.4
TRUE,TRUE,1,TRUE,19038,20256,4090,25.2,FALSE,0,FALSE,14948,17733,-4090,21.4
TRUE,TRUE,1,TRUE,14492,16087,-2828,17.6,FALSE,1,FALSE,17320,17901,2828,21.7
FALSE,TRUE,0,FALSE,15193,17054,-1810,23.2,FALSE,1,TRUE,17003,19715,1810,23.5
FALSE,TRUE,0,FALSE,13362,15531,-4968,15.5,FALSE,1,TRUE,18330,19696,4968,24
TRUE,TRUE,1,TRUE,14832,17330,-196,22.8,FALSE,0,FALSE,15028,17612,196,22.6
TRUE,TRUE,1,TRUE,17664,17554,2946,22.1,FALSE,0,FALSE,14718,16543,-2946,23.6
TRUE,FALSE,1,TRUE,17046,19783,307,21.7,TRUE,0,FALSE,16739,17698,-307,25.6
FALSE,TRUE,0,FALSE,15984,18306,1916,26.1,FALSE,0,FALSE,14068,17674,-1916,22.4
TRUE,TRUE,0,FALSE,18748,17354,1212,19.5,FALSE,1,TRUE,17536,17277,-1212,19.3
TRUE,TRUE,0,FALSE,16733,19698,1901,23.1,FALSE,2,TRUE,14832,18572,-1901,23.9
FALSE,FALSE,1,TRUE,15417,15374,-4032,15.4,TRUE,0,FALSE,19449,18240,4032,23.2
FALSE,TRUE,1,TRUE,18302,18149,2617,21.5,FALSE,1,FALSE,15685,16977,-2617,17.8
TRUE,FALSE,0,FALSE,15471,18349,-251,21.9,TRUE,0,FALSE,15722,17789,251,25.5
TRUE,TRUE,1,TRUE,16612,17712,1094,21.8,FALSE,0,FALSE,15518,17425,-1094,22.1
TRUE,TRUE,0,FALSE,16601,18618,1235,24.2,FALSE,0,FALSE,15366,17608,-1235,20.1
TRUE,TRUE,2,TRUE,18159,16870,5302,21.7,FALSE,0,FALSE,12857,13825,-5302,14.7
FALSE,FALSE,0,FALSE,14690,15168,-5426,18.8,TRUE,1,TRUE,20116,18283,5426,24.5
TRUE,TRUE,0,FALSE,16963,18341,2609,24.5,FALSE,1,TRUE,14354,17660,-2609,20.9
FALSE,TRUE,0,FALSE,16116,16953,-89,23.3,FALSE,1,TRUE,16205,17906,89,21.3
FALSE,FALSE,0,FALSE,15341,15896,-3588,18.8,TRUE,1,TRUE,18929,17691,3588,23
FALSE,FALSE,0,FALSE,14177,15427,-2115,19.6,TRUE,1,TRUE,16292,18299,2115,20
FALSE,TRUE,0,FALSE,17308,18538,1589,21.3,FALSE,2,TRUE,15719,18735,-1589,23.2
FALSE,TRUE,0,FALSE,15758,16906,628,21.1,FALSE,1,TRUE,15130,17464,-628,20.5
FALSE,TRUE,1,TRUE,17275,16684,-604,20.4,FALSE,0,FALSE,17879,17938,604,18.6
FALSE,TRUE,1,TRUE,16505,17778,-1861,20.6,FALSE,0,FALSE,18366,18973,1861,22.1
FALSE,TRUE,0,FALSE,18093,18506,2774,23.8,FALSE,1,TRUE,15319,17372,-2774,23
FALSE,FALSE,0,FALSE,15939,16482,-1323,20.5,TRUE,0,FALSE,17262,17507,1323,16.7
FALSE,FALSE,1,TRUE,14457,18824,-832,23,TRUE,0,FALSE,15289,18283,832,26.7
TRUE,FALSE,1,FALSE,20920,19263,5418,24.3,TRUE,0,FALSE,15502,16186,-5418,17.3
TRUE,TRUE,0,FALSE,16688,19162,3060,23.3,FALSE,1,TRUE,13628,16693,-3060,22.2
FALSE,FALSE,0,FALSE,14873,17781,-2304,20.5,TRUE,1,TRUE,17177,17750,2304,23.8
FALSE,FALSE,0,FALSE,15259,17666,-1396,21.4,TRUE,1,TRUE,16655,17758,1396,25
TRUE,TRUE,1,TRUE,18096,19349,3738,24.2,FALSE,0,FALSE,14358,15087,-3738,19.8
TRUE,TRUE,1,FALSE,16153,17913,1184,22.7,FALSE,1,TRUE,14969,17993,-1184,20.8
TRUE,TRUE,1,FALSE,19036,19444,2346,24.8,FALSE,1,TRUE,16690,18693,-2346,19.7
FALSE,FALSE,0,FALSE,17788,17829,-275,15.9,TRUE,0,FALSE,18063,18568,275,21.2
TRUE,TRUE,0,FALSE,16532,18420,1558,22.9,FALSE,1,FALSE,14974,17635,-1558,20.6
FALSE,TRUE,0,FALSE,15742,17970,-750,21.4,FALSE,1,TRUE,16492,18246,750,23.2
TRUE,TRUE,0,FALSE,15960,18912,1479,25.3,FALSE,0,FALSE,14481,16562,-1479,22.8
FALSE,FALSE,0,FALSE,16132,18331,-1850,19.9,TRUE,1,TRUE,17982,19347,1850,24.3
FALSE,TRUE,0,FALSE,17350,18836,620,20.2,FALSE,0,FALSE,16730,17962,-620,21.1
FALSE,FALSE,0,FALSE,13875,16394,-3866,20.9,TRUE,1,TRUE,17741,18381,3866,22.7
TRUE,FALSE,1,FALSE,14969,17547,1089,25.2,TRUE,0,FALSE,13880,17514,-1089,21.2
TRUE,FALSE,2,TRUE,17195,18590,827,17.8,TRUE,0,FALSE,16368,17319,-827,20.1
FALSE,TRUE,0,FALSE,15347,17655,-1374,23.4,FALSE,2,TRUE,16721,18696,1374,23.8
TRUE,FALSE,1,TRUE,18290,20250,3943,24.8,TRUE,0,FALSE,14347,16007,-3943,20
FALSE,FALSE,1,FALSE,16176,18728,543,22.1,TRUE,0,FALSE,15633,17663,-543,25.7
FALSE,TRUE,1,TRUE,16148,15943,-1106,20,FALSE,1,FALSE,17254,17377,1106,21.6
TRUE,TRUE,2,TRUE,15612,18702,-1011,21.4,FALSE,0,FALSE,16623,19011,1011,23.9
TRUE,FALSE,1,FALSE,16104,17890,1039,23.1,TRUE,1,TRUE,15065,17301,-1039,20.5
FALSE,FALSE,0,FALSE,15372,16833,-3616,16.1,TRUE,1,TRUE,18988,20185,3616,24.8
FALSE,FALSE,0,FALSE,15694,18453,217,24.2,TRUE,1,TRUE,15477,17744,-217,21.4
TRUE,FALSE,1,FALSE,17578,18250,1641,20.9,TRUE,0,FALSE,15937,16811,-1641,17.5
TRUE,TRUE,1,TRUE,18436,18039,1990,20.9,FALSE,1,FALSE,16446,18125,-1990,22.6
FALSE,TRUE,1,FALSE,16620,18824,273,21.1,FALSE,1,TRUE,16347,18569,-273,22.6
FALSE,TRUE,2,TRUE,16419,19317,1994,24.8,FALSE,0,FALSE,14425,16674,-1994,23.8
TRUE,FALSE,0,FALSE,16384,19826,759,22.9,TRUE,1,TRUE,15625,17315,-759,20.5
FALSE,FALSE,1,FALSE,15330,18294,-2105,23,TRUE,1,TRUE,17435,19360,2105,22.5
TRUE,TRUE,2,TRUE,19008,19021,4319,23.9,FALSE,0,FALSE,14689,16633,-4319,24
FALSE,FALSE,0,FALSE,16238,18854,428,26,TRUE,1,FALSE,15810,18480,-428,23.2
TRUE,FALSE,0,FALSE,16094,17711,956,21.9,TRUE,0,FALSE,15138,15713,-956,18.3
FALSE,FALSE,0,FALSE,15099,17734,-5206,15.6,TRUE,0,FALSE,20305,19356,5206,22.6
FALSE,FALSE,0,FALSE,14143,16647,-5891,18.3,TRUE,2,TRUE,20034,20363,5891,26.4
FALSE,FALSE,1,TRUE,14385,15780,-4413,19.5,TRUE,1,FALSE,18798,18889,4413,23.4
FALSE,FALSE,0,FALSE,14725,17291,-1680,20.4,TRUE,2,TRUE,16405,18446,1680,25.8
FALSE,FALSE,0,FALSE,16543,18558,192,24.5,TRUE,1,TRUE,16351,19214,-192,24.5
FALSE,FALSE,0,FALSE,14505,18139,-1183,23,TRUE,1,TRUE,15688,18321,1183,25.3
FALSE,TRUE,0,FALSE,16681,18270,1403,26.5,FALSE,0,FALSE,15278,17881,-1403,22.4
FALSE,TRUE,0,FALSE,15844,16801,-151,19.7,FALSE,2,TRUE,15995,17696,151,20.5
TRUE,TRUE,0,FALSE,15843,17530,380,23.3,FALSE,1,TRUE,15463,17775,-380,22.1
TRUE,TRUE,1,TRUE,17913,19102,3453,21.8,FALSE,0,FALSE,14460,17327,-3453,21.5
FALSE,FALSE,0,FALSE,15057,17267,-3443,21.8,TRUE,1,TRUE,18500,18614,3443,21.9
TRUE,TRUE,0,FALSE,14630,16527,-2167,17.7,FALSE,1,TRUE,16797,18572,2167,21.4
TRUE,TRUE,0,FALSE,16156,17794,152,26,FALSE,0,FALSE,16004,18516,-152,24.9
FALSE,FALSE,1,TRUE,13352,16455,-3059,18.8,TRUE,1,FALSE,16411,19173,3059,25.2
FALSE,TRUE,1,TRUE,16042,17865,-236,24,FALSE,0,FALSE,16278,17154,236,24.1
TRUE,FALSE,1,FALSE,15420,16996,-2178,17.6,TRUE,1,TRUE,17598,18403,2178,21.9
FALSE,FALSE,0,FALSE,15080,17979,-1267,26.2,TRUE,2,TRUE,16347,17552,1267,25.5
TRUE,FALSE,1,TRUE,15766,18750,-1035,23.2,TRUE,0,FALSE,16801,18168,1035,20.2
TRUE,TRUE,1,FALSE,20639,18457,4639,20.7,FALSE,1,TRUE,16000,15260,-4639,15.9
FALSE,FALSE,0,FALSE,13345,15982,-5508,23,TRUE,1,TRUE,18853,19630,5508,23.5
TRUE,FALSE,1,TRUE,17712,19043,2370,20.7,TRUE,0,FALSE,15342,15248,-2370,18.6
TRUE,TRUE,1,TRUE,18866,18926,3992,22.5,FALSE,0,FALSE,14874,16420,-3992,18.9
TRUE,TRUE,1,TRUE,19035,19997,2739,23.2,FALSE,1,FALSE,16296,18827,-2739,26.8
TRUE,FALSE,0,FALSE,15292,17170,-2513,22.3,TRUE,1,TRUE,17805,19417,2513,23.1
TRUE,TRUE,0,FALSE,15082,17854,1389,23.9,FALSE,1,TRUE,13693,16960,-1389,20.9
TRUE,FALSE,0,FALSE,15818,16894,-1492,16.2,TRUE,1,TRUE,17310,18819,1492,21.4
FALSE,TRUE,1,FALSE,18145,18705,-139,21.1,FALSE,1,TRUE,18284,19357,139,23.6
TRUE,TRUE,0,FALSE,15934,18258,943,25.1,FALSE,1,TRUE,14991,17753,-943,23.1
TRUE,TRUE,1,TRUE,17846,18097,2425,19.2,FALSE,1,FALSE,15421,17273,-2425,21.5
TRUE,TRUE,1,FALSE,17025,17699,1128,20.7,FALSE,1,TRUE,15897,17744,-1128,22.6
FALSE,FALSE,2,TRUE,17598,18935,1380,22.5,TRUE,0,FALSE,16218,17533,-1380,19.2
FALSE,TRUE,1,FALSE,16220,18251,688,23.9,FALSE,1,TRUE,15532,17836,-688,22.1
FALSE,FALSE,1,TRUE,18395,16701,2933,20.6,TRUE,0,FALSE,15462,14796,-2933,16.7
FALSE,FALSE,1,FALSE,15727,15909,-2467,17.1,TRUE,0,FALSE,18194,17403,2467,20.2
TRUE,FALSE,0,FALSE,15832,18431,755,25.7,TRUE,2,TRUE,15077,17995,-755,21.7
TRUE,TRUE,1,TRUE,18549,19419,4378,20.3,FALSE,0,FALSE,14171,16262,-4378,21.4
FALSE,TRUE,1,TRUE,16589,17707,-1302,22.1,FALSE,0,FALSE,17891,17797,1302,20.7
TRUE,TRUE,0,FALSE,14945,17524,-145,16.8,FALSE,1,TRUE,15090,16674,145,23.3
TRUE,TRUE,1,FALSE,19279,19873,4305,23,FALSE,1,TRUE,14974,16123,-4305,18.2
TRUE,FALSE,0,FALSE,15871,16394,-3162,20,TRUE,0,FALSE,19033,16417,3162,19.5
TRUE,FALSE,2,TRUE,18790,18604,1726,22.4,TRUE,0,FALSE,17064,18800,-1726,19.5
FALSE,TRUE,1,FALSE,16616,17642,350,18.2,FALSE,1,TRUE,16266,16953,-350,20.6
TRUE,FALSE,0,FALSE,15701,16610,-2760,18.6,TRUE,1,TRUE,18461,18884,2760,24.7
FALSE,FALSE,0,FALSE,17556,18967,805,21.4,TRUE,1,TRUE,16751,17244,-805,23
FALSE,FALSE,1,TRUE,13591,16284,-3754,20.1,TRUE,0,FALSE,17345,18655,3754,25.6
TRUE,TRUE,1,TRUE,17637,18484,2216,19.8,FALSE,1,FALSE,15421,17535,-2216,23.6
TRUE,TRUE,0,FALSE,17047,19573,3135,22.4,FALSE,1,TRUE,13912,17685,-3135,20.1
FALSE,FALSE,2,TRUE,17821,18702,1855,21.5,TRUE,0,FALSE,15966,17182,-1855,23.3
FALSE,TRUE,0,FALSE,15694,18079,-451,20.9,FALSE,1,TRUE,16145,17488,451,24.1
FALSE,TRUE,0,FALSE,16640,16726,-1939,22.2,FALSE,2,TRUE,18579,19637,1939,23.3
TRUE,FALSE,1,TRUE,16235,18651,584,26,TRUE,0,FALSE,15651,18281,-584,22.1
FALSE,FALSE,1,FALSE,14423,17518,-2911,18.8,TRUE,0,FALSE,17334,17804,2911,20.1
FALSE,FALSE,0,FALSE,15911,17205,-194,22.4,TRUE,0,FALSE,16105,18311,194,19.3
FALSE,FALSE,0,FALSE,14232,17038,-3082,18.6,TRUE,1,TRUE,17314,17684,3082,20.8
FALSE,TRUE,0,FALSE,15429,16825,-1480,22.7,FALSE,0,FALSE,16909,18191,1480,21.8
FALSE,FALSE,0,FALSE,14349,17864,-2289,19.9,TRUE,1,TRUE,16638,18141,2289,24.6
TRUE,FALSE,1,TRUE,17877,17302,-920,18.6,TRUE,1,FALSE,18797,18864,920,23.1
TRUE,FALSE,0,FALSE,15968,15868,-1912,14.5,TRUE,1,TRUE,17880,15887,1912,19.1
TRUE,TRUE,2,TRUE,17931,18404,-546,21,FALSE,0,FALSE,18477,18508,546,21.7
FALSE,FALSE,0,FALSE,17082,18101,188,22.3,TRUE,1,TRUE,16894,18599,-188,21.5
FALSE,FALSE,1,TRUE,17147,18525,-142,20.5,TRUE,1,FALSE,17289,19718,142,24.2
TRUE,TRUE,0,FALSE,18338,18468,3054,21.1,FALSE,1,TRUE,15284,15958,-3054,19
FALSE,FALSE,1,TRUE,15367,17109,-2572,21.4,TRUE,1,FALSE,17939,19751,2572,19.8
TRUE,TRUE,1,TRUE,14408,16534,-1147,21.2,FALSE,0,FALSE,15555,18376,1147,21.8
TRUE,TRUE,0,FALSE,14991,17977,-274,19.3,FALSE,1,TRUE,15265,18383,274,21.7
TRUE,FALSE,1,FALSE,16144,17907,2237,22.6,TRUE,0,FALSE,13907,16898,-2237,22.6
FALSE,TRUE,0,FALSE,15186,16381,-2666,20.4,FALSE,1,TRUE,17852,18353,2666,21.8
TRUE,TRUE,1,TRUE,17072,19087,1782,22.7,FALSE,0,FALSE,15290,17853,-1782,21.2
FALSE,TRUE,1,TRUE,15381,16972,-2545,24.9,FALSE,1,FALSE,17926,18932,2545,24.3
TRUE,FALSE,1,TRUE,13610,16594,-1817,19.9,TRUE,0,FALSE,15427,18448,1817,23.8
TRUE,TRUE,0,FALSE,16535,17582,443,23,FALSE,0,FALSE,16092,18758,-443,21.6
FALSE,FALSE,0,FALSE,15145,16768,-3472,20,TRUE,1,FALSE,18617,19827,3472,22.7
FALSE,FALSE,0,FALSE,15686,17245,-2594,19.5,TRUE,0,FALSE,18280,18395,2594,23.6
TRUE,TRUE,1,TRUE,17379,18458,1138,20,FALSE,0,FALSE,16241,18465,-1138,24.6
FALSE,TRUE,0,FALSE,18051,17921,-2224,20.1,FALSE,1,TRUE,20275,19929,2224,22.6
TRUE,FALSE,1,TRUE,16075,19032,597,25.1,TRUE,0,FALSE,15478,18473,-597,24.4
TRUE,TRUE,2,TRUE,14854,16846,-630,21.2,FALSE,0,FALSE,15484,17711,630,20.3
TRUE,TRUE,1,TRUE,15770,17426,669,22.9,FALSE,0,FALSE,15101,17909,-669,26.1
TRUE,FALSE,0,FALSE,16308,17911,-1464,19.9,TRUE,0,FALSE,17772,19486,1464,25
FALSE,FALSE,1,TRUE,15008,18344,-37,21.1,TRUE,0,FALSE,15045,17200,37,22.1
TRUE,FALSE,0,FALSE,15238,17288,-719,18.4,TRUE,0,FALSE,15957,16463,719,21.1
TRUE,TRUE,2,TRUE,15534,18339,-483,22.3,FALSE,0,FALSE,16017,18781,483,26.6
FALSE,TRUE,1,TRUE,16707,17154,-164,21.7,FALSE,0,FALSE,16871,16811,164,17.4
FALSE,FALSE,0,FALSE,17200,18695,1266,23.7,TRUE,1,TRUE,15934,18083,-1266,23.9
FALSE,FALSE,0,FALSE,14830,17313,-4299,22.1,TRUE,0,FALSE,19129,20323,4299,22.8
TRUE,TRUE,1,TRUE,16620,16713,1156,21.2,FALSE,1,FALSE,15464,16545,-1156,20
TRUE,TRUE,2,TRUE,17611,18390,3878,23.2,FALSE,0,FALSE,13733,15374,-3878,20.5
TRUE,FALSE,1,TRUE,17908,17505,1717,22,TRUE,1,FALSE,16191,16730,-1717,21.2
TRUE,TRUE,1,TRUE,17791,19243,2037,24.4,FALSE,0,FALSE,15754,16760,-2037,20.9
FALSE,FALSE,0,FALSE,15509,18064,-1098,23.5,TRUE,2,TRUE,16607,19030,1098,20.4
TRUE,TRUE,0,FALSE,16304,17893,-794,20.9,FALSE,0,FALSE,17098,18844,794,22
FALSE,TRUE,1,TRUE,16594,18266,611,21.7,FALSE,0,FALSE,15983,17976,-611,23.9
FALSE,FALSE,0,FALSE,14732,16332,-2749,18.6,TRUE,1,TRUE,17481,19667,2749,22.2
TRUE,FALSE,1,FALSE,17149,17767,-417,21.1,TRUE,1,TRUE,17566,18795,417,21.5
TRUE,TRUE,0,FALSE,18408,20063,4119,25,FALSE,2,TRUE,14289,17743,-4119,23.4
FALSE,FALSE,0,FALSE,14211,17270,-3051,23.2,TRUE,2,TRUE,17262,19384,3051,25
TRUE,TRUE,2,TRUE,15698,18088,-451,25.3,FALSE,0,FALSE,16149,19462,451,25.5
FALSE,TRUE,1,TRUE,15956,17062,-916,20,FALSE,0,FALSE,16872,18528,916,20.4
TRUE,TRUE,1,TRUE,20289,20144,7039,24.5,FALSE,0,FALSE,13250,15284,-7039,15.2
TRUE,FALSE,0,FALSE,16948,17861,-2581,20.7,TRUE,1,TRUE,19529,19165,2581,25.2
FALSE,FALSE,0,FALSE,15900,17743,-688,18.7,TRUE,1,TRUE,16588,17973,688,23.6
FALSE,FALSE,0,FALSE,15690,18165,-2802,22.3,TRUE,2,TRUE,18492,19771,2802,22.7
TRUE,TRUE,2,TRUE,17018,20337,1496,26.2,FALSE,0,FALSE,15522,18673,-1496,25.3
TRUE,TRUE,2,TRUE,19639,19616,2778,24.1,FALSE,0,FALSE,16861,18486,-2778,24
TRUE,TRUE,1,TRUE,16019,17728,-612,19.3,FALSE,0,FALSE,16631,17895,612,21.8
FALSE,FALSE,0,FALSE,14525,18541,-3207,21.4,TRUE,1,TRUE,17732,19868,3207,24.1
FALSE,FALSE,1,TRUE,14931,16059,-2698,19.9,TRUE,1,FALSE,17629,18517,2698,23.9
TRUE,TRUE,2,TRUE,20540,20655,6921,25.6,FALSE,0,FALSE,13619,16244,-6921,18.6
TRUE,TRUE,0,FALSE,14895,17420,773,23.6,FALSE,1,TRUE,14122,17100,-773,21.2
FALSE,FALSE,0,FALSE,14584,16269,-4788,19.8,TRUE,1,TRUE,19372,18839,4788,21.4
TRUE,TRUE,0,FALSE,15757,17869,603,22.9,FALSE,1,TRUE,15154,18330,-603,24.6
FALSE,TRUE,0,FALSE,16477,18750,435,19.8,FALSE,1,TRUE,16042,18186,-435,25.8
FALSE,TRUE,0,FALSE,15048,16614,384,18.2,FALSE,1,TRUE,14664,15742,-384,22.9
TRUE,TRUE,1,TRUE,17197,18431,2348,22.4,FALSE,0,FALSE,14849,17384,-2348,20.6
FALSE,FALSE,1,FALSE,16956,18758,314,22.3,TRUE,1,TRUE,16642,18147,-314,23.5
FALSE,TRUE,0,FALSE,14958,16928,-5089,18.4,FALSE,1,FALSE,20047,21818,5089,24.3
FALSE,FALSE,1,TRUE,17006,18416,-1682,24.5,TRUE,0,FALSE,18688,19569,1682,26
TRUE,TRUE,0,FALSE,19866,20339,3128,20.2,FALSE,0,FALSE,16738,17420,-3128,20.2
FALSE,TRUE,0,FALSE,15720,17660,-1862,18.7,FALSE,1,FALSE,17582,18986,1862,24
FALSE,FALSE,0,FALSE,17938,18477,-1415,15,TRUE,0,FALSE,19353,20303,1415,19.6
FALSE,TRUE,0,FALSE,17197,18196,1125,23.8,FALSE,0,FALSE,16072,18337,-1125,20.5
TRUE,FALSE,0,FALSE,14343,16877,-3049,20.9,TRUE,0,FALSE,17392,19097,3049,24.1
FALSE,FALSE,0,FALSE,14485,17588,-1422,23.3,TRUE,1,TRUE,15907,18449,1422,23.5
TRUE,FALSE,0,FALSE,17671,18649,2135,25,TRUE,1,TRUE,15536,17395,-2135,23.1
FALSE,FALSE,0,FALSE,15430,16509,-2763,20.7,TRUE,0,FALSE,18193,18390,2763,21.8
FALSE,TRUE,1,FALSE,15072,17479,-1247,23.3,FALSE,1,TRUE,16319,19799,1247,22.2
FALSE,FALSE,2,TRUE,13815,16570,-4898,21.9,TRUE,0,FALSE,18713,20306,4898,26.1
FALSE,FALSE,0,FALSE,17080,18513,-758,21.9,TRUE,1,TRUE,17838,19029,758,20.9
TRUE,FALSE,1,TRUE,17103,19263,2481,22.1,TRUE,0,FALSE,14622,17151,-2481,21
FALSE,TRUE,1,TRUE,18312,18057,1250,23.9,FALSE,1,FALSE,17062,18283,-1250,20.6
TRUE,TRUE,1,TRUE,15924,17965,961,21.1,FALSE,0,FALSE,14963,16851,-961,19.9
FALSE,FALSE,0,FALSE,15122,17880,-1740,21.6,TRUE,0,FALSE,16862,17926,1740,19.5
FALSE,FALSE,1,FALSE,18361,18709,1531,23.4,TRUE,1,TRUE,16830,17029,-1531,20.7
TRUE,TRUE,0,FALSE,15888,17305,-209,22.9,FALSE,1,TRUE,16097,18037,209,23.2
FALSE,FALSE,1,FALSE,15717,16971,-646,19.6,TRUE,1,TRUE,16363,17931,646,22.2
TRUE,TRUE,0,FALSE,19153,20631,4003,26.2,FALSE,1,TRUE,15150,17876,-4003,22.5
TRUE,FALSE,1,FALSE,17530,18078,2063,23.8,TRUE,0,FALSE,15467,16648,-2063,18.9
TRUE,TRUE,0,FALSE,18389,18618,5191,22.7,FALSE,0,FALSE,13198,14507,-5191,16.2
FALSE,TRUE,0,FALSE,17381,18931,2389,25.8,FALSE,1,TRUE,14992,18039,-2389,21.6
TRUE,FALSE,0,FALSE,15091,18237,-1516,21.5,TRUE,1,TRUE,16607,18678,1516,26.7
FALSE,FALSE,0,FALSE,15097,18355,-2575,22.3,TRUE,1,TRUE,17672,19337,2575,22.6
TRUE,TRUE,1,TRUE,16272,18613,1471,23.2,FALSE,0,FALSE,14801,17807,-1471,23.9
TRUE,FALSE,2,TRUE,16618,17861,-702,20.6,TRUE,0,FALSE,17320,17115,702,20.6
FALSE,FALSE,0,FALSE,14826,16327,-1635,22.2,TRUE,2,TRUE,16461,17871,1635,21
TRUE,TRUE,2,TRUE,19354,20036,5462,25.1,FALSE,0,FALSE,13892,16359,-5462,19.2
TRUE,TRUE,0,FALSE,17380,18705,2615,23.2,FALSE,0,FALSE,14765,16677,-2615,18.1
TRUE,TRUE,0,FALSE,16952,19223,790,23.9,FALSE,0,FALSE,16162,19140,-790,25.1
TRUE,TRUE,0,FALSE,16316,17968,1193,24.1,FALSE,0,FALSE,15123,16515,-1193,20.8
FALSE,FALSE,0,FALSE,13608,16690,-4785,22.9,TRUE,2,TRUE,18393,19919,4785,23.9
FALSE,TRUE,1,TRUE,16227,16987,-3055,19.7,FALSE,0,FALSE,19282,19659,3055,21.4
TRUE,TRUE,1,TRUE,16285,16278,-1655,18.3,FALSE,0,FALSE,17940,17286,1655,18.9
TRUE,TRUE,1,TRUE,19407,19360,1259,21.7,FALSE,0,FALSE,18148,18810,-1259,19.3
FALSE,FALSE,0,FALSE,17208,18713,-737,23.1,TRUE,0,FALSE,17945,18046,737,23.9
FALSE,TRUE,1,FALSE,15915,18778,-255,24.5,FALSE,1,TRUE,16170,19323,255,19.7
TRUE,TRUE,0,FALSE,19012,18944,2194,21,FALSE,0,FALSE,16818,17130,-2194,19.5
TRUE,TRUE,1,FALSE,20861,18819,5245,21.3,FALSE,0,FALSE,15616,16065,-5245,19.5
FALSE,TRUE,0,FALSE,16051,16995,-290,23.5,FALSE,1,TRUE,16341,18056,290,24.5
FALSE,FALSE,1,TRUE,16380,18331,-115,22.9,TRUE,1,FALSE,16495,17851,115,22.5
FALSE,TRUE,1,FALSE,15420,16188,-634,18.5,FALSE,1,TRUE,16054,17714,634,23.6
TRUE,TRUE,1,TRUE,18320,18926,3461,24.4,FALSE,0,FALSE,14859,16941,-3461,21.7
TRUE,TRUE,2,TRUE,16604,17994,867,24,FALSE,0,FALSE,15737,17574,-867,20.5
FALSE,FALSE,0,FALSE,15610,18203,-215,18.4,TRUE,0,FALSE,15825,18048,215,22.1
FALSE,TRUE,0,FALSE,17403,18532,1515,18.1,FALSE,1,TRUE,15888,17420,-1515,23.1
TRUE,FALSE,1,TRUE,16030,17738,-114,18,TRUE,0,FALSE,16144,17305,114,23.3
FALSE,FALSE,0,FALSE,14756,17221,-1942,21.7,TRUE,1,TRUE,16698,17628,1942,21.2
FALSE,FALSE,0,FALSE,14156,16075,-3906,17.7,TRUE,0,FALSE,18062,18584,3906,23.3
FALSE,TRUE,0,FALSE,16927,17042,-498,22.3,FALSE,0,FALSE,17425,17903,498,22.8
TRUE,TRUE,1,TRUE,17365,17243,2208,22.3,FALSE,0,FALSE,15157,17556,-2208,19.2
TRUE,TRUE,0,FALSE,15226,17774,-1667,16.8,FALSE,0,FALSE,16893,18428,1667,22.7
FALSE,FALSE,0,FALSE,17123,17730,1110,19,TRUE,1,TRUE,16013,16756,-1110,16.1
FALSE,FALSE,1,TRUE,14663,17795,-1984,20.6,TRUE,0,FALSE,16647,18510,1984,20.5
FALSE,TRUE,1,FALSE,17897,19344,1692,21.7,FALSE,1,TRUE,16205,17346,-1692,20.6
FALSE,FALSE,0,FALSE,13418,13877,-5710,17.5,TRUE,2,TRUE,19128,18829,5710,21.3
FALSE,FALSE,1,FALSE,15928,17872,806,19.5,TRUE,1,TRUE,15122,17501,-806,20
FALSE,FALSE,1,FALSE,15111,17710,-3620,21,TRUE,1,TRUE,18731,20400,3620,23.6
TRUE,TRUE,0,FALSE,17101,18836,3056,23.7,FALSE,0,FALSE,14045,17031,-3056,19.4
TRUE,FALSE,1,TRUE,17194,19279,2562,20,TRUE,0,FALSE,14632,16263,-2562,18.4
TRUE,TRUE,1,FALSE,16565,17877,824,21.4,FALSE,1,TRUE,15741,17356,-824,21.2
FALSE,FALSE,1,TRUE,16943,17157,-1074,20.8,TRUE,1,FALSE,18017,18789,1074,22.9
TRUE,TRUE,1,TRUE,17568,19108,1975,24.1,FALSE,0,FALSE,15593,18306,-1975,22.9
FALSE,FALSE,0,FALSE,17250,18763,86,20.6,TRUE,2,TRUE,17164,18296,-86,19.7
TRUE,TRUE,1,FALSE,16559,17552,1928,21.6,FALSE,1,TRUE,14631,17295,-1928,24.8
FALSE,FALSE,0,FALSE,14351,17173,-982,21.8,TRUE,1,TRUE,15333,18787,982,21.9
FALSE,TRUE,0,FALSE,14735,16525,-1751,23.6,FALSE,0,FALSE,16486,19055,1751,22.3
TRUE,TRUE,2,TRUE,18070,19270,3828,23.5,FALSE,0,FALSE,14242,16823,-3828,21.4
FALSE,TRUE,1,TRUE,15449,17026,423,20.6,FALSE,0,FALSE,15026,17341,-423,25.4
TRUE,TRUE,0,FALSE,17581,18639,1839,24.3,FALSE,1,TRUE,15742,18327,-1839,22.1
FALSE,FALSE,1,FALSE,15505,18109,-875,21.5,TRUE,1,TRUE,16380,18472,875,23.2
TRUE,TRUE,0,FALSE,16873,17879,375,21.5,FALSE,1,TRUE,16498,17583,-375,20.2
FALSE,FALSE,0,FALSE,14755,15569,-4095,21.3,TRUE,1,TRUE,18850,16602,4095,19.9
TRUE,TRUE,0,FALSE,18081,18813,2273,20.7,FALSE,0,FALSE,15808,17099,-2273,22
TRUE,FALSE,0,FALSE,15791,17342,-1892,19.2,TRUE,0,FALSE,17683,17922,1892,20.5
FALSE,FALSE,1,TRUE,13480,16396,-3137,21.5,TRUE,0,FALSE,16617,18493,3137,23.3
TRUE,TRUE,0,FALSE,17946,18778,2401,20.4,FALSE,0,FALSE,15545,18051,-2401,18.7
TRUE,FALSE,1,TRUE,17754,18278,292,19.5,TRUE,1,FALSE,17462,17252,-292,19
TRUE,FALSE,0,FALSE,16172,17632,-1460,22.1,TRUE,1,TRUE,17632,18766,1460,22.3
FALSE,TRUE,0,FALSE,14828,18414,-507,23.7,FALSE,1,TRUE,15335,18071,507,26
TRUE,FALSE,0,FALSE,16589,18188,-3242,18.8,TRUE,1,TRUE,19831,19138,3242,25.3
TRUE,FALSE,0,FALSE,15521,17703,-1079,21,TRUE,1,TRUE,16600,17470,1079,21.5
TRUE,TRUE,1,TRUE,16198,17866,1873,22.6,FALSE,0,FALSE,14325,15879,-1873,17.9
FALSE,FALSE,0,FALSE,13125,15273,-4596,16.7,TRUE,1,TRUE,17721,18088,4596,24.3
TRUE,FALSE,1,TRUE,16065,17018,1322,20,TRUE,0,FALSE,14743,16870,-1322,21.3
TRUE,TRUE,0,FALSE,16940,17909,566,24.6,FALSE,0,FALSE,16374,17966,-566,21.9
FALSE,TRUE,1,FALSE,17655,16585,-134,20.3,FALSE,1,TRUE,17789,18103,134,21.7
FALSE,TRUE,1,TRUE,16707,17380,-724,19.3,FALSE,0,FALSE,17431,16130,724,21.6
FALSE,FALSE,0,FALSE,15214,17796,-3709,17.1,TRUE,0,FALSE,18923,19431,3709,22.8
TRUE,TRUE,0,FALSE,19835,19690,4675,22.3,FALSE,1,TRUE,15160,16636,-4675,16.9
TRUE,FALSE,0,FALSE,14289,17513,-1222,24.6,TRUE,2,TRUE,15511,18387,1222,24.8
FALSE,TRUE,1,TRUE,16846,19790,2487,22.4,FALSE,0,FALSE,14359,17827,-2487,22.3
FALSE,FALSE,1,FALSE,15488,17274,-4858,19.6,TRUE,1,TRUE,20346,18905,4858,21.4
TRUE,TRUE,0,FALSE,16855,17721,-1678,21.8,FALSE,1,TRUE,18533,18680,1678,23.2
TRUE,FALSE,1,TRUE,16660,19188,785,21.7,TRUE,0,FALSE,15875,17749,-785,20
FALSE,TRUE,1,TRUE,18611,20169,2819,22.5,FALSE,0,FALSE,15792,16947,-2819,21.1
FALSE,FALSE,1,FALSE,18233,19767,363,25.6,TRUE,1,TRUE,17870,20300,-363,23.9
FALSE,TRUE,1,FALSE,16616,17450,930,21.5,FALSE,0,FALSE,15686,15439,-930,16.8
TRUE,FALSE,0,FALSE,16107,17763,-621,23.1,TRUE,1,TRUE,16728,17786,621,21.6
TRUE,TRUE,0,FALSE,16674,17188,111,20.4,FALSE,2,TRUE,16563,17387,-111,22.1
TRUE,TRUE,1,TRUE,16671,17285,2644,21.6,FALSE,1,FALSE,14027,15885,-2644,22.8
TRUE,FALSE,1,TRUE,17261,18577,1704,21.9,TRUE,0,FALSE,15557,16554,-1704,18.2
TRUE,FALSE,2,TRUE,16886,18724,2881,24.2,TRUE,0,FALSE,14005,16719,-2881,18.6
FALSE,TRUE,2,TRUE,18226,18871,1063,21.1,FALSE,0,FALSE,17163,17718,-1063,22.9
TRUE,TRUE,1,TRUE,18136,18077,649,19.4,FALSE,0,FALSE,17487,17734,-649,23.9
FALSE,TRUE,1,FALSE,14712,17631,-132,25.3,FALSE,1,TRUE,14844,19104,132,26.4
TRUE,TRUE,1,FALSE,16420,18391,-1250,22.4,FALSE,1,TRUE,17670,19425,1250,23.9
TRUE,FALSE,0,FALSE,17678,17263,-1213,19,TRUE,1,TRUE,18891,16415,1213,18.2
FALSE,FALSE,0,FALSE,17126,17604,1386,19.5,TRUE,1,TRUE,15740,16925,-1386,20.2
FALSE,FALSE,0,FALSE,15001,16275,-5120,20.5,TRUE,1,FALSE,20121,20286,5120,23.3
FALSE,TRUE,0,FALSE,15416,18403,-2219,21.4,FALSE,2,TRUE,17635,19080,2219,23.7
FALSE,TRUE,0,FALSE,15177,16094,-2399,20.6,FALSE,1,TRUE,17576,18411,2399,24.3
FALSE,TRUE,0,FALSE,15853,18455,20,22.9,FALSE,1,TRUE,15833,19837,-20,23.2
FALSE,FALSE,1,TRUE,17513,18498,834,23.4,TRUE,0,FALSE,16679,17637,-834,21.5
FALSE,FALSE,0,FALSE,16345,17692,-1208,20.6,TRUE,2,TRUE,17553,17905,1208,22.3
FALSE,FALSE,0,FALSE,14826,16490,-2907,17.6,TRUE,1,TRUE,17733,19879,2907,22.9
FALSE,TRUE,0,FALSE,16440,17181,-635,19.7,FALSE,1,TRUE,17075,18630,635,24.6
TRUE,TRUE,1,TRUE,16571,18893,1749,25.8,FALSE,0,FALSE,14822,17623,-1749,23.2
FALSE,FALSE,0,FALSE,15928,17242,-2760,20.4,TRUE,1,TRUE,18688,19191,2760,23.3
FALSE,TRUE,1,FALSE,17759,18043,-695,24.6,FALSE,0,FALSE,18454,20202,695,21.4
TRUE,FALSE,0,FALSE,13995,17605,-1171,17.6,TRUE,1,TRUE,15166,18459,1171,21.8
TRUE,TRUE,1,FALSE,16607,17949,-1001,22.3,FALSE,1,TRUE,17608,18492,1001,22.9
TRUE,FALSE,1,TRUE,22173,20408,7154,23.4,TRUE,1,FALSE,15019,14376,-7154,18.9
FALSE,FALSE,0,FALSE,14114,17331,-3063,21.5,TRUE,1,TRUE,17177,19345,3063,22.7
TRUE,FALSE,2,TRUE,18704,20796,3917,26,TRUE,0,FALSE,14787,18600,-3917,21.6
TRUE,TRUE,0,FALSE,18236,19626,3586,23.4,FALSE,0,FALSE,14650,16195,-3586,22.1
FALSE,FALSE,0,FALSE,15437,17811,-2205,19.5,TRUE,1,TRUE,17642,19119,2205,27
FALSE,FALSE,1,TRUE,15842,17223,-3572,21.6,TRUE,0,FALSE,19414,18553,3572,22.5
TRUE,FALSE,1,TRUE,16476,17137,896,22.5,TRUE,1,FALSE,15580,17277,-896,22.7
TRUE,FALSE,1,FALSE,17075,17360,399,19.8,TRUE,1,TRUE,16676,17542,-399,21.9
TRUE,TRUE,1,TRUE,18327,18553,2980,21.9,FALSE,0,FALSE,15347,16688,-2980,23.3
FALSE,FALSE,0,FALSE,15432,17869,-2228,22.5,TRUE,1,TRUE,17660,18614,2228,24.7
FALSE,FALSE,0,FALSE,14510,17801,-1456,24.7,TRUE,2,TRUE,15966,18052,1456,25.2
FALSE,FALSE,1,TRUE,14426,17051,-2709,21,TRUE,0,FALSE,17135,18519,2709,23.9
TRUE,FALSE,1,TRUE,19632,18732,4648,22.2,TRUE,0,FALSE,14984,16234,-4648,18.1
TRUE,FALSE,1,TRUE,17923,17698,-37,18.9,TRUE,0,FALSE,17960,17798,37,20.2
TRUE,TRUE,0,FALSE,16297,17730,1772,23.7,FALSE,0,FALSE,14525,16475,-1772,20.2
TRUE,TRUE,0,FALSE,20026,19142,6773,24.6,FALSE,1,TRUE,13253,13927,-6773,14.8
FALSE,TRUE,1,TRUE,15926,16415,-299,24.7,FALSE,0,FALSE,16225,18304,299,23
TRUE,FALSE,1,TRUE,15579,18054,-2227,20.3,TRUE,1,FALSE,17806,19131,2227,25.4
TRUE,FALSE,0,FALSE,15270,18043,-1429,23.5,TRUE,0,FALSE,16699,17003,1429,20.4
FALSE,FALSE,1,TRUE,15994,18031,-2519,22.9,TRUE,0,FALSE,18513,19641,2519,23.8
FALSE,TRUE,0,FALSE,16064,18651,1117,24.7,FALSE,2,TRUE,14947,18179,-1117,22.9
TRUE,TRUE,1,TRUE,16796,16424,700,18.5,FALSE,0,FALSE,16096,15203,-700,17.5
TRUE,FALSE,0,FALSE,15553,15768,-977,20.3,TRUE,2,TRUE,16530,17948,977,22.2
FALSE,FALSE,0,FALSE,14838,15075,-6265,18,TRUE,1,FALSE,21103,18593,6265,19.4
TRUE,FALSE,0,FALSE,15506,17801,-154,22.9,TRUE,1,TRUE,15660,17138,154,22.2
FALSE,FALSE,0,FALSE,16531,19310,-1114,22.6,TRUE,1,TRUE,17645,19708,1114,19.9
FALSE,TRUE,0,FALSE,16000,16324,-2111,19,FALSE,0,FALSE,18111,19199,2111,22.1
FALSE,FALSE,0,FALSE,16281,17569,-2082,20.9,TRUE,1,TRUE,18363,19694,2082,20.6
TRUE,TRUE,1,TRUE,17442,17426,153,23.6,FALSE,0,FALSE,17289,17945,-153,22.6
TRUE,TRUE,1,FALSE,18692,19767,2830,24.8,FALSE,0,FALSE,15862,18178,-2830,21
TRUE,FALSE,1,TRUE,17028,18519,1761,23.5,TRUE,1,FALSE,15267,16222,-1761,17.7
FALSE,FALSE,1,TRUE,13787,17848,-2153,22.5,TRUE,0,FALSE,15940,19192,2153,23.7
TRUE,FALSE,2,TRUE,17956,18251,4594,27.1,TRUE,0,FALSE,13362,15506,-4594,18.7
FALSE,FALSE,1,TRUE,15476,17429,-781,23.7,TRUE,1,FALSE,16257,18988,781,22.7
TRUE,FALSE,2,TRUE,15875,18309,455,23.4,TRUE,0,FALSE,15420,17004,-455,23.3
TRUE,TRUE,2,TRUE,17030,17359,-493,20.6,FALSE,0,FALSE,17523,18345,493,18.6
FALSE,FALSE,0,FALSE,14719,16759,-2418,21.4,TRUE,0,FALSE,17137,19014,2418,24
TRUE,FALSE,1,FALSE,17617,17519,241,19.9,TRUE,1,TRUE,17376,17212,-241,21.4
FALSE,TRUE,1,FALSE,16457,18669,1023,22.9,FALSE,0,FALSE,15434,16915,-1023,21.9
FALSE,TRUE,0,FALSE,15885,16674,-75,20.3,FALSE,2,TRUE,15960,18240,75,21.1
TRUE,TRUE,1,FALSE,19107,20103,3799,23,FALSE,0,FALSE,15308,17247,-3799,21
TRUE,FALSE,0,FALSE,16507,16273,1114,21.2,TRUE,0,FALSE,15393,17567,-1114,22.1
TRUE,FALSE,1,TRUE,16538,18707,1585,23.5,TRUE,0,FALSE,14953,17359,-1585,18.9
FALSE,FALSE,0,FALSE,15067,15937,-2968,18.6,TRUE,1,TRUE,18035,19273,2968,21.4
FALSE,TRUE,0,FALSE,16571,15773,-1624,17.8,FALSE,0,FALSE,18195,18777,1624,20.7
FALSE,FALSE,0,FALSE,16530,19242,-1347,23.1,TRUE,1,TRUE,17877,20675,1347,23.1
TRUE,FALSE,1,TRUE,16239,18439,36,20.3,TRUE,0,FALSE,16203,18673,-36,22.4
FALSE,TRUE,0,FALSE,16624,18473,115,20.8,FALSE,2,TRUE,16509,18729,-115,23.9
FALSE,FALSE,1,TRUE,15890,16536,-3280,20.1,TRUE,1,FALSE,19170,18837,3280,22.3
TRUE,TRUE,0,FALSE,18957,19663,2842,22.2,FALSE,1,TRUE,16115,18004,-2842,23.8
TRUE,FALSE,1,TRUE,18307,19247,3223,22.8,TRUE,0,FALSE,15084,16443,-3223,19.8
TRUE,FALSE,2,TRUE,16394,20016,1447,26.4,TRUE,0,FALSE,14947,18263,-1447,22.7
TRUE,FALSE,1,FALSE,15096,15306,-2483,21.2,TRUE,1,TRUE,17579,17002,2483,14.4
TRUE,TRUE,1,TRUE,15200,17127,662,23,FALSE,0,FALSE,14538,17094,-662,20.2
TRUE,FALSE,1,TRUE,14684,16985,-2212,21.7,TRUE,0,FALSE,16896,18651,2212,25.8
TRUE,TRUE,1,TRUE,16228,16387,-412,19.4,FALSE,0,FALSE,16640,16365,412,20.8
TRUE,TRUE,1,TRUE,18101,19775,1645,21.3,FALSE,0,FALSE,16456,18286,-1645,18.7
FALSE,TRUE,1,FALSE,21055,19573,6744,21.9,FALSE,1,TRUE,14311,14218,-6744,16.6
FALSE,TRUE,0,FALSE,13933,16078,-2215,19.9,FALSE,2,TRUE,16148,17957,2215,21.2
TRUE,TRUE,1,FALSE,19497,18445,3611,22.1,FALSE,0,FALSE,15886,15598,-3611,16.5
TRUE,FALSE,0,FALSE,15236,18474,-297,23.6,TRUE,1,TRUE,15533,17926,297,20.5
FALSE,TRUE,1,TRUE,16700,18574,1928,24.2,FALSE,0,FALSE,14772,17277,-1928,24.3
TRUE,TRUE,2,TRUE,16506,17981,2663,21.3,FALSE,0,FALSE,13843,17117,-2663,22.4
TRUE,TRUE,1,TRUE,16482,16880,1086,22.2,FALSE,0,FALSE,15396,16124,-1086,21.2
TRUE,FALSE,0,FALSE,15694,17920,764,24.1,TRUE,1,TRUE,14930,17949,-764,22.1
TRUE,TRUE,1,FALSE,16276,17562,-1216,19.5,FALSE,0,FALSE,17492,18191,1216,21
FALSE,FALSE,1,FALSE,18331,18445,-1572,18.1,TRUE,1,TRUE,19903,18653,1572,22.8
TRUE,TRUE,1,TRUE,17347,18131,2547,23,FALSE,0,FALSE,14800,16745,-2547,20.8
FALSE,FALSE,0,FALSE,15090,18031,-1931,23.8,TRUE,1,TRUE,17021,18330,1931,22
TRUE,TRUE,1,FALSE,17799,18078,-333,19,FALSE,1,TRUE,18132,18437,333,24.1
FALSE,TRUE,0,FALSE,15694,16853,-3531,20.2,FALSE,1,TRUE,19225,19502,3531,26.5
TRUE,TRUE,0,FALSE,17269,19988,3425,24.4,FALSE,1,TRUE,13844,16165,-3425,22.8
TRUE,FALSE,1,TRUE,16662,18914,619,23.7,TRUE,0,FALSE,16043,18879,-619,21.2
FALSE,TRUE,0,FALSE,17292,18087,-689,23.8,FALSE,1,TRUE,17981,18353,689,21.4
FALSE,FALSE,1,FALSE,14772,17784,-2395,21.4,TRUE,1,TRUE,17167,19957,2395,25.8
FALSE,TRUE,1,FALSE,15157,16829,-1082,22.8,FALSE,1,TRUE,16239,18648,1082,22.9
TRUE,TRUE,0,FALSE,16124,17018,-467,19.2,FALSE,2,TRUE,16591,17104,467,21.1
TRUE,FALSE,1,FALSE,17881,19560,3135,25.7,TRUE,0,FALSE,14746,17194,-3135,20.1
TRUE,TRUE,2,TRUE,17676,17633,1209,18.6,FALSE,0,FALSE,16467,16614,-1209,18.9
FALSE,FALSE,1,TRUE,15809,17675,-1462,21.4,TRUE,1,FALSE,17271,19508,1462,23.2
FALSE,TRUE,1,TRUE,16960,17503,-60,21.5,FALSE,1,FALSE,17020,17493,60,22.2
FALSE,TRUE,0,FALSE,15372,17983,-6,23.4,FALSE,1,TRUE,15378,19729,6,23.6
FALSE,TRUE,1,TRUE,16527,16884,-233,19.4,FALSE,1,FALSE,16760,17638,233,19.7
TRUE,TRUE,0,FALSE,17774,18689,4232,22.6,FALSE,0,FALSE,13542,17188,-4232,21.8
TRUE,FALSE,1,FALSE,16074,17776,-283,23.7,TRUE,0,FALSE,16357,18260,283,22
FALSE,FALSE,2,TRUE,15612,17678,1518,23.4,TRUE,0,FALSE,14094,16470,-1518,21.3
FALSE,TRUE,0,FALSE,16759,15499,-4236,16.3,FALSE,1,TRUE,20995,19710,4236,18.7
FALSE,TRUE,1,TRUE,14911,16715,-224,22.8,FALSE,0,FALSE,15135,18657,224,24.8
TRUE,FALSE,1,TRUE,16980,18629,-53,21.8,TRUE,0,FALSE,17033,18070,53,24
FALSE,TRUE,0,FALSE,15776,17726,969,26.1,FALSE,1,TRUE,14807,16163,-969,20.7
FALSE,FALSE,0,FALSE,14961,17673,-2090,21.5,TRUE,1,TRUE,17051,18589,2090,23.9
TRUE,FALSE,1,TRUE,16031,18664,687,22.3,TRUE,0,FALSE,15344,18154,-687,25.4
TRUE,FALSE,1,TRUE,16313,18652,-152,24.2,TRUE,0,FALSE,16465,19189,152,21.3
FALSE,TRUE,1,FALSE,15964,18133,-68,21.7,FALSE,1,TRUE,16032,17170,68,19.8
TRUE,FALSE,1,TRUE,20541,19687,2368,26,TRUE,0,FALSE,18173,17920,-2368,16.9
FALSE,FALSE,1,TRUE,17415,16774,2791,23.2,TRUE,0,FALSE,14624,14863,-2791,20.5
FALSE,FALSE,1,TRUE,16878,17994,-2636,18.5,TRUE,1,FALSE,19514,19384,2636,22.7
TRUE,TRUE,1,TRUE,15901,16965,324,21.3,FALSE,0,FALSE,15577,17374,-324,20.7
TRUE,TRUE,1,TRUE,16040,17697,-572,23.5,FALSE,0,FALSE,16612,17662,572,22.1
TRUE,FALSE,1,TRUE,18140,20250,2793,20.4,TRUE,0,FALSE,15347,16926,-2793,22.2
TRUE,TRUE,1,TRUE,17229,18401,354,19.1,FALSE,0,FALSE,16875,17665,-354,20.2
TRUE,TRUE,1,FALSE,15916,17531,73,23.7,FALSE,1,TRUE,15843,18337,-73,23.8
FALSE,TRUE,1,TRUE,15452,18378,-1039,19.1,FALSE,1,FALSE,16491,17551,1039,21.5
TRUE,FALSE,0,FALSE,15999,17524,-1189,20.3,TRUE,1,TRUE,17188,19265,1189,22.4
FALSE,FALSE,0,FALSE,14399,17167,-3656,22.1,TRUE,0,FALSE,18055,20033,3656,23.2
FALSE,FALSE,1,TRUE,13449,16281,-4357,20.5,TRUE,0,FALSE,17806,21240,4357,22.6
FALSE,FALSE,1,TRUE,13876,16521,-3248,17.5,TRUE,0,FALSE,17124,18227,3248,19.4
FALSE,TRUE,0,FALSE,15776,16537,-3587,20.9,FALSE,2,TRUE,19363,19398,3587,19.7
FALSE,TRUE,1,TRUE,15282,17671,-35,23.2,FALSE,0,FALSE,15317,17354,35,20.6
FALSE,FALSE,1,TRUE,14258,16594,-3903,19.8,TRUE,0,FALSE,18161,19110,3903,26.1
FALSE,FALSE,0,FALSE,14316,16505,-4885,21.4,TRUE,2,TRUE,19201,19226,4885,24.9
TRUE,TRUE,0,FALSE,15482,17584,36,24.3,FALSE,2,TRUE,15446,18512,-36,22.6
FALSE,TRUE,0,FALSE,16402,18713,1678,25,FALSE,1,TRUE,14724,16856,-1678,17.3
FALSE,TRUE,1,TRUE,18822,18319,2830,22.4,FALSE,1,FALSE,15992,16714,-2830,19.5
TRUE,TRUE,0,FALSE,17702,18597,1741,21.6,FALSE,0,FALSE,15961,17922,-1741,21.1
FALSE,FALSE,0,FALSE,16178,19240,-183,25.8,TRUE,1,TRUE,16361,18983,183,22.6
FALSE,FALSE,0,FALSE,15897,18190,485,22.6,TRUE,0,FALSE,15412,17332,-485,23.8
TRUE,FALSE,0,FALSE,16248,19928,131,20.4,TRUE,0,FALSE,16117,18721,-131,21.1
FALSE,FALSE,1,FALSE,15797,18289,-1234,22.6,TRUE,1,TRUE,17031,18263,1234,22.2
TRUE,FALSE,0,FALSE,15678,17696,-596,21.1,TRUE,0,FALSE,16274,16922,596,22.3
TRUE,TRUE,1,TRUE,16006,17612,-1493,23.3,FALSE,0,FALSE,17499,18878,1493,24.7
TRUE,FALSE,1,TRUE,16590,18656,-283,25.1,TRUE,0,FALSE,16873,18572,283,20.8
FALSE,FALSE,1,FALSE,14939,15632,-798,18.9,TRUE,1,TRUE,15737,17050,798,21
FALSE,FALSE,1,TRUE,16787,18246,-240,24.8,TRUE,1,FALSE,17027,18940,240,21.6
TRUE,FALSE,0,FALSE,17388,19549,1994,25,TRUE,1,TRUE,15394,19319,-1994,20.5
FALSE,TRUE,0,FALSE,14868,17736,-539,25.7,FALSE,1,FALSE,15407,18588,539,24.3
FALSE,FALSE,0,FALSE,15676,17248,-703,26.7,TRUE,1,TRUE,16379,18464,703,22.4
FALSE,FALSE,0,FALSE,14230,17035,-2647,23.2,TRUE,2,TRUE,16877,18907,2647,25.4
TRUE,FALSE,0,FALSE,16981,17309,384,21.4,TRUE,2,TRUE,16597,17774,-384,22.4
FALSE,TRUE,0,FALSE,16374,15811,1057,15.2,FALSE,1,TRUE,15317,15954,-1057,19.6
FALSE,TRUE,0,FALSE,17227,18842,1687,21.8,FALSE,1,TRUE,15540,16802,-1687,20.5
TRUE,TRUE,0,FALSE,16631,19270,2088,23.4,FALSE,1,TRUE,14543,17496,-2088,20.9
FALSE,FALSE,0,FALSE,15888,18144,-149,21.8,TRUE,1,TRUE,16037,17499,149,20.4
FALSE,FALSE,0,FALSE,15688,17439,-1434,23.9,TRUE,1,FALSE,17122,18861,1434,23.7
FALSE,TRUE,0,FALSE,16462,17215,-922,22.3,FALSE,2,TRUE,17384,18520,922,22.7
FALSE,FALSE,2,TRUE,14548,17158,-2408,20.4,TRUE,0,FALSE,16956,19483,2408,25.3
TRUE,FALSE,1,TRUE,18128,18825,1851,20.5,TRUE,0,FALSE,16277,16817,-1851,21.1
TRUE,FALSE,0,FALSE,15162,17438,-3051,22,TRUE,2,TRUE,18213,19636,3051,25
TRUE,TRUE,0,FALSE,14767,16585,-1233,23,FALSE,1,TRUE,16000,18035,1233,19.3
FALSE,TRUE,1,TRUE,17384,18198,3390,20.2,FALSE,0,FALSE,13994,16108,-3390,20.1
FALSE,FALSE,1,FALSE,16159,16943,1656,20.8,TRUE,0,FALSE,14503,15645,-1656,20
FALSE,FALSE,0,FALSE,13046,15452,-2264,19.7,TRUE,0,FALSE,15310,16416,2264,22.2
FALSE,FALSE,0,FALSE,15459,18187,-2483,24.3,TRUE,2,TRUE,17942,20081,2483,25.4
FALSE,FALSE,0,FALSE,13886,14445,-4582,17.8,TRUE,2,TRUE,18468,18039,4582,21
FALSE,FALSE,1,FALSE,15928,17865,-1938,20.6,TRUE,1,TRUE,17866,19858,1938,24.4
FALSE,TRUE,1,FALSE,14687,17701,-668,23.4,FALSE,0,FALSE,15355,18001,668,25.5
TRUE,TRUE,1,FALSE,17146,19051,954,24,FALSE,1,TRUE,16192,17897,-954,21.2
TRUE,TRUE,1,TRUE,19814,20713,5468,22.4,FALSE,0,FALSE,14346,15191,-5468,19.7
FALSE,FALSE,0,FALSE,17945,19818,209,20.6,TRUE,1,TRUE,17736,18171,-209,19.6
FALSE,FALSE,1,FALSE,16646,18530,2352,22.6,TRUE,1,TRUE,14294,17528,-2352,21
FALSE,TRUE,0,FALSE,17604,17925,1538,19.4,FALSE,1,TRUE,16066,16807,-1538,16.8
FALSE,FALSE,0,FALSE,16089,17265,-490,19.8,TRUE,1,TRUE,16579,17482,490,22.9
FALSE,FALSE,1,TRUE,15544,15313,-4625,17.6,TRUE,1,FALSE,20169,18760,4625,23.9
FALSE,FALSE,0,FALSE,17434,17974,-3478,18.8,TRUE,1,TRUE,20912,20001,3478,19.6
FALSE,TRUE,0,FALSE,15945,18619,405,20.4,FALSE,0,FALSE,15540,18132,-405,23.6
FALSE,FALSE,0,FALSE,15692,17807,-560,23.4,TRUE,1,TRUE,16252,17331,560,19.9
TRUE,TRUE,1,TRUE,17469,18286,2278,20.6,FALSE,0,FALSE,15191,16098,-2278,17.4
FALSE,TRUE,0,FALSE,16314,16894,-2665,25,FALSE,2,TRUE,18979,17794,2665,20
TRUE,TRUE,0,FALSE,16299,17994,1049,23.4,FALSE,0,FALSE,15250,18285,-1049,24
FALSE,FALSE,1,TRUE,15844,16971,-2270,20.9,TRUE,0,FALSE,18114,19004,2270,24.3
FALSE,FALSE,0,FALSE,15856,18029,295,22.4,TRUE,0,FALSE,15561,17399,-295,17.3
FALSE,TRUE,0,FALSE,15967,17065,-2162,21.7,FALSE,0,FALSE,18129,19318,2162,22.4
FALSE,TRUE,0,FALSE,15236,17761,194,19.6,FALSE,1,TRUE,15042,17618,-194,25.4
FALSE,FALSE,0,FALSE,12941,15085,-5519,17.8,TRUE,2,TRUE,18460,20606,5519,25.3
TRUE,FALSE,1,TRUE,17513,16367,332,17.4,TRUE,0,FALSE,17181,16567,-332,20.9
TRUE,FALSE,2,TRUE,16700,19019,1039,21.8,TRUE,0,FALSE,15661,17390,-1039,24.8
FALSE,TRUE,0,FALSE,18038,17959,3107,24.1,FALSE,1,TRUE,14931,15736,-3107,15.4
TRUE,FALSE,0,FALSE,15491,15893,-2183,19.4,TRUE,0,FALSE,17674,17903,2183,22.4
FALSE,FALSE,0,FALSE,16090,16407,-4191,18.2,TRUE,1,TRUE,20281,19268,4191,21.9
TRUE,FALSE,1,TRUE,17204,18534,1072,23.6,TRUE,0,FALSE,16132,16947,-1072,22.2
TRUE,TRUE,2,TRUE,15032,18187,-1920,20.7,FALSE,0,FALSE,16952,18550,1920,24.6
FALSE,TRUE,0,FALSE,17739,16482,377,21.5,FALSE,2,TRUE,17362,17079,-377,19.7
FALSE,TRUE,1,TRUE,16894,17233,-1529,20.3,FALSE,1,FALSE,18423,17151,1529,23.2
FALSE,FALSE,0,FALSE,14944,17906,-2150,23.7,TRUE,1,TRUE,17094,19224,2150,24.1
FALSE,TRUE,0,FALSE,14623,16060,-1585,20,FALSE,1,TRUE,16208,18366,1585,25.3
FALSE,FALSE,0,FALSE,15278,17274,-3315,21.9,TRUE,1,FALSE,18593,18915,3315,22.7
FALSE,TRUE,0,FALSE,17126,19205,2361,24.9,FALSE,2,TRUE,14765,17403,-2361,23
FALSE,FALSE,1,TRUE,15494,17574,-2846,21.1,TRUE,0,FALSE,18340,19613,2846,21.3
TRUE,TRUE,1,FALSE,16904,18744,406,24.5,FALSE,1,TRUE,16498,17962,-406,21
TRUE,FALSE,0,FALSE,17214,18948,2045,24.4,TRUE,1,TRUE,15169,17010,-2045,22
TRUE,TRUE,0,FALSE,16352,18600,209,23,FALSE,1,FALSE,16143,18606,-209,24.3
FALSE,FALSE,0,FALSE,14696,16517,-2688,20.2,TRUE,1,TRUE,17384,17689,2688,21.2
TRUE,TRUE,0,FALSE,15392,17929,-982,22.2,FALSE,1,TRUE,16374,19542,982,23.4
TRUE,TRUE,1,TRUE,15928,19109,1468,26.6,FALSE,0,FALSE,14460,17904,-1468,22.8
TRUE,TRUE,0,FALSE,18417,19926,3910,23.1,FALSE,2,TRUE,14507,16526,-3910,20.6
TRUE,FALSE,0,FALSE,14981,18767,-1607,22.2,TRUE,1,TRUE,16588,18815,1607,25.9
TRUE,FALSE,1,FALSE,15994,17724,-144,22.5,TRUE,0,FALSE,16138,16227,144,18.3
TRUE,FALSE,0,FALSE,18420,19041,1472,21.8,TRUE,0,FALSE,16948,17203,-1472,20.9
FALSE,FALSE,0,FALSE,17421,19606,1053,24.1,TRUE,2,TRUE,16368,18302,-1053,22.3
FALSE,FALSE,0,FALSE,13671,16878,-5751,20.2,TRUE,1,TRUE,19422,21120,5751,25.9
TRUE,FALSE,1,FALSE,17544,18604,1092,23,TRUE,0,FALSE,16452,17203,-1092,25.8
FALSE,FALSE,1,TRUE,15589,18306,-2268,21.9,TRUE,0,FALSE,17857,20116,2268,26.1
TRUE,FALSE,0,FALSE,16702,18943,1868,23.4,TRUE,1,TRUE,14834,17902,-1868,23
TRUE,FALSE,2,TRUE,18211,20198,3608,20.9,TRUE,0,FALSE,14603,17113,-3608,18.3
FALSE,FALSE,0,FALSE,14640,17333,-3116,22.4,TRUE,1,TRUE,17756,19327,3116,21.5
TRUE,TRUE,1,TRUE,16211,18576,-706,20.7,FALSE,0,FALSE,16917,18882,706,23.9
FALSE,TRUE,0,FALSE,16517,17161,1402,21.9,FALSE,1,TRUE,15115,17727,-1402,20.6
TRUE,TRUE,2,TRUE,15723,19631,139,24.6,FALSE,0,FALSE,15584,19371,-139,25.3
FALSE,FALSE,0,FALSE,14993,17018,-1481,24.1,TRUE,1,TRUE,16474,18895,1481,22.6
TRUE,FALSE,1,TRUE,19576,18210,4417,23.6,TRUE,0,FALSE,15159,15277,-4417,19.8
TRUE,FALSE,0,FALSE,15217,18056,-784,19.5,TRUE,1,TRUE,16001,17302,784,23.8
TRUE,FALSE,0,FALSE,15502,17716,243,22.3,TRUE,1,TRUE,15259,17747,-243,21.4
FALSE,FALSE,1,TRUE,15125,17495,-2302,20,TRUE,0,FALSE,17427,18197,2302,20.7
TRUE,FALSE,0,FALSE,15845,16561,-1018,19.5,TRUE,0,FALSE,16863,17542,1018,21.3
TRUE,FALSE,0,FALSE,16433,18215,-350,22.9,TRUE,0,FALSE,16783,18166,350,22.4
TRUE,TRUE,1,TRUE,18824,19996,5240,23.7,FALSE,0,FALSE,13584,17661,-5240,21.7
TRUE,TRUE,1,TRUE,16360,17624,1447,23.4,FALSE,0,FALSE,14913,17773,-1447,21.4
FALSE,FALSE,1,TRUE,15128,15881,-1187,17.2,TRUE,0,FALSE,16315,17018,1187,17.9
TRUE,TRUE,1,FALSE,18317,19636,2214,22.9,FALSE,0,FALSE,16103,18331,-2214,20.4
FALSE,FALSE,1,TRUE,16248,18567,174,22,TRUE,0,FALSE,16074,17056,-174,21.1
FALSE,TRUE,0,FALSE,15871,17457,-967,23.4,FALSE,1,TRUE,16838,18673,967,21.4
TRUE,TRUE,1,TRUE,17779,19282,2178,22,FALSE,0,FALSE,15601,17453,-2178,24.4
FALSE,FALSE,0,FALSE,16785,17837,-860,18.6,TRUE,1,TRUE,17645,17623,860,23.6
TRUE,TRUE,2,TRUE,15524,17366,-700,18.2,FALSE,0,FALSE,16224,17283,700,19.4
TRUE,TRUE,0,FALSE,16592,18393,813,22.1,FALSE,0,FALSE,15779,17161,-813,19.5
TRUE,TRUE,2,TRUE,19148,18457,7791,23.2,FALSE,0,FALSE,11357,11999,-7791,13.7
FALSE,FALSE,0,FALSE,17337,18952,2429,22.8,TRUE,1,TRUE,14908,16547,-2429,19.8
TRUE,FALSE,0,FALSE,16003,17152,-954,21.3,TRUE,1,TRUE,16957,18159,954,26.1
TRUE,TRUE,1,FALSE,17370,19627,2279,24.9,FALSE,1,TRUE,15091,17218,-2279,22.9
TRUE,TRUE,0,FALSE,18036,19849,2203,24.3,FALSE,1,TRUE,15833,18315,-2203,19.3
TRUE,TRUE,1,TRUE,14711,18380,-1244,20.9,FALSE,1,FALSE,15955,18928,1244,23.4
FALSE,FALSE,2,TRUE,16468,17897,142,22.4,TRUE,0,FALSE,16326,17955,-142,20.9
FALSE,TRUE,0,FALSE,15285,16734,-974,19.4,FALSE,1,TRUE,16259,17549,974,18.4
FALSE,FALSE,1,TRUE,17151,18598,267,19.5,TRUE,0,FALSE,16884,18045,-267,23.4
TRUE,TRUE,0,FALSE,17951,17346,2095,21.1,FALSE,0,FALSE,15856,16718,-2095,17.1
FALSE,FALSE,0,FALSE,15917,17466,-3142,20,TRUE,0,FALSE,19059,19755,3142,24.3
FALSE,TRUE,1,TRUE,17399,17937,381,24.5,FALSE,0,FALSE,17018,17072,-381,23.7
TRUE,TRUE,1,TRUE,17639,18319,2392,24.7,FALSE,0,FALSE,15247,17119,-2392,21.4
FALSE,TRUE,0,FALSE,17183,18197,157,20.8,FALSE,1,TRUE,17026,16524,-157,18.8
FALSE,TRUE,0,FALSE,17130,17703,690,22.1,FALSE,0,FALSE,16440,17039,-690,20.8
FALSE,FALSE,0,FALSE,15920,17106,-905,22.9,TRUE,2,TRUE,16825,19335,905,22.4
FALSE,TRUE,0,FALSE,17818,17651,-1272,20.4,FALSE,0,FALSE,19090,19285,1272,25.8
FALSE,FALSE,2,TRUE,15956,18145,656,21.5,TRUE,0,FALSE,15300,17619,-656,21.2
TRUE,TRUE,0,FALSE,15582,15958,977,23.8,FALSE,1,TRUE,14605,15824,-977,20.4
FALSE,TRUE,2,TRUE,16486,18609,-2249,24.4,FALSE,0,FALSE,18735,20156,2249,21.4
TRUE,FALSE,1,TRUE,15692,17598,189,21.7,TRUE,0,FALSE,15503,17697,-189,24.4
FALSE,TRUE,0,FALSE,14232,15999,-3089,19.7,FALSE,1,TRUE,17321,19264,3089,25.1
TRUE,TRUE,1,FALSE,18133,17764,1025,21.5,FALSE,1,TRUE,17108,18917,-1025,21.8
TRUE,FALSE,1,FALSE,23205,17846,7600,20.8,TRUE,0,FALSE,15605,15981,-7600,17.1
TRUE,FALSE,2,TRUE,15564,18158,-1075,21.4,TRUE,0,FALSE,16639,17780,1075,24
TRUE,TRUE,1,TRUE,14977,17698,98,22.3,FALSE,0,FALSE,14879,17537,-98,22.4
FALSE,FALSE,0,FALSE,16263,16732,-1911,19.8,TRUE,1,TRUE,18174,19057,1911,22
TRUE,FALSE,1,TRUE,18477,19323,4458,27.5,TRUE,0,FALSE,14019,15484,-4458,18.8
FALSE,TRUE,2,TRUE,16484,17470,-375,20.2,FALSE,0,FALSE,16859,18222,375,21.9
FALSE,TRUE,1,FALSE,15167,18214,7,24.4,FALSE,0,FALSE,15160,18873,-7,24.2
FALSE,FALSE,0,FALSE,16007,18083,-1534,20.7,TRUE,2,TRUE,17541,18250,1534,19.6
TRUE,FALSE,0,FALSE,18093,18394,1882,23.1,TRUE,0,FALSE,16211,16904,-1882,20.3
TRUE,FALSE,0,FALSE,18588,19735,2382,22.5,TRUE,0,FALSE,16206,17121,-2382,19.2
TRUE,TRUE,1,TRUE,16853,18255,2751,22.6,FALSE,0,FALSE,14102,16791,-2751,19.9
TRUE,FALSE,0,FALSE,16323,18362,-451,21.3,TRUE,1,TRUE,16774,18026,451,21.9
TRUE,FALSE,0,FALSE,15063,17979,-1213,20.6,TRUE,1,TRUE,16276,18992,1213,25.3
FALSE,TRUE,0,FALSE,14929,15842,-3291,22.3,FALSE,2,TRUE,18220,18344,3291,24.8
TRUE,TRUE,2,TRUE,17119,18962,2031,23.3,FALSE,0,FALSE,15088,16995,-2031,20.9
FALSE,FALSE,2,TRUE,19049,17924,1618,20.2,TRUE,0,FALSE,17431,17998,-1618,20.9
FALSE,TRUE,1,TRUE,19452,18579,3682,20.9,FALSE,0,FALSE,15770,17295,-3682,20.7
FALSE,FALSE,1,FALSE,13981,16277,-5870,22,TRUE,0,FALSE,19851,19919,5870,23.4
FALSE,TRUE,0,FALSE,15418,15315,-3531,20.3,FALSE,2,TRUE,18949,19204,3531,21.5
TRUE,FALSE,1,TRUE,17636,19458,2360,21.8,TRUE,0,FALSE,15276,17062,-2360,18.8
TRUE,FALSE,1,TRUE,17026,18215,326,22.9,TRUE,0,FALSE,16700,18130,-326,21.7
FALSE,FALSE,1,TRUE,17084,18781,2148,21.9,TRUE,0,FALSE,14936,17081,-2148,21.7
FALSE,FALSE,0,FALSE,14501,16545,-2930,19.5,TRUE,1,TRUE,17431,19324,2930,23.9
TRUE,FALSE,0,FALSE,15745,17654,-1300,23.6,TRUE,1,TRUE,17045,18306,1300,25.2
TRUE,TRUE,1,TRUE,16571,18777,88,22,FALSE,0,FALSE,16483,18364,-88,20.2
FALSE,TRUE,0,FALSE,17224,18105,631,22.9,FALSE,1,TRUE,16593,18370,-631,21.8
TRUE,TRUE,0,FALSE,18518,19380,4619,22.4,FALSE,1,TRUE,13899,16476,-4619,20.5
FALSE,FALSE,0,FALSE,17155,18632,-1516,22.4,TRUE,1,TRUE,18671,18241,1516,22.8
TRUE,FALSE,1,TRUE,16046,17207,699,23.4,TRUE,0,FALSE,15347,17189,-699,19.9
FALSE,TRUE,0,FALSE,16986,18376,2587,22.6,FALSE,1,TRUE,14399,16405,-2587,20.8
TRUE,TRUE,1,FALSE,16368,18857,-180,21.6,FALSE,1,TRUE,16548,19747,180,22.4
FALSE,TRUE,0,FALSE,15302,16647,-3051,21,FALSE,1,TRUE,18353,18770,3051,21.5
FALSE,FALSE,1,TRUE,15367,18799,-2021,21.7,TRUE,0,FALSE,17388,19567,2021,23.8
FALSE,FALSE,1,TRUE,15178,17707,-673,23.6,TRUE,1,FALSE,15851,19039,673,25.2
FALSE,FALSE,0,FALSE,13824,14814,-5059,16.7,TRUE,2,TRUE,18883,20061,5059,23.5
FALSE,FALSE,0,FALSE,15919,16956,-2604,20,TRUE,0,FALSE,18523,18052,2604,18.3
FALSE,FALSE,1,FALSE,16627,18559,-844,22.9,TRUE,0,FALSE,17471,17822,844,20.6
FALSE,FALSE,1,TRUE,14032,16940,-1935,22,TRUE,0,FALSE,15967,18474,1935,23.1
TRUE,TRUE,1,TRUE,18787,17878,3886,19.3,FALSE,0,FALSE,14901,16101,-3886,17.5
FALSE,TRUE,0,FALSE,15205,16968,-977,24.8,FALSE,0,FALSE,16182,18288,977,18.6
FALSE,TRUE,1,TRUE,15651,16945,-1990,20.1,FALSE,0,FALSE,17641,19947,1990,22.6
FALSE,TRUE,0,FALSE,17376,18907,2809,23.8,FALSE,1,FALSE,14567,17167,-2809,23.4
FALSE,FALSE,1,TRUE,15788,17331,-3084,22.3,TRUE,0,FALSE,18872,20472,3084,23
FALSE,TRUE,0,FALSE,15688,16920,-162,22.6,FALSE,0,FALSE,15850,17473,162,23.3
TRUE,FALSE,1,FALSE,15374,17943,-780,22.3,TRUE,1,TRUE,16154,17836,780,23.1
FALSE,FALSE,1,FALSE,13418,16047,-2958,18.9,TRUE,1,TRUE,16376,17780,2958,22
FALSE,FALSE,0,FALSE,12178,10098,-6754,12,TRUE,0,FALSE,18932,15824,6754,20.3
TRUE,TRUE,0,FALSE,15984,16282,-2111,20.6,FALSE,1,FALSE,18095,17855,2111,20.8
TRUE,FALSE,0,FALSE,15908,18487,-1194,22,TRUE,1,TRUE,17102,19620,1194,25.5
FALSE,TRUE,0,FALSE,15240,17500,-3562,16.2,FALSE,1,TRUE,18802,20090,3562,22.1
TRUE,FALSE,1,TRUE,14943,17710,-626,22.3,TRUE,0,FALSE,15569,17649,626,23.3
TRUE,FALSE,0,FALSE,15634,18046,-1848,23.5,TRUE,1,TRUE,17482,18663,1848,25.6
TRUE,FALSE,1,TRUE,17071,19207,374,24.5,TRUE,0,FALSE,16697,17742,-374,20.9
TRUE,FALSE,1,FALSE,15726,17885,-1614,22.2,TRUE,1,TRUE,17340,18303,1614,23.9
FALSE,FALSE,0,FALSE,15249,19121,-162,24,TRUE,2,TRUE,15411,17601,162,24.8
TRUE,FALSE,1,TRUE,16055,18838,583,20.8,TRUE,0,FALSE,15472,18399,-583,25.9
FALSE,FALSE,0,FALSE,13446,15500,-4676,19,TRUE,2,TRUE,18122,19051,4676,24.3
FALSE,TRUE,1,TRUE,15903,17640,428,23.9,FALSE,0,FALSE,15475,17240,-428,21.7
FALSE,TRUE,0,FALSE,16940,18098,893,20.3,FALSE,1,TRUE,16047,17842,-893,22.8
TRUE,FALSE,1,FALSE,16882,18657,1632,22.1,TRUE,0,FALSE,15250,16890,-1632,17.9
FALSE,FALSE,0,FALSE,15894,17808,-1019,21.2,TRUE,1,TRUE,16913,19372,1019,22.9
TRUE,FALSE,2,TRUE,16047,18644,1976,24.4,TRUE,0,FALSE,14071,16866,-1976,22.2
FALSE,FALSE,0,FALSE,14709,17092,-2591,21.7,TRUE,1,TRUE,17300,18342,2591,23.6
TRUE,FALSE,1,FALSE,16368,17821,-1314,23.4,TRUE,1,TRUE,17682,19529,1314,23
FALSE,FALSE,1,FALSE,17394,17904,188,26.1,TRUE,0,FALSE,17206,18580,-188,21.2
TRUE,FALSE,1,TRUE,15950,17303,175,19.6,TRUE,0,FALSE,15775,17537,-175,22.1
FALSE,FALSE,0,FALSE,15268,17717,-880,21.4,TRUE,0,FALSE,16148,17538,880,19.8
TRUE,TRUE,0,FALSE,18274,19011,4693,23.2,FALSE,0,FALSE,13581,16043,-4693,17.9
FALSE,TRUE,0,FALSE,15993,17528,-645,20.6,FALSE,1,TRUE,16638,17976,645,19.7
FALSE,TRUE,1,TRUE,14857,16510,-959,22.6,FALSE,1,FALSE,15816,17758,959,19.5
TRUE,TRUE,1,TRUE,18503,19717,2527,25,FALSE,0,FALSE,15976,18022,-2527,21
TRUE,FALSE,1,FALSE,17442,20005,-347,21,TRUE,0,FALSE,17789,19039,347,21.8
FALSE,FALSE,0,FALSE,14478,14665,-5087,17.1,TRUE,0,FALSE,19565,19283,5087,19.9
TRUE,TRUE,2,TRUE,17086,17746,1838,22.9,FALSE,0,FALSE,15248,18435,-1838,23.1
TRUE,FALSE,1,FALSE,18075,19324,600,23.3,TRUE,1,TRUE,17475,19035,-600,22.4
TRUE,TRUE,1,TRUE,15965,18534,725,20.8,FALSE,1,FALSE,15240,16761,-725,20.2
TRUE,FALSE,0,FALSE,15261,18671,-1461,22.3,TRUE,1,TRUE,16722,18740,1461,21.5
TRUE,FALSE,1,TRUE,14603,18478,670,23.2,TRUE,0,FALSE,13933,17032,-670,19.7
FALSE,FALSE,1,FALSE,13836,17114,-1798,21.3,TRUE,1,TRUE,15634,17788,1798,25.1
TRUE,TRUE,1,FALSE,17170,19211,3234,25.1,FALSE,0,FALSE,13936,16784,-3234,20.3
FALSE,FALSE,1,TRUE,16198,18249,-2121,16.5,TRUE,1,FALSE,18319,19287,2121,18.7
TRUE,TRUE,0,FALSE,16923,19758,1974,22.2,FALSE,1,TRUE,14949,18046,-1974,20.2
FALSE,FALSE,2,TRUE,15131,18216,-727,21.4,TRUE,0,FALSE,15858,17873,727,24.8
TRUE,TRUE,0,FALSE,17155,18002,756,23.1,FALSE,1,TRUE,16399,18001,-756,21.6
TRUE,TRUE,0,FALSE,18573,19391,2639,20.7,FALSE,0,FALSE,15934,17027,-2639,19.7
TRUE,TRUE,1,TRUE,17765,18967,2519,21.1,FALSE,0,FALSE,15246,16498,-2519,22.9
TRUE,FALSE,1,TRUE,16238,19255,782,23.3,TRUE,0,FALSE,15456,18367,-782,20.6
FALSE,FALSE,0,FALSE,15903,18032,-2416,21,TRUE,1,TRUE,18319,19909,2416,26.1
FALSE,TRUE,1,TRUE,14459,17229,-839,22.4,FALSE,0,FALSE,15298,18314,839,24.7
TRUE,TRUE,0,FALSE,16266,17321,927,20.7,FALSE,1,TRUE,15339,17379,-927,20.1